season,date,team,points,division,conference,cum_points,possible_points,total_possible_points,points_pct,division_threshold,points_above_division_spot,conference_threshold,points_above_conference_spot
2011-12,2011-10-08,Anaheim Ducks,0,Pacific,Western,0,2,2,0.0,2,-2,0,0
2011-12,2011-10-09,Anaheim Ducks,2,Pacific,Western,2,2,4,0.5,2,0,2,0
2011-12,2011-10-15,Anaheim Ducks,2,Pacific,Western,4,2,6,0.6666666666666666,6,-2,4,0
2011-12,2011-10-17,Anaheim Ducks,2,Pacific,Western,6,2,8,0.75,8,-2,5,1
2011-12,2011-10-18,Anaheim Ducks,2,Pacific,Western,8,2,10,0.8,10,-2,5,3
2011-12,2011-10-22,Anaheim Ducks,0,Pacific,Western,8,2,12,0.6666666666666666,12,-4,8,0
2011-12,2011-10-24,Anaheim Ducks,0,Pacific,Western,8,2,14,0.5714285714285714,12,-4,8,0
2011-12,2011-10-26,Anaheim Ducks,1,Pacific,Western,9,2,16,0.5625,14,-5,9,0
2011-12,2011-10-28,Anaheim Ducks,2,Pacific,Western,11,2,18,0.6111111111111112,14,-3,10,1
2011-12,2011-10-30,Anaheim Ducks,0,Pacific,Western,11,2,20,0.55,16,-5,11,0
2011-12,2011-10-30,Anaheim Ducks,0,Pacific,Western,11,2,22,0.5,16,-5,11,0
2011-12,2011-11-01,Anaheim Ducks,1,Pacific,Western,12,2,24,0.5,16,-4,12,0
2011-12,2011-11-03,Anaheim Ducks,1,Pacific,Western,13,2,26,0.5,16,-3,13,0
2011-12,2011-11-05,Anaheim Ducks,0,Pacific,Western,13,2,28,0.4642857142857143,18,-5,14,-1
2011-12,2011-11-10,Anaheim Ducks,0,Pacific,Western,13,2,30,0.43333333333333335,22,-9,16,-3
2011-12,2011-11-12,Anaheim Ducks,2,Pacific,Western,15,2,32,0.46875,22,-7,17,-2
2011-12,2011-11-14,Anaheim Ducks,0,Pacific,Western,15,2,34,0.4411764705882353,22,-7,19,-4
2011-12,2011-11-17,Anaheim Ducks,1,Pacific,Western,16,2,36,0.4444444444444444,22,-6,19,-3
2011-12,2011-11-18,Anaheim Ducks,0,Pacific,Western,16,2,38,0.42105263157894735,23,-7,21,-5
2011-12,2011-11-21,Anaheim Ducks,0,Pacific,Western,16,2,40,0.4,25,-9,22,-6
2011-12,2011-11-24,Anaheim Ducks,0,Pacific,Western,16,2,42,0.38095238095238093,27,-11,24,-8
2011-12,2011-11-25,Anaheim Ducks,0,Pacific,Western,16,2,44,0.36363636363636365,27,-11,25,-9
2011-12,2011-11-28,Anaheim Ducks,0,Pacific,Western,16,2,46,0.34782608695652173,27,-11,27,-11
2011-12,2011-12-01,Anaheim Ducks,2,Pacific,Western,18,2,48,0.375,29,-11,28,-10
2011-12,2011-12-03,Anaheim Ducks,1,Pacific,Western,19,2,50,0.38,31,-12,29,-10
2011-12,2011-12-05,Anaheim Ducks,0,Pacific,Western,19,2,52,0.36538461538461536,31,-12,29,-10
2011-12,2011-12-07,Anaheim Ducks,2,Pacific,Western,21,2,54,0.3888888888888889,33,-12,30,-9
2011-12,2011-12-09,Anaheim Ducks,0,Pacific,Western,21,2,56,0.375,33,-12,31,-10
2011-12,2011-12-11,Anaheim Ducks,0,Pacific,Western,21,2,58,0.3620689655172414,33,-12,32,-11
2011-12,2011-12-15,Anaheim Ducks,2,Pacific,Western,23,2,60,0.38333333333333336,35,-12,33,-10
2011-12,2011-12-17,Anaheim Ducks,0,Pacific,Western,23,2,62,0.3709677419354839,37,-14,35,-12
2011-12,2011-12-18,Anaheim Ducks,0,Pacific,Western,23,2,64,0.359375,37,-14,37,-14
2011-12,2011-12-20,Anaheim Ducks,0,Pacific,Western,23,2,66,0.3484848484848485,39,-16,37,-14
2011-12,2011-12-23,Anaheim Ducks,1,Pacific,Western,24,2,68,0.35294117647058826,39,-15,39,-15
2011-12,2011-12-27,Anaheim Ducks,2,Pacific,Western,26,2,70,0.37142857142857144,41,-15,40,-14
2011-12,2011-12-30,Anaheim Ducks,0,Pacific,Western,26,2,72,0.3611111111111111,42,-16,42,-16
2011-12,2012-01-01,Anaheim Ducks,0,Pacific,Western,26,2,74,0.35135135135135137,44,-18,43,-17
2011-12,2012-01-05,Anaheim Ducks,0,Pacific,Western,26,2,76,0.34210526315789475,46,-20,45,-19
2011-12,2012-01-07,Anaheim Ducks,2,Pacific,Western,28,2,78,0.358974358974359,48,-20,47,-19
2011-12,2012-01-09,Anaheim Ducks,2,Pacific,Western,30,2,80,0.375,50,-20,47,-17
2011-12,2012-01-11,Anaheim Ducks,2,Pacific,Western,32,2,82,0.3902439024390244,51,-19,49,-17
2011-12,2012-01-13,Anaheim Ducks,1,Pacific,Western,33,2,84,0.39285714285714285,53,-20,50,-17
2011-12,2012-01-14,Anaheim Ducks,2,Pacific,Western,35,2,86,0.4069767441860465,53,-18,50,-15
2011-12,2012-01-16,Anaheim Ducks,2,Pacific,Western,37,2,88,0.42045454545454547,55,-18,51,-14
2011-12,2012-01-19,Anaheim Ducks,2,Pacific,Western,39,2,90,0.43333333333333335,57,-18,52,-13
2011-12,2012-01-21,Anaheim Ducks,2,Pacific,Western,41,2,92,0.44565217391304346,57,-16,52,-11
2011-12,2012-01-23,Anaheim Ducks,2,Pacific,Western,43,2,94,0.4574468085106383,57,-14,54,-11
2011-12,2012-01-25,Anaheim Ducks,0,Pacific,Western,43,2,96,0.4479166666666667,60,-17,55,-12
2011-12,2012-02-01,Anaheim Ducks,2,Pacific,Western,45,2,98,0.45918367346938777,62,-17,55,-10
2011-12,2012-02-02,Anaheim Ducks,0,Pacific,Western,45,2,100,0.45,62,-17,55,-10
2011-12,2012-02-04,Anaheim Ducks,1,Pacific,Western,46,2,102,0.45098039215686275,64,-18,57,-11
2011-12,2012-02-07,Anaheim Ducks,2,Pacific,Western,48,2,104,0.46153846153846156,64,-16,58,-10
2011-12,2012-02-09,Anaheim Ducks,2,Pacific,Western,50,2,106,0.4716981132075472,64,-14,58,-8
2011-12,2012-02-11,Anaheim Ducks,1,Pacific,Western,51,2,108,0.4722222222222222,66,-15,60,-9
2011-12,2012-02-12,Anaheim Ducks,2,Pacific,Western,53,2,110,0.4818181818181818,66,-13,62,-9
2011-12,2012-02-15,Anaheim Ducks,2,Pacific,Western,55,2,112,0.49107142857142855,68,-13,63,-8
2011-12,2012-02-16,Anaheim Ducks,2,Pacific,Western,57,2,114,0.5,68,-11,63,-6
2011-12,2012-02-18,Anaheim Ducks,1,Pacific,Western,58,2,116,0.5,69,-11,65,-7
2011-12,2012-02-19,Anaheim Ducks,2,Pacific,Western,60,2,118,0.5084745762711864,69,-9,65,-5
2011-12,2012-02-22,Anaheim Ducks,0,Pacific,Western,60,2,120,0.5,69,-9,66,-6
2011-12,2012-02-24,Anaheim Ducks,2,Pacific,Western,62,2,122,0.5081967213114754,71,-9,66,-4
2011-12,2012-02-27,Anaheim Ducks,2,Pacific,Western,64,2,124,0.5161290322580645,73,-9,70,-6
2011-12,2012-02-28,Anaheim Ducks,0,Pacific,Western,64,2,126,0.5079365079365079,73,-9,70,-6
2011-12,2012-03-01,Anaheim Ducks,0,Pacific,Western,64,2,128,0.5,75,-11,71,-7
2011-12,2012-03-03,Anaheim Ducks,2,Pacific,Western,66,2,130,0.5076923076923077,75,-9,73,-7
2011-12,2012-03-04,Anaheim Ducks,0,Pacific,Western,66,2,132,0.5,75,-9,73,-7
2011-12,2012-03-06,Anaheim Ducks,2,Pacific,Western,68,2,134,0.5074626865671642,75,-7,73,-5
2011-12,2012-03-09,Anaheim Ducks,0,Pacific,Western,68,2,136,0.5,79,-11,75,-7
2011-12,2012-03-11,Anaheim Ducks,0,Pacific,Western,68,2,138,0.4927536231884058,81,-13,76,-8
2011-12,2012-03-13,Anaheim Ducks,1,Pacific,Western,69,2,140,0.4928571428571429,81,-12,78,-9
2011-12,2012-03-15,Anaheim Ducks,2,Pacific,Western,71,2,142,0.5,83,-12,81,-10
2011-12,2012-03-17,Anaheim Ducks,0,Pacific,Western,71,2,144,0.4930555555555556,83,-12,81,-10
2011-12,2012-03-19,Anaheim Ducks,0,Pacific,Western,71,2,146,0.4863013698630137,83,-12,83,-12
2011-12,2012-03-20,Anaheim Ducks,2,Pacific,Western,73,2,148,0.49324324324324326,83,-10,83,-10
2011-12,2012-03-22,Anaheim Ducks,2,Pacific,Western,75,2,150,0.5,85,-10,84,-9
2011-12,2012-03-26,Anaheim Ducks,0,Pacific,Western,75,2,152,0.4934210526315789,87,-12,86,-11
2011-12,2012-03-29,Anaheim Ducks,2,Pacific,Western,77,2,154,0.5,89,-12,88,-11
2011-12,2012-04-01,Anaheim Ducks,0,Pacific,Western,77,2,156,0.4935897435897436,91,-14,90,-13
2011-12,2012-04-02,Anaheim Ducks,0,Pacific,Western,77,2,158,0.4873417721518987,91,-14,90,-13
2011-12,2012-04-04,Anaheim Ducks,1,Pacific,Western,78,2,160,0.4875,93,-15,92,-14
2011-12,2012-04-06,Anaheim Ducks,2,Pacific,Western,80,2,162,0.49382716049382713,95,-15,94,-14
2011-12,2012-04-07,Anaheim Ducks,0,Pacific,Western,80,2,164,0.4878048780487805,95,-15,94,-14
2011-12,2011-10-06,Boston Bruins,0,Northeast,Eastern,0,2,2,0.0,2,-2,0,0
2011-12,2011-10-08,Boston Bruins,2,Northeast,Eastern,2,2,4,0.5,4,-2,1,1
2011-12,2011-10-10,Boston Bruins,0,Northeast,Eastern,2,2,6,0.3333333333333333,4,-2,2,0
2011-12,2011-10-12,Boston Bruins,0,Northeast,Eastern,2,2,8,0.25,4,-2,2,0
2011-12,2011-10-16,Boston Bruins,2,Northeast,Eastern,4,2,10,0.4,6,-2,5,-1
2011-12,2011-10-18,Boston Bruins,0,Northeast,Eastern,4,2,12,0.3333333333333333,8,-4,6,-2
2011-12,2011-10-20,Boston Bruins,2,Northeast,Eastern,6,2,14,0.42857142857142855,10,-4,6,0
2011-12,2011-10-22,Boston Bruins,0,Northeast,Eastern,6,2,16,0.375,11,-5,8,-2
2011-12,2011-10-27,Boston Bruins,0,Northeast,Eastern,6,2,18,0.3333333333333333,13,-7,10,-4
2011-12,2011-10-29,Boston Bruins,0,Northeast,Eastern,6,2,20,0.3,15,-9,12,-6
2011-12,2011-11-01,Boston Bruins,2,Northeast,Eastern,8,2,22,0.36363636363636365,15,-7,12,-4
2011-12,2011-11-05,Boston Bruins,2,Northeast,Eastern,10,2,24,0.4166666666666667,19,-9,14,-4
2011-12,2011-11-08,Boston Bruins,2,Northeast,Eastern,12,2,26,0.46153846153846156,19,-7,15,-3
2011-12,2011-11-11,Boston Bruins,2,Northeast,Eastern,14,2,28,0.5,21,-7,18,-4
2011-12,2011-11-13,Boston Bruins,2,Northeast,Eastern,16,2,30,0.5333333333333333,21,-5,18,-2
2011-12,2011-11-16,Boston Bruins,2,Northeast,Eastern,18,2,32,0.5625,22,-4,19,-1
2011-12,2011-11-18,Boston Bruins,2,Northeast,Eastern,20,2,34,0.5882352941176471,22,-2,21,-1
2011-12,2011-11-20,Boston Bruins,2,Northeast,Eastern,22,2,36,0.6111111111111112,24,-2,21,1
2011-12,2011-11-22,Boston Bruins,2,Northeast,Eastern,24,2,38,0.631578947368421,24,0,23,1
2011-12,2011-11-24,Boston Bruins,2,Northeast,Eastern,26,2,40,0.65,26,0,23,3
2011-12,2011-11-25,Boston Bruins,1,Northeast,Eastern,27,2,42,0.6428571428571429,27,0,25,2
2011-12,2011-11-27,Boston Bruins,2,Northeast,Eastern,29,2,44,0.6590909090909091,29,0,25,4
2011-12,2011-12-01,Boston Bruins,2,Northeast,Eastern,31,2,46,0.6739130434782609,31,0,26,5
2011-12,2011-12-04,Boston Bruins,2,Northeast,Eastern,33,2,48,0.6875,33,0,27,6
2011-12,2011-12-06,Boston Bruins,2,Northeast,Eastern,35,2,50,0.7,35,0,29,6
2011-12,2011-12-07,Boston Bruins,0,Northeast,Eastern,35,2,52,0.6730769230769231,35,0,29,6
2011-12,2011-12-09,Boston Bruins,0,Northeast,Eastern,35,2,54,0.6481481481481481,35,0,30,5
2011-12,2011-12-11,Boston Bruins,2,Northeast,Eastern,37,2,56,0.6607142857142857,37,0,31,6
2011-12,2011-12-14,Boston Bruins,2,Northeast,Eastern,39,2,58,0.6724137931034483,39,0,33,6
2011-12,2011-12-15,Boston Bruins,2,Northeast,Eastern,41,2,60,0.6833333333333333,41,0,33,8
2011-12,2011-12-17,Boston Bruins,2,Northeast,Eastern,43,2,62,0.6935483870967742,43,0,35,8
2011-12,2011-12-20,Boston Bruins,2,Northeast,Eastern,45,2,64,0.703125,45,0,35,10
2011-12,2011-12-24,Boston Bruins,2,Northeast,Eastern,47,2,66,0.7121212121212122,47,0,39,8
2011-12,2011-12-29,Boston Bruins,2,Northeast,Eastern,49,2,68,0.7205882352941176,49,0,39,10
2011-12,2012-01-01,Boston Bruins,0,Northeast,Eastern,49,2,70,0.7,49,0,43,6
2011-12,2012-01-05,Boston Bruins,2,Northeast,Eastern,51,2,72,0.7083333333333334,51,0,44,7
2011-12,2012-01-06,Boston Bruins,2,Northeast,Eastern,53,2,74,0.7162162162162162,53,0,44,9
2011-12,2012-01-07,Boston Bruins,0,Northeast,Eastern,53,2,76,0.6973684210526315,53,0,45,8
2011-12,2012-01-11,Boston Bruins,2,Northeast,Eastern,55,2,78,0.7051282051282052,55,0,46,9
2011-12,2012-01-13,Boston Bruins,2,Northeast,Eastern,57,2,80,0.7125,57,0,46,11
2011-12,2012-01-15,Boston Bruins,0,Northeast,Eastern,57,2,82,0.6951219512195121,57,0,50,7
2011-12,2012-01-17,Boston Bruins,2,Northeast,Eastern,59,2,84,0.7023809523809523,59,0,50,9
2011-12,2012-01-18,Boston Bruins,0,Northeast,Eastern,59,2,86,0.686046511627907,59,0,50,9
2011-12,2012-01-20,Boston Bruins,2,Northeast,Eastern,61,2,88,0.6931818181818182,61,0,52,9
2011-12,2012-01-21,Boston Bruins,1,Northeast,Eastern,62,2,90,0.6888888888888889,62,0,52,10
2011-12,2012-01-22,Boston Bruins,2,Northeast,Eastern,64,2,92,0.6956521739130435,64,0,53,11
2011-12,2012-01-25,Boston Bruins,0,Northeast,Eastern,64,2,94,0.6808510638297872,64,0,55,9
2011-12,2012-02-01,Boston Bruins,2,Northeast,Eastern,66,2,96,0.6875,66,0,56,10
2011-12,2012-02-03,Boston Bruins,0,Northeast,Eastern,66,2,98,0.673469387755102,66,0,57,9
2011-12,2012-02-04,Boston Bruins,0,Northeast,Eastern,66,2,100,0.66,66,0,58,8
2011-12,2012-02-05,Boston Bruins,2,Northeast,Eastern,68,2,102,0.6666666666666666,68,0,59,9
2011-12,2012-02-09,Boston Bruins,0,Northeast,Eastern,68,2,104,0.6538461538461539,68,0,60,8
2011-12,2012-02-11,Boston Bruins,2,Northeast,Eastern,70,2,106,0.660377358490566,70,0,62,8
2011-12,2012-02-15,Boston Bruins,0,Northeast,Eastern,70,2,108,0.6481481481481481,70,0,62,8
2011-12,2012-02-16,Boston Bruins,2,Northeast,Eastern,72,2,110,0.6545454545454545,72,0,64,8
2011-12,2012-02-18,Boston Bruins,0,Northeast,Eastern,72,2,112,0.6428571428571429,72,0,64,8
2011-12,2012-02-19,Boston Bruins,0,Northeast,Eastern,72,2,114,0.631578947368421,72,0,64,8
2011-12,2012-02-23,Boston Bruins,2,Northeast,Eastern,74,2,116,0.6379310344827587,74,0,65,9
2011-12,2012-02-25,Boston Bruins,1,Northeast,Eastern,75,2,118,0.635593220338983,75,0,66,9
2011-12,2012-02-26,Boston Bruins,2,Northeast,Eastern,77,2,120,0.6416666666666667,77,0,68,9
2011-12,2012-02-29,Boston Bruins,0,Northeast,Eastern,77,2,122,0.6311475409836066,77,0,69,8
2011-12,2012-03-02,Boston Bruins,2,Northeast,Eastern,79,2,124,0.6370967741935484,79,0,70,9
2011-12,2012-03-03,Boston Bruins,0,Northeast,Eastern,79,2,126,0.626984126984127,79,0,70,9
2011-12,2012-03-04,Boston Bruins,0,Northeast,Eastern,79,2,128,0.6171875,79,0,70,9
2011-12,2012-03-07,Boston Bruins,2,Northeast,Eastern,81,2,130,0.6230769230769231,81,0,72,9
2011-12,2012-03-09,Boston Bruins,2,Northeast,Eastern,83,2,132,0.6287878787878788,83,0,72,11
2011-12,2012-03-10,Boston Bruins,0,Northeast,Eastern,83,2,134,0.6194029850746269,83,0,74,9
2011-12,2012-03-11,Boston Bruins,0,Northeast,Eastern,83,2,136,0.6102941176470589,83,0,76,7
2011-12,2012-03-13,Boston Bruins,0,Northeast,Eastern,83,2,138,0.6014492753623188,83,0,78,5
2011-12,2012-03-15,Boston Bruins,0,Northeast,Eastern,83,2,140,0.5928571428571429,83,0,78,5
2011-12,2012-03-17,Boston Bruins,2,Northeast,Eastern,85,2,142,0.5985915492957746,85,0,78,7
2011-12,2012-03-19,Boston Bruins,2,Northeast,Eastern,87,2,144,0.6041666666666666,87,0,80,7
2011-12,2012-03-23,Boston Bruins,0,Northeast,Eastern,87,2,146,0.5958904109589042,87,0,82,5
2011-12,2012-03-25,Boston Bruins,2,Northeast,Eastern,89,2,148,0.6013513513513513,89,0,84,5
2011-12,2012-03-26,Boston Bruins,2,Northeast,Eastern,91,2,150,0.6066666666666667,91,0,84,7
2011-12,2012-03-27,Boston Bruins,2,Northeast,Eastern,93,2,152,0.6118421052631579,93,0,86,7
2011-12,2012-03-29,Boston Bruins,1,Northeast,Eastern,94,2,154,0.6103896103896104,94,0,86,8
2011-12,2012-03-31,Boston Bruins,2,Northeast,Eastern,96,2,156,0.6153846153846154,96,0,88,8
2011-12,2012-04-01,Boston Bruins,2,Northeast,Eastern,98,2,158,0.620253164556962,98,0,88,10
2011-12,2012-04-03,Boston Bruins,0,Northeast,Eastern,98,2,160,0.6125,98,0,88,10
2011-12,2012-04-05,Boston Bruins,2,Northeast,Eastern,100,2,162,0.6172839506172839,100,0,90,10
2011-12,2012-04-07,Boston Bruins,2,Northeast,Eastern,102,2,164,0.6219512195121951,102,0,92,10
2011-12,2011-10-08,Buffalo Sabres,2,Northeast,Eastern,2,2,2,1.0,4,-2,1,1
2011-12,2011-10-09,Buffalo Sabres,2,Northeast,Eastern,4,2,4,1.0,4,0,2,2
2011-12,2011-10-14,Buffalo Sabres,0,Northeast,Eastern,4,2,6,0.6666666666666666,4,0,4,0
2011-12,2011-10-15,Buffalo Sabres,2,Northeast,Eastern,6,2,8,0.75,6,0,4,2
2011-12,2011-10-18,Buffalo Sabres,2,Northeast,Eastern,8,2,10,0.8,8,0,6,2
2011-12,2011-10-20,Buffalo Sabres,2,Northeast,Eastern,10,2,12,0.8333333333333334,10,0,6,4
2011-12,2011-10-22,Buffalo Sabres,0,Northeast,Eastern,10,2,14,0.7142857142857143,11,-1,8,2
2011-12,2011-10-25,Buffalo Sabres,0,Northeast,Eastern,10,2,16,0.625,11,-1,9,1
2011-12,2011-10-27,Buffalo Sabres,2,Northeast,Eastern,12,2,18,0.6666666666666666,13,-1,10,2
2011-12,2011-10-29,Buffalo Sabres,0,Northeast,Eastern,12,2,20,0.6,15,-3,12,0
2011-12,2011-11-02,Buffalo Sabres,0,Northeast,Eastern,12,2,22,0.5454545454545454,17,-5,12,0
2011-12,2011-11-04,Buffalo Sabres,2,Northeast,Eastern,14,2,24,0.5833333333333334,19,-5,14,0
2011-12,2011-11-05,Buffalo Sabres,2,Northeast,Eastern,16,2,26,0.6153846153846154,19,-3,14,2
2011-12,2011-11-09,Buffalo Sabres,2,Northeast,Eastern,18,2,28,0.6428571428571429,19,-1,16,2
2011-12,2011-11-12,Buffalo Sabres,2,Northeast,Eastern,20,2,30,0.6666666666666666,21,-1,18,2
2011-12,2011-11-13,Buffalo Sabres,0,Northeast,Eastern,20,2,32,0.625,21,-1,18,2
2011-12,2011-11-15,Buffalo Sabres,2,Northeast,Eastern,22,2,34,0.6470588235294118,22,0,18,4
2011-12,2011-11-17,Buffalo Sabres,0,Northeast,Eastern,22,2,36,0.6111111111111112,22,0,19,3
2011-12,2011-11-19,Buffalo Sabres,2,Northeast,Eastern,24,2,38,0.631578947368421,24,0,21,3
2011-12,2011-11-20,Buffalo Sabres,0,Northeast,Eastern,24,2,40,0.6,24,0,21,3
2011-12,2011-11-24,Buffalo Sabres,1,Northeast,Eastern,25,2,42,0.5952380952380952,26,-1,23,2
2011-12,2011-11-26,Buffalo Sabres,0,Northeast,Eastern,25,2,44,0.5681818181818182,28,-3,25,0
2011-12,2011-11-27,Buffalo Sabres,2,Northeast,Eastern,27,2,46,0.5869565217391305,29,-2,25,2
2011-12,2011-11-30,Buffalo Sabres,0,Northeast,Eastern,27,2,48,0.5625,30,-3,26,1
2011-12,2011-12-03,Buffalo Sabres,0,Northeast,Eastern,27,2,50,0.54,31,-4,27,0
2011-12,2011-12-04,Buffalo Sabres,2,Northeast,Eastern,29,2,52,0.5576923076923077,33,-4,27,2
2011-12,2011-12-08,Buffalo Sabres,1,Northeast,Eastern,30,2,54,0.5555555555555556,35,-5,29,1
2011-12,2011-12-10,Buffalo Sabres,2,Northeast,Eastern,32,2,56,0.5714285714285714,35,-3,31,1
2011-12,2011-12-11,Buffalo Sabres,0,Northeast,Eastern,32,2,58,0.5517241379310345,37,-5,31,1
2011-12,2011-12-14,Buffalo Sabres,1,Northeast,Eastern,33,2,60,0.55,39,-6,33,0
2011-12,2011-12-17,Buffalo Sabres,2,Northeast,Eastern,35,2,62,0.5645161290322581,43,-8,35,0
2011-12,2011-12-18,Buffalo Sabres,0,Northeast,Eastern,35,2,64,0.546875,43,-8,35,0
2011-12,2011-12-21,Buffalo Sabres,0,Northeast,Eastern,35,2,66,0.5303030303030303,45,-10,36,-1
2011-12,2011-12-23,Buffalo Sabres,0,Northeast,Eastern,35,2,68,0.5147058823529411,45,-10,37,-2
2011-12,2011-12-27,Buffalo Sabres,2,Northeast,Eastern,37,2,70,0.5285714285714286,47,-10,39,-2
2011-12,2011-12-29,Buffalo Sabres,0,Northeast,Eastern,37,2,72,0.5138888888888888,49,-12,39,-2
2011-12,2011-12-31,Buffalo Sabres,0,Northeast,Eastern,37,2,74,0.5,49,-12,41,-4
2011-12,2012-01-01,Buffalo Sabres,1,Northeast,Eastern,38,2,76,0.5,49,-11,43,-5
2011-12,2012-01-04,Buffalo Sabres,2,Northeast,Eastern,40,2,78,0.5128205128205128,49,-9,44,-4
2011-12,2012-01-07,Buffalo Sabres,0,Northeast,Eastern,40,2,80,0.5,53,-13,45,-5
2011-12,2012-01-08,Buffalo Sabres,1,Northeast,Eastern,41,2,82,0.5,53,-12,46,-5
2011-12,2012-01-11,Buffalo Sabres,0,Northeast,Eastern,41,2,84,0.4880952380952381,55,-14,46,-5
2011-12,2012-01-14,Buffalo Sabres,2,Northeast,Eastern,43,2,86,0.5,57,-14,48,-5
2011-12,2012-01-15,Buffalo Sabres,0,Northeast,Eastern,43,2,88,0.48863636363636365,57,-14,50,-7
2011-12,2012-01-17,Buffalo Sabres,0,Northeast,Eastern,43,2,90,0.4777777777777778,59,-16,50,-7
2011-12,2012-01-19,Buffalo Sabres,0,Northeast,Eastern,43,2,92,0.4673913043478261,59,-16,52,-9
2011-12,2012-01-20,Buffalo Sabres,0,Northeast,Eastern,43,2,94,0.4574468085106383,61,-18,52,-9
2011-12,2012-01-22,Buffalo Sabres,0,Northeast,Eastern,43,2,96,0.4479166666666667,64,-21,53,-10
2011-12,2012-01-25,Buffalo Sabres,2,Northeast,Eastern,45,2,98,0.45918367346938777,64,-19,55,-10
2011-12,2012-02-01,Buffalo Sabres,2,Northeast,Eastern,47,2,100,0.47,66,-19,56,-9
2011-12,2012-02-02,Buffalo Sabres,1,Northeast,Eastern,48,2,102,0.47058823529411764,66,-18,57,-9
2011-12,2012-02-05,Buffalo Sabres,2,Northeast,Eastern,50,2,104,0.4807692307692308,68,-18,59,-9
2011-12,2012-02-09,Buffalo Sabres,2,Northeast,Eastern,52,2,106,0.49056603773584906,68,-16,60,-8
2011-12,2012-02-11,Buffalo Sabres,2,Northeast,Eastern,54,2,108,0.5,70,-16,62,-8
2011-12,2012-02-12,Buffalo Sabres,0,Northeast,Eastern,54,2,110,0.4909090909090909,70,-16,62,-8
2011-12,2012-02-15,Buffalo Sabres,0,Northeast,Eastern,54,2,112,0.48214285714285715,70,-16,62,-8
2011-12,2012-02-17,Buffalo Sabres,0,Northeast,Eastern,54,2,114,0.47368421052631576,72,-18,64,-10
2011-12,2012-02-18,Buffalo Sabres,1,Northeast,Eastern,55,2,116,0.47413793103448276,72,-17,64,-9
2011-12,2012-02-19,Buffalo Sabres,2,Northeast,Eastern,57,2,118,0.4830508474576271,72,-15,64,-7
2011-12,2012-02-22,Buffalo Sabres,2,Northeast,Eastern,59,2,120,0.49166666666666664,72,-13,65,-6
2011-12,2012-02-25,Buffalo Sabres,2,Northeast,Eastern,61,2,122,0.5,75,-14,66,-5
2011-12,2012-02-26,Buffalo Sabres,1,Northeast,Eastern,62,2,124,0.5,77,-15,68,-6
2011-12,2012-03-01,Buffalo Sabres,2,Northeast,Eastern,64,2,126,0.5079365079365079,77,-13,69,-5
2011-12,2012-03-02,Buffalo Sabres,2,Northeast,Eastern,66,2,128,0.515625,79,-13,70,-4
2011-12,2012-03-04,Buffalo Sabres,2,Northeast,Eastern,68,2,130,0.5230769230769231,79,-11,70,-2
2011-12,2012-03-06,Buffalo Sabres,0,Northeast,Eastern,68,2,132,0.5151515151515151,79,-11,72,-4
2011-12,2012-03-08,Buffalo Sabres,2,Northeast,Eastern,70,2,134,0.5223880597014925,81,-11,72,-2
2011-12,2012-03-09,Buffalo Sabres,0,Northeast,Eastern,70,2,136,0.5147058823529411,83,-13,72,-2
2011-12,2012-03-11,Buffalo Sabres,2,Northeast,Eastern,72,2,138,0.5217391304347826,83,-11,76,-4
2011-12,2012-03-12,Buffalo Sabres,2,Northeast,Eastern,74,2,140,0.5285714285714286,83,-9,76,-2
2011-12,2012-03-14,Buffalo Sabres,1,Northeast,Eastern,75,2,142,0.528169014084507,83,-8,78,-3
2011-12,2012-03-17,Buffalo Sabres,1,Northeast,Eastern,76,2,144,0.5277777777777778,85,-9,78,-2
2011-12,2012-03-19,Buffalo Sabres,2,Northeast,Eastern,78,2,146,0.5342465753424658,87,-9,80,-2
2011-12,2012-03-21,Buffalo Sabres,2,Northeast,Eastern,80,2,148,0.5405405405405406,87,-7,80,0
2011-12,2012-03-23,Buffalo Sabres,2,Northeast,Eastern,82,2,150,0.5466666666666666,87,-5,82,0
2011-12,2012-03-24,Buffalo Sabres,2,Northeast,Eastern,84,2,152,0.5526315789473685,87,-3,84,0
2011-12,2012-03-27,Buffalo Sabres,2,Northeast,Eastern,86,2,154,0.5584415584415584,93,-7,86,0
2011-12,2012-03-30,Buffalo Sabres,0,Northeast,Eastern,86,2,156,0.5512820512820513,94,-8,86,0
2011-12,2012-03-31,Buffalo Sabres,0,Northeast,Eastern,86,2,158,0.5443037974683544,96,-10,88,-2
2011-12,2012-04-03,Buffalo Sabres,2,Northeast,Eastern,88,2,160,0.55,98,-10,88,0
2011-12,2012-04-05,Buffalo Sabres,0,Northeast,Eastern,88,2,162,0.5432098765432098,100,-12,90,-2
2011-12,2012-04-07,Buffalo Sabres,1,Northeast,Eastern,89,2,164,0.5426829268292683,102,-13,92,-3
2011-12,2011-10-09,Calgary Flames,0,Northwest,Western,0,2,2,0.0,2,-2,2,-2
2011-12,2011-10-10,Calgary Flames,0,Northwest,Western,0,2,4,0.0,3,-3,2,-2
2011-12,2011-10-13,Calgary Flames,2,Northwest,Western,2,2,6,0.3333333333333333,6,-4,2,0
2011-12,2011-10-15,Calgary Flames,0,Northwest,Western,2,2,8,0.25,8,-6,4,-2
2011-12,2011-10-19,Calgary Flames,2,Northwest,Western,4,2,10,0.4,10,-6,5,-1
2011-12,2011-10-21,Calgary Flames,1,Northwest,Western,5,2,12,0.4166666666666667,10,-5,7,-2
2011-12,2011-10-22,Calgary Flames,0,Northwest,Western,5,2,14,0.35714285714285715,10,-5,8,-3
2011-12,2011-10-27,Calgary Flames,2,Northwest,Western,7,2,16,0.4375,12,-5,9,-2
2011-12,2011-10-29,Calgary Flames,2,Northwest,Western,9,2,18,0.5,14,-5,10,-1
2011-12,2011-11-02,Calgary Flames,0,Northwest,Western,9,2,20,0.45,16,-7,12,-3
2011-12,2011-11-03,Calgary Flames,2,Northwest,Western,11,2,22,0.5,16,-5,13,-2
2011-12,2011-11-04,Calgary Flames,0,Northwest,Western,11,2,24,0.4583333333333333,18,-7,14,-3
2011-12,2011-11-07,Calgary Flames,2,Northwest,Western,13,2,26,0.5,18,-5,15,-2
2011-12,2011-11-09,Calgary Flames,0,Northwest,Western,13,2,28,0.4642857142857143,20,-7,16,-3
2011-12,2011-11-12,Calgary Flames,0,Northwest,Western,13,2,30,0.43333333333333335,20,-7,17,-4
2011-12,2011-11-13,Calgary Flames,2,Northwest,Western,15,2,32,0.46875,20,-5,19,-4
2011-12,2011-11-16,Calgary Flames,0,Northwest,Western,15,2,34,0.4411764705882353,23,-8,19,-4
2011-12,2011-11-19,Calgary Flames,2,Northwest,Western,17,2,36,0.4722222222222222,25,-8,21,-4
2011-12,2011-11-22,Calgary Flames,0,Northwest,Western,17,2,38,0.4473684210526316,27,-10,23,-6
2011-12,2011-11-24,Calgary Flames,0,Northwest,Western,17,2,40,0.425,29,-12,24,-7
2011-12,2011-11-26,Calgary Flames,0,Northwest,Western,17,2,42,0.40476190476190477,29,-12,26,-9
2011-12,2011-11-27,Calgary Flames,2,Northwest,Western,19,2,44,0.4318181818181818,29,-10,27,-8
2011-12,2011-11-30,Calgary Flames,2,Northwest,Western,21,2,46,0.45652173913043476,31,-10,28,-7
2011-12,2011-12-02,Calgary Flames,1,Northwest,Western,22,2,48,0.4583333333333333,33,-11,29,-7
2011-12,2011-12-04,Calgary Flames,2,Northwest,Western,24,2,50,0.48,35,-11,29,-5
2011-12,2011-12-05,Calgary Flames,0,Northwest,Western,24,2,52,0.46153846153846156,37,-13,29,-5
2011-12,2011-12-07,Calgary Flames,2,Northwest,Western,26,2,54,0.48148148148148145,39,-13,30,-4
2011-12,2011-12-09,Calgary Flames,2,Northwest,Western,28,2,56,0.5,41,-13,31,-3
2011-12,2011-12-11,Calgary Flames,2,Northwest,Western,30,2,58,0.5172413793103449,43,-13,32,-2
2011-12,2011-12-14,Calgary Flames,0,Northwest,Western,30,2,60,0.5,43,-13,33,-3
2011-12,2011-12-16,Calgary Flames,1,Northwest,Western,31,2,62,0.5,44,-13,35,-4
2011-12,2011-12-17,Calgary Flames,1,Northwest,Western,32,2,64,0.5,44,-12,35,-3
2011-12,2011-12-19,Calgary Flames,0,Northwest,Western,32,2,66,0.48484848484848486,45,-13,37,-5
2011-12,2011-12-21,Calgary Flames,2,Northwest,Western,34,2,68,0.5,45,-11,37,-3
2011-12,2011-12-23,Calgary Flames,2,Northwest,Western,36,2,70,0.5142857142857142,45,-9,39,-3
2011-12,2011-12-24,Calgary Flames,2,Northwest,Western,38,2,72,0.5277777777777778,45,-7,40,-2
2011-12,2011-12-28,Calgary Flames,2,Northwest,Western,40,2,74,0.5405405405405406,46,-6,40,0
2011-12,2011-12-30,Calgary Flames,0,Northwest,Western,40,2,76,0.5263157894736842,50,-10,42,-2
2011-12,2011-12-31,Calgary Flames,1,Northwest,Western,41,2,78,0.5256410256410257,50,-9,42,-1
2011-12,2012-01-01,Calgary Flames,0,Northwest,Western,41,2,80,0.5125,50,-9,43,-2
2011-12,2012-01-04,Calgary Flames,0,Northwest,Western,41,2,82,0.5,51,-10,45,-4
2011-12,2012-01-06,Calgary Flames,0,Northwest,Western,41,2,84,0.4880952380952381,53,-12,46,-5
2011-12,2012-01-08,Calgary Flames,2,Northwest,Western,43,2,86,0.5,55,-12,47,-4
2011-12,2012-01-11,Calgary Flames,2,Northwest,Western,45,2,88,0.5113636363636364,57,-12,49,-4
2011-12,2012-01-13,Calgary Flames,2,Northwest,Western,47,2,90,0.5222222222222223,59,-12,50,-3
2011-12,2012-01-15,Calgary Flames,0,Northwest,Western,47,2,92,0.5108695652173914,59,-12,51,-4
2011-12,2012-01-18,Calgary Flames,1,Northwest,Western,48,2,94,0.5106382978723404,60,-12,51,-3
2011-12,2012-01-20,Calgary Flames,2,Northwest,Western,50,2,96,0.5208333333333334,60,-10,52,-2
2011-12,2012-01-22,Calgary Flames,2,Northwest,Western,52,2,98,0.5306122448979592,62,-10,54,-2
2011-12,2012-01-25,Calgary Flames,0,Northwest,Western,52,2,100,0.52,64,-12,55,-3
2011-12,2012-02-01,Calgary Flames,0,Northwest,Western,52,2,102,0.5098039215686274,66,-14,55,-3
2011-12,2012-02-04,Calgary Flames,2,Northwest,Western,54,2,104,0.5192307692307693,69,-15,57,-3
2011-12,2012-02-07,Calgary Flames,1,Northwest,Western,55,2,106,0.5188679245283019,69,-14,58,-3
2011-12,2012-02-09,Calgary Flames,2,Northwest,Western,57,2,108,0.5277777777777778,71,-14,58,-1
2011-12,2012-02-10,Calgary Flames,1,Northwest,Western,58,2,110,0.5272727272727272,73,-15,60,-2
2011-12,2012-02-12,Calgary Flames,2,Northwest,Western,60,2,112,0.5357142857142857,74,-14,62,-2
2011-12,2012-02-15,Calgary Flames,2,Northwest,Western,62,2,114,0.543859649122807,76,-14,63,-1
2011-12,2012-02-17,Calgary Flames,1,Northwest,Western,63,2,116,0.5431034482758621,78,-15,65,-2
2011-12,2012-02-19,Calgary Flames,2,Northwest,Western,65,2,118,0.5508474576271186,80,-15,65,0
2011-12,2012-02-22,Calgary Flames,0,Northwest,Western,65,2,120,0.5416666666666666,82,-17,66,-1
2011-12,2012-02-24,Calgary Flames,1,Northwest,Western,66,2,122,0.5409836065573771,84,-18,66,0
2011-12,2012-02-26,Calgary Flames,1,Northwest,Western,67,2,124,0.5403225806451613,87,-20,70,-3
2011-12,2012-02-28,Calgary Flames,0,Northwest,Western,67,2,126,0.5317460317460317,87,-20,70,-3
2011-12,2012-03-02,Calgary Flames,2,Northwest,Western,69,2,128,0.5390625,90,-21,71,-2
2011-12,2012-03-03,Calgary Flames,0,Northwest,Western,69,2,130,0.5307692307692308,90,-21,73,-4
2011-12,2012-03-04,Calgary Flames,1,Northwest,Western,70,2,132,0.5303030303030303,90,-20,73,-3
2011-12,2012-03-07,Calgary Flames,2,Northwest,Western,72,2,134,0.5373134328358209,90,-18,74,-2
2011-12,2012-03-10,Calgary Flames,2,Northwest,Western,74,2,136,0.5441176470588235,92,-18,76,-2
2011-12,2012-03-11,Calgary Flames,2,Northwest,Western,76,2,138,0.5507246376811594,92,-16,76,0
2011-12,2012-03-14,Calgary Flames,2,Northwest,Western,78,2,140,0.5571428571428572,92,-14,79,-1
2011-12,2012-03-16,Calgary Flames,2,Northwest,Western,80,2,142,0.5633802816901409,92,-12,81,-1
2011-12,2012-03-17,Calgary Flames,0,Northwest,Western,80,2,144,0.5555555555555556,92,-12,81,-1
2011-12,2012-03-19,Calgary Flames,1,Northwest,Western,81,2,146,0.5547945205479452,94,-13,83,-2
2011-12,2012-03-21,Calgary Flames,1,Northwest,Western,82,2,148,0.5540540540540541,94,-12,84,-2
2011-12,2012-03-23,Calgary Flames,1,Northwest,Western,83,2,150,0.5533333333333333,97,-14,85,-2
2011-12,2012-03-24,Calgary Flames,0,Northwest,Western,83,2,152,0.5460526315789473,97,-14,86,-3
2011-12,2012-03-27,Calgary Flames,2,Northwest,Western,85,2,154,0.551948051948052,101,-16,87,-2
2011-12,2012-03-29,Calgary Flames,0,Northwest,Western,85,2,156,0.5448717948717948,103,-18,88,-3
2011-12,2012-03-31,Calgary Flames,0,Northwest,Western,85,2,158,0.5379746835443038,105,-20,89,-4
2011-12,2012-04-01,Calgary Flames,1,Northwest,Western,86,2,160,0.5375,107,-21,90,-4
2011-12,2012-04-06,Calgary Flames,2,Northwest,Western,88,2,162,0.5432098765432098,109,-21,94,-6
2011-12,2012-04-07,Calgary Flames,2,Northwest,Western,90,2,164,0.5487804878048781,109,-19,94,-4
2011-12,2011-10-07,Carolina Hurricanes,0,Southeast,Eastern,0,2,2,0.0,2,-2,0,0
2011-12,2011-10-08,Carolina Hurricanes,1,Southeast,Eastern,1,2,4,0.25,2,-1,1,0
2011-12,2011-10-10,Carolina Hurricanes,0,Southeast,Eastern,1,2,6,0.16666666666666666,4,-3,2,-1
2011-12,2011-10-12,Carolina Hurricanes,2,Southeast,Eastern,3,2,8,0.375,4,-1,2,1
2011-12,2011-10-14,Carolina Hurricanes,2,Southeast,Eastern,5,2,10,0.5,6,-1,4,1
2011-12,2011-10-18,Carolina Hurricanes,2,Southeast,Eastern,7,2,12,0.5833333333333334,10,-3,6,1
2011-12,2011-10-22,Carolina Hurricanes,1,Southeast,Eastern,8,2,14,0.5714285714285714,14,-6,8,0
2011-12,2011-10-22,Carolina Hurricanes,0,Southeast,Eastern,8,2,16,0.5,14,-6,8,0
2011-12,2011-10-25,Carolina Hurricanes,1,Southeast,Eastern,9,2,18,0.5,14,-5,9,0
2011-12,2011-10-28,Carolina Hurricanes,2,Southeast,Eastern,11,2,20,0.55,14,-3,10,1
2011-12,2011-10-29,Carolina Hurricanes,0,Southeast,Eastern,11,2,22,0.5,14,-3,12,-1
2011-12,2011-11-01,Carolina Hurricanes,2,Southeast,Eastern,13,2,24,0.5416666666666666,16,-3,12,1
2011-12,2011-11-04,Carolina Hurricanes,0,Southeast,Eastern,13,2,26,0.5,18,-5,14,-1
2011-12,2011-11-06,Carolina Hurricanes,0,Southeast,Eastern,13,2,28,0.4642857142857143,18,-5,15,-2
2011-12,2011-11-09,Carolina Hurricanes,0,Southeast,Eastern,13,2,30,0.43333333333333335,18,-5,16,-3
2011-12,2011-11-12,Carolina Hurricanes,0,Southeast,Eastern,13,2,32,0.40625,20,-7,18,-5
2011-12,2011-11-13,Carolina Hurricanes,2,Southeast,Eastern,15,2,34,0.4411764705882353,21,-6,18,-3
2011-12,2011-11-15,Carolina Hurricanes,0,Southeast,Eastern,15,2,36,0.4166666666666667,21,-6,18,-3
2011-12,2011-11-17,Carolina Hurricanes,0,Southeast,Eastern,15,2,38,0.39473684210526316,21,-6,19,-4
2011-12,2011-11-19,Carolina Hurricanes,0,Southeast,Eastern,15,2,40,0.375,21,-6,21,-6
2011-12,2011-11-20,Carolina Hurricanes,2,Southeast,Eastern,17,2,42,0.40476190476190477,23,-6,21,-4
2011-12,2011-11-22,Carolina Hurricanes,2,Southeast,Eastern,19,2,44,0.4318181818181818,25,-6,23,-4
2011-12,2011-11-24,Carolina Hurricanes,1,Southeast,Eastern,20,2,46,0.43478260869565216,27,-7,23,-3
2011-12,2011-11-26,Carolina Hurricanes,0,Southeast,Eastern,20,2,48,0.4166666666666667,28,-8,25,-5
2011-12,2011-11-27,Carolina Hurricanes,0,Southeast,Eastern,20,2,50,0.4,28,-8,25,-5
2011-12,2011-11-30,Carolina Hurricanes,0,Southeast,Eastern,20,2,52,0.38461538461538464,30,-10,26,-6
2011-12,2011-12-02,Carolina Hurricanes,0,Southeast,Eastern,20,2,54,0.37037037037037035,30,-10,26,-6
2011-12,2011-12-04,Carolina Hurricanes,0,Southeast,Eastern,20,2,56,0.35714285714285715,32,-12,27,-7
2011-12,2011-12-07,Carolina Hurricanes,0,Southeast,Eastern,20,2,58,0.3448275862068966,34,-14,29,-9
2011-12,2011-12-08,Carolina Hurricanes,2,Southeast,Eastern,22,2,60,0.36666666666666664,34,-12,29,-7
2011-12,2011-12-10,Carolina Hurricanes,0,Southeast,Eastern,22,2,62,0.3548387096774194,37,-15,31,-9
2011-12,2011-12-14,Carolina Hurricanes,1,Southeast,Eastern,23,2,64,0.359375,38,-15,33,-10
2011-12,2011-12-16,Carolina Hurricanes,2,Southeast,Eastern,25,2,66,0.3787878787878788,38,-13,33,-8
2011-12,2011-12-18,Carolina Hurricanes,1,Southeast,Eastern,26,2,68,0.38235294117647056,42,-16,35,-9
2011-12,2011-12-22,Carolina Hurricanes,0,Southeast,Eastern,26,2,70,0.37142857142857144,42,-16,36,-10
2011-12,2011-12-24,Carolina Hurricanes,2,Southeast,Eastern,28,2,72,0.3888888888888889,43,-15,39,-11
2011-12,2011-12-27,Carolina Hurricanes,2,Southeast,Eastern,30,2,74,0.40540540540540543,43,-13,39,-9
2011-12,2011-12-28,Carolina Hurricanes,0,Southeast,Eastern,30,2,76,0.39473684210526316,45,-15,39,-9
2011-12,2011-12-30,Carolina Hurricanes,2,Southeast,Eastern,32,2,78,0.41025641025641024,45,-13,41,-9
2011-12,2011-12-31,Carolina Hurricanes,0,Southeast,Eastern,32,2,80,0.4,45,-13,41,-9
2011-12,2012-01-04,Carolina Hurricanes,1,Southeast,Eastern,33,2,82,0.4024390243902439,47,-14,44,-11
2011-12,2012-01-07,Carolina Hurricanes,2,Southeast,Eastern,35,2,84,0.4166666666666667,48,-13,45,-10
2011-12,2012-01-08,Carolina Hurricanes,0,Southeast,Eastern,35,2,86,0.4069767441860465,48,-13,46,-11
2011-12,2012-01-11,Carolina Hurricanes,0,Southeast,Eastern,35,2,88,0.3977272727272727,50,-15,46,-11
2011-12,2012-01-13,Carolina Hurricanes,2,Southeast,Eastern,37,2,90,0.4111111111111111,50,-13,46,-9
2011-12,2012-01-15,Carolina Hurricanes,2,Southeast,Eastern,39,2,92,0.42391304347826086,50,-11,50,-11
2011-12,2012-01-15,Carolina Hurricanes,0,Southeast,Eastern,39,2,94,0.4148936170212766,50,-11,50,-11
2011-12,2012-01-18,Carolina Hurricanes,1,Southeast,Eastern,40,2,96,0.4166666666666667,51,-11,50,-10
2011-12,2012-01-21,Carolina Hurricanes,2,Southeast,Eastern,42,2,98,0.42857142857142855,52,-10,52,-10
2011-12,2012-01-22,Carolina Hurricanes,1,Southeast,Eastern,43,2,100,0.43,54,-11,53,-10
2011-12,2012-01-24,Carolina Hurricanes,2,Southeast,Eastern,45,2,102,0.4411764705882353,54,-9,53,-8
2011-12,2012-02-01,Carolina Hurricanes,0,Southeast,Eastern,45,2,104,0.4326923076923077,56,-11,56,-11
2011-12,2012-02-03,Carolina Hurricanes,2,Southeast,Eastern,47,2,106,0.44339622641509435,57,-10,57,-10
2011-12,2012-02-05,Carolina Hurricanes,2,Southeast,Eastern,49,2,108,0.4537037037037037,59,-10,59,-10
2011-12,2012-02-09,Carolina Hurricanes,1,Southeast,Eastern,50,2,110,0.45454545454545453,60,-10,60,-10
2011-12,2012-02-11,Carolina Hurricanes,1,Southeast,Eastern,51,2,112,0.45535714285714285,63,-12,62,-11
2011-12,2012-02-14,Carolina Hurricanes,2,Southeast,Eastern,53,2,114,0.4649122807017544,65,-12,62,-9
2011-12,2012-02-18,Carolina Hurricanes,2,Southeast,Eastern,55,2,116,0.47413793103448276,65,-10,64,-9
2011-12,2012-02-19,Carolina Hurricanes,0,Southeast,Eastern,55,2,118,0.4661016949152542,65,-10,64,-9
2011-12,2012-02-21,Carolina Hurricanes,2,Southeast,Eastern,57,2,120,0.475,65,-8,64,-7
2011-12,2012-02-24,Carolina Hurricanes,1,Southeast,Eastern,58,2,122,0.47540983606557374,67,-9,66,-8
2011-12,2012-02-26,Carolina Hurricanes,1,Southeast,Eastern,59,2,124,0.47580645161290325,70,-11,68,-9
2011-12,2012-02-29,Carolina Hurricanes,2,Southeast,Eastern,61,2,126,0.48412698412698413,72,-11,69,-8
2011-12,2012-03-02,Carolina Hurricanes,0,Southeast,Eastern,61,2,128,0.4765625,72,-11,70,-9
2011-12,2012-03-04,Carolina Hurricanes,1,Southeast,Eastern,62,2,130,0.47692307692307695,74,-12,70,-8
2011-12,2012-03-07,Carolina Hurricanes,2,Southeast,Eastern,64,2,132,0.48484848484848486,74,-10,72,-8
2011-12,2012-03-08,Carolina Hurricanes,1,Southeast,Eastern,65,2,134,0.48507462686567165,74,-9,72,-7
2011-12,2012-03-11,Carolina Hurricanes,2,Southeast,Eastern,67,2,136,0.49264705882352944,77,-10,76,-9
2011-12,2012-03-11,Carolina Hurricanes,0,Southeast,Eastern,67,2,138,0.4855072463768116,77,-10,76,-9
2011-12,2012-03-13,Carolina Hurricanes,0,Southeast,Eastern,67,2,140,0.4785714285714286,79,-12,78,-11
2011-12,2012-03-15,Carolina Hurricanes,2,Southeast,Eastern,69,2,142,0.4859154929577465,81,-12,78,-9
2011-12,2012-03-17,Carolina Hurricanes,2,Southeast,Eastern,71,2,144,0.4930555555555556,83,-12,78,-7
2011-12,2012-03-19,Carolina Hurricanes,2,Southeast,Eastern,73,2,146,0.5,83,-10,80,-7
2011-12,2012-03-21,Carolina Hurricanes,2,Southeast,Eastern,75,2,148,0.5067567567567568,85,-10,80,-5
2011-12,2012-03-23,Carolina Hurricanes,0,Southeast,Eastern,75,2,150,0.5,86,-11,82,-7
2011-12,2012-03-24,Carolina Hurricanes,0,Southeast,Eastern,75,2,152,0.4934210526315789,86,-11,84,-9
2011-12,2012-03-27,Carolina Hurricanes,2,Southeast,Eastern,77,2,154,0.5,89,-12,86,-9
2011-12,2012-03-30,Carolina Hurricanes,1,Southeast,Eastern,78,2,156,0.5,90,-12,86,-8
2011-12,2012-03-31,Carolina Hurricanes,0,Southeast,Eastern,78,2,158,0.4936708860759494,90,-12,88,-10
2011-12,2012-04-03,Carolina Hurricanes,2,Southeast,Eastern,80,2,160,0.5,92,-12,88,-8
2011-12,2012-04-05,Carolina Hurricanes,2,Southeast,Eastern,82,2,162,0.5061728395061729,92,-10,90,-8
2011-12,2012-04-07,Carolina Hurricanes,0,Southeast,Eastern,82,2,164,0.5,94,-12,92,-10
2011-12,2011-10-08,Chicago Blackhawks,0,Central,Western,0,2,2,0.0,2,-2,0,0
2011-12,2011-10-09,Chicago Blackhawks,2,Central,Western,2,2,4,0.5,4,-2,2,0
2011-12,2011-10-14,Chicago Blackhawks,2,Central,Western,4,2,6,0.6666666666666666,6,-2,3,1
2011-12,2011-10-16,Chicago Blackhawks,1,Central,Western,5,2,8,0.625,8,-3,5,0
2011-12,2011-10-19,Chicago Blackhawks,2,Central,Western,7,2,10,0.7,8,-1,5,2
2011-12,2011-10-21,Chicago Blackhawks,2,Central,Western,9,2,12,0.75,10,-1,7,2
2011-12,2011-10-23,Chicago Blackhawks,1,Central,Western,10,2,14,0.7142857142857143,10,0,8,2
2011-12,2011-10-26,Chicago Blackhawks,2,Central,Western,12,2,16,0.75,12,0,9,3
2011-12,2011-10-28,Chicago Blackhawks,0,Central,Western,12,2,18,0.6666666666666666,12,0,10,2
2011-12,2011-10-30,Chicago Blackhawks,2,Central,Western,14,2,20,0.7,14,0,11,3
2011-12,2011-11-01,Chicago Blackhawks,2,Central,Western,16,2,22,0.7272727272727273,16,0,12,4
2011-12,2011-11-03,Chicago Blackhawks,2,Central,Western,18,2,24,0.75,18,0,13,5
2011-12,2011-11-04,Chicago Blackhawks,1,Central,Western,19,2,26,0.7307692307692307,19,0,14,5
2011-12,2011-11-07,Chicago Blackhawks,0,Central,Western,19,2,28,0.6785714285714286,19,0,15,4
2011-12,2011-11-09,Chicago Blackhawks,0,Central,Western,19,2,30,0.6333333333333333,19,0,16,3
2011-12,2011-11-11,Chicago Blackhawks,2,Central,Western,21,2,32,0.65625,21,0,17,4
2011-12,2011-11-12,Chicago Blackhawks,2,Central,Western,23,2,34,0.6764705882352942,23,0,17,6
2011-12,2011-11-14,Chicago Blackhawks,2,Central,Western,25,2,36,0.6944444444444444,25,0,19,6
2011-12,2011-11-17,Chicago Blackhawks,2,Central,Western,27,2,38,0.7105263157894737,27,0,19,8
2011-12,2011-11-19,Chicago Blackhawks,0,Central,Western,27,2,40,0.675,27,0,21,6
2011-12,2011-11-20,Chicago Blackhawks,0,Central,Western,27,2,42,0.6428571428571429,27,0,22,5
2011-12,2011-11-24,Chicago Blackhawks,0,Central,Western,27,2,44,0.6136363636363636,27,0,24,3
2011-12,2011-11-25,Chicago Blackhawks,2,Central,Western,29,2,46,0.6304347826086957,29,0,25,4
2011-12,2011-11-27,Chicago Blackhawks,2,Central,Western,31,2,48,0.6458333333333334,31,0,27,4
2011-12,2011-11-30,Chicago Blackhawks,0,Central,Western,31,2,50,0.62,31,0,28,3
2011-12,2011-12-03,Chicago Blackhawks,2,Central,Western,33,2,52,0.6346153846153846,33,0,29,4
2011-12,2011-12-04,Chicago Blackhawks,2,Central,Western,35,2,54,0.6481481481481481,35,0,29,6
2011-12,2011-12-06,Chicago Blackhawks,1,Central,Western,36,2,56,0.6428571428571429,36,0,30,6
2011-12,2011-12-09,Chicago Blackhawks,2,Central,Western,38,2,58,0.6551724137931034,38,0,31,7
2011-12,2011-12-12,Chicago Blackhawks,2,Central,Western,40,2,60,0.6666666666666666,40,0,32,8
2011-12,2011-12-15,Chicago Blackhawks,2,Central,Western,42,2,62,0.6774193548387096,42,0,33,9
2011-12,2011-12-17,Chicago Blackhawks,2,Central,Western,44,2,64,0.6875,44,0,35,9
2011-12,2011-12-19,Chicago Blackhawks,2,Central,Western,46,2,66,0.696969696969697,46,0,37,9
2011-12,2011-12-21,Chicago Blackhawks,0,Central,Western,46,2,68,0.6764705882352942,46,0,37,9
2011-12,2011-12-22,Chicago Blackhawks,2,Central,Western,48,2,70,0.6857142857142857,48,0,39,9
2011-12,2011-12-27,Chicago Blackhawks,2,Central,Western,50,2,72,0.6944444444444444,50,0,40,10
2011-12,2011-12-29,Chicago Blackhawks,0,Central,Western,50,2,74,0.6756756756756757,50,0,41,9
2011-12,2011-12-31,Chicago Blackhawks,2,Central,Western,52,2,76,0.6842105263157895,52,0,42,10
2011-12,2012-01-03,Chicago Blackhawks,0,Central,Western,52,2,78,0.6666666666666666,52,0,45,7
2011-12,2012-01-06,Chicago Blackhawks,0,Central,Western,52,2,80,0.65,52,0,46,6
2011-12,2012-01-07,Chicago Blackhawks,0,Central,Western,52,2,82,0.6341463414634146,52,0,47,5
2011-12,2012-01-09,Chicago Blackhawks,1,Central,Western,53,2,84,0.6309523809523809,53,0,47,6
2011-12,2012-01-11,Chicago Blackhawks,2,Central,Western,55,2,86,0.6395348837209303,55,0,49,6
2011-12,2012-01-13,Chicago Blackhawks,2,Central,Western,57,2,88,0.6477272727272727,57,0,50,7
2011-12,2012-01-14,Chicago Blackhawks,1,Central,Western,58,2,90,0.6444444444444445,58,0,50,8
2011-12,2012-01-16,Chicago Blackhawks,2,Central,Western,60,2,92,0.6521739130434783,60,0,51,9
2011-12,2012-01-19,Chicago Blackhawks,2,Central,Western,62,2,94,0.6595744680851063,62,0,52,10
2011-12,2012-01-21,Chicago Blackhawks,2,Central,Western,64,2,96,0.6666666666666666,64,0,52,12
2011-12,2012-01-22,Chicago Blackhawks,0,Central,Western,64,2,98,0.6530612244897959,65,-1,54,10
2011-12,2012-01-25,Chicago Blackhawks,0,Central,Western,64,2,100,0.64,67,-3,55,9
2011-12,2012-02-01,Chicago Blackhawks,1,Central,Western,65,2,102,0.6372549019607843,69,-4,55,10
2011-12,2012-02-03,Chicago Blackhawks,0,Central,Western,65,2,104,0.625,71,-6,57,8
2011-12,2012-02-04,Chicago Blackhawks,0,Central,Western,65,2,106,0.6132075471698113,71,-6,57,8
2011-12,2012-02-08,Chicago Blackhawks,0,Central,Western,65,2,108,0.6018518518518519,72,-7,58,7
2011-12,2012-02-11,Chicago Blackhawks,0,Central,Western,65,2,110,0.5909090909090909,76,-11,60,5
2011-12,2012-02-12,Chicago Blackhawks,0,Central,Western,65,2,112,0.5803571428571429,76,-11,62,3
2011-12,2012-02-15,Chicago Blackhawks,0,Central,Western,65,2,114,0.5701754385964912,80,-15,63,2
2011-12,2012-02-17,Chicago Blackhawks,2,Central,Western,67,2,116,0.5775862068965517,80,-13,65,2
2011-12,2012-02-18,Chicago Blackhawks,2,Central,Western,69,2,118,0.5847457627118644,82,-13,65,4
2011-12,2012-02-19,Chicago Blackhawks,2,Central,Western,71,2,120,0.5916666666666667,84,-13,65,6
2011-12,2012-02-22,Chicago Blackhawks,2,Central,Western,73,2,122,0.5983606557377049,84,-11,66,7
2011-12,2012-02-24,Chicago Blackhawks,0,Central,Western,73,2,124,0.5887096774193549,85,-12,66,7
2011-12,2012-02-26,Chicago Blackhawks,0,Central,Western,73,2,126,0.5793650793650794,85,-12,70,3
2011-12,2012-02-27,Chicago Blackhawks,0,Central,Western,73,2,128,0.5703125,85,-12,70,3
2011-12,2012-03-01,Chicago Blackhawks,2,Central,Western,75,2,130,0.5769230769230769,87,-12,71,4
2011-12,2012-03-03,Chicago Blackhawks,2,Central,Western,77,2,132,0.5833333333333334,89,-12,73,4
2011-12,2012-03-04,Chicago Blackhawks,2,Central,Western,79,2,134,0.5895522388059702,89,-10,73,6
2011-12,2012-03-07,Chicago Blackhawks,0,Central,Western,79,2,136,0.5808823529411765,91,-12,74,5
2011-12,2012-03-10,Chicago Blackhawks,2,Central,Western,81,2,138,0.5869565217391305,93,-12,76,5
2011-12,2012-03-12,Chicago Blackhawks,1,Central,Western,82,2,140,0.5857142857142857,97,-15,76,6
2011-12,2012-03-14,Chicago Blackhawks,2,Central,Western,84,2,142,0.5915492957746479,98,-14,79,5
2011-12,2012-03-17,Chicago Blackhawks,2,Central,Western,86,2,144,0.5972222222222222,100,-14,81,5
2011-12,2012-03-18,Chicago Blackhawks,2,Central,Western,88,2,146,0.6027397260273972,100,-12,82,6
2011-12,2012-03-20,Chicago Blackhawks,2,Central,Western,90,2,148,0.6081081081081081,100,-10,83,7
2011-12,2012-03-22,Chicago Blackhawks,2,Central,Western,92,2,150,0.6133333333333333,100,-8,84,8
2011-12,2012-03-25,Chicago Blackhawks,0,Central,Western,92,2,152,0.6052631578947368,101,-9,86,6
2011-12,2012-03-27,Chicago Blackhawks,1,Central,Western,93,2,154,0.6038961038961039,103,-10,87,6
2011-12,2012-03-30,Chicago Blackhawks,2,Central,Western,95,2,156,0.6089743589743589,106,-11,88,7
2011-12,2012-04-01,Chicago Blackhawks,1,Central,Western,96,2,158,0.6075949367088608,106,-10,90,6
2011-12,2012-04-01,Chicago Blackhawks,2,Central,Western,98,2,160,0.6125,106,-8,90,8
2011-12,2012-04-06,Chicago Blackhawks,1,Central,Western,99,2,162,0.6111111111111112,107,-8,94,5
2011-12,2012-04-07,Chicago Blackhawks,2,Central,Western,101,2,164,0.6158536585365854,107,-6,94,7
2011-12,2011-10-09,Colorado Avalanche,0,Northwest,Western,0,2,2,0.0,2,-2,2,-2
2011-12,2011-10-10,Colorado Avalanche,2,Northwest,Western,2,2,4,0.5,3,-1,2,0
2011-12,2011-10-12,Colorado Avalanche,2,Northwest,Western,4,2,6,0.6666666666666666,4,0,2,2
2011-12,2011-10-13,Colorado Avalanche,2,Northwest,Western,6,2,8,0.75,6,0,2,4
2011-12,2011-10-15,Colorado Avalanche,2,Northwest,Western,8,2,10,0.8,8,0,4,4
2011-12,2011-10-17,Colorado Avalanche,2,Northwest,Western,10,2,12,0.8333333333333334,10,0,5,5
2011-12,2011-10-21,Colorado Avalanche,0,Northwest,Western,10,2,14,0.7142857142857143,10,0,7,3
2011-12,2011-10-23,Colorado Avalanche,2,Northwest,Western,12,2,16,0.75,12,0,8,4
2011-12,2011-10-27,Colorado Avalanche,0,Northwest,Western,12,2,18,0.6666666666666666,12,0,9,3
2011-12,2011-10-29,Colorado Avalanche,0,Northwest,Western,12,2,20,0.6,14,-2,10,2
2011-12,2011-10-31,Colorado Avalanche,2,Northwest,Western,14,2,22,0.6363636363636364,16,-2,11,3
2011-12,2011-11-03,Colorado Avalanche,0,Northwest,Western,14,2,24,0.5833333333333334,16,-2,13,1
2011-12,2011-11-05,Colorado Avalanche,1,Northwest,Western,15,2,26,0.5769230769230769,18,-3,14,1
2011-12,2011-11-07,Colorado Avalanche,0,Northwest,Western,15,2,28,0.5357142857142857,18,-3,15,0
2011-12,2011-11-09,Colorado Avalanche,0,Northwest,Western,15,2,30,0.5,20,-5,16,-1
2011-12,2011-11-11,Colorado Avalanche,2,Northwest,Western,17,2,32,0.53125,20,-3,17,0
2011-12,2011-11-13,Colorado Avalanche,0,Northwest,Western,17,2,34,0.5,20,-3,19,-2
2011-12,2011-11-16,Colorado Avalanche,0,Northwest,Western,17,2,36,0.4722222222222222,23,-6,19,-2
2011-12,2011-11-18,Colorado Avalanche,0,Northwest,Western,17,2,38,0.4473684210526316,25,-8,21,-4
2011-12,2011-11-19,Colorado Avalanche,2,Northwest,Western,19,2,40,0.475,25,-6,21,-2
2011-12,2011-11-21,Colorado Avalanche,0,Northwest,Western,19,2,42,0.4523809523809524,27,-8,22,-3
2011-12,2011-11-24,Colorado Avalanche,0,Northwest,Western,19,2,44,0.4318181818181818,29,-10,24,-5
2011-12,2011-11-27,Colorado Avalanche,2,Northwest,Western,21,2,46,0.45652173913043476,29,-8,27,-6
2011-12,2011-11-29,Colorado Avalanche,0,Northwest,Western,21,2,48,0.4375,31,-10,27,-6
2011-12,2011-12-01,Colorado Avalanche,2,Northwest,Western,23,2,50,0.46,33,-10,28,-5
2011-12,2011-12-03,Colorado Avalanche,2,Northwest,Western,25,2,52,0.4807692307692308,35,-10,29,-4
2011-12,2011-12-05,Colorado Avalanche,2,Northwest,Western,27,2,54,0.5,37,-10,29,-2
2011-12,2011-12-07,Colorado Avalanche,0,Northwest,Western,27,2,56,0.48214285714285715,39,-12,30,-3
2011-12,2011-12-09,Colorado Avalanche,0,Northwest,Western,27,2,58,0.46551724137931033,41,-14,31,-4
2011-12,2011-12-10,Colorado Avalanche,0,Northwest,Western,27,2,60,0.45,41,-14,31,-4
2011-12,2011-12-14,Colorado Avalanche,2,Northwest,Western,29,2,62,0.46774193548387094,43,-14,33,-4
2011-12,2011-12-16,Colorado Avalanche,0,Northwest,Western,29,2,64,0.453125,44,-15,35,-6
2011-12,2011-12-18,Colorado Avalanche,2,Northwest,Western,31,2,66,0.4696969696969697,45,-14,37,-6
2011-12,2011-12-20,Colorado Avalanche,2,Northwest,Western,33,2,68,0.4852941176470588,45,-12,37,-4
2011-12,2011-12-22,Colorado Avalanche,2,Northwest,Western,35,2,70,0.5,45,-10,39,-4
2011-12,2011-12-24,Colorado Avalanche,2,Northwest,Western,37,2,72,0.5138888888888888,45,-8,40,-3
2011-12,2011-12-26,Colorado Avalanche,2,Northwest,Western,39,2,74,0.527027027027027,45,-6,40,-1
2011-12,2011-12-28,Colorado Avalanche,0,Northwest,Western,39,2,76,0.5131578947368421,46,-7,40,-1
2011-12,2011-12-30,Colorado Avalanche,2,Northwest,Western,41,2,78,0.5256410256410257,50,-9,42,-1
2011-12,2012-01-01,Colorado Avalanche,2,Northwest,Western,43,2,80,0.5375,50,-7,43,0
2011-12,2012-01-03,Colorado Avalanche,2,Northwest,Western,45,2,82,0.5487804878048781,51,-6,45,0
2011-12,2012-01-07,Colorado Avalanche,2,Northwest,Western,47,2,84,0.5595238095238095,55,-8,47,0
2011-12,2012-01-08,Colorado Avalanche,0,Northwest,Western,47,2,86,0.5465116279069767,55,-8,47,0
2011-12,2012-01-11,Colorado Avalanche,0,Northwest,Western,47,2,88,0.5340909090909091,57,-10,49,-2
2011-12,2012-01-13,Colorado Avalanche,1,Northwest,Western,48,2,90,0.5333333333333333,59,-11,50,-2
2011-12,2012-01-14,Colorado Avalanche,2,Northwest,Western,50,2,92,0.5434782608695652,59,-9,50,0
2011-12,2012-01-16,Colorado Avalanche,0,Northwest,Western,50,2,94,0.5319148936170213,59,-9,51,-1
2011-12,2012-01-19,Colorado Avalanche,2,Northwest,Western,52,2,96,0.5416666666666666,60,-8,52,0
2011-12,2012-01-22,Colorado Avalanche,2,Northwest,Western,54,2,98,0.5510204081632653,62,-8,54,0
2011-12,2012-01-23,Colorado Avalanche,0,Northwest,Western,54,2,100,0.54,62,-8,54,0
2011-12,2012-01-25,Colorado Avalanche,0,Northwest,Western,54,2,102,0.5294117647058824,64,-10,55,-1
2011-12,2012-02-01,Colorado Avalanche,0,Northwest,Western,54,2,104,0.5192307692307693,66,-12,55,-1
2011-12,2012-02-03,Colorado Avalanche,0,Northwest,Western,54,2,106,0.5094339622641509,67,-13,57,-3
2011-12,2012-02-04,Colorado Avalanche,1,Northwest,Western,55,2,108,0.5092592592592593,69,-14,57,-2
2011-12,2012-02-08,Colorado Avalanche,2,Northwest,Western,57,2,110,0.5181818181818182,71,-14,58,-1
2011-12,2012-02-11,Colorado Avalanche,2,Northwest,Western,59,2,112,0.5267857142857143,73,-14,60,-1
2011-12,2012-02-12,Colorado Avalanche,1,Northwest,Western,60,2,114,0.5263157894736842,74,-14,62,-2
2011-12,2012-02-16,Colorado Avalanche,0,Northwest,Western,60,2,116,0.5172413793103449,78,-18,63,-3
2011-12,2012-02-18,Colorado Avalanche,2,Northwest,Western,62,2,118,0.5254237288135594,78,-16,65,-3
2011-12,2012-02-20,Colorado Avalanche,0,Northwest,Western,62,2,120,0.5166666666666667,82,-20,65,-3
2011-12,2012-02-23,Colorado Avalanche,2,Northwest,Western,64,2,122,0.5245901639344263,82,-18,66,-2
2011-12,2012-02-25,Colorado Avalanche,2,Northwest,Western,66,2,124,0.532258064516129,86,-20,68,-2
2011-12,2012-02-26,Colorado Avalanche,2,Northwest,Western,68,2,126,0.5396825396825397,87,-19,70,-2
2011-12,2012-02-28,Colorado Avalanche,2,Northwest,Western,70,2,128,0.546875,87,-17,70,0
2011-12,2012-03-02,Colorado Avalanche,0,Northwest,Western,70,2,130,0.5384615384615384,90,-20,71,-1
2011-12,2012-03-04,Colorado Avalanche,0,Northwest,Western,70,2,132,0.5303030303030303,90,-20,73,-3
2011-12,2012-03-05,Colorado Avalanche,2,Northwest,Western,72,2,134,0.5373134328358209,90,-18,73,-1
2011-12,2012-03-07,Colorado Avalanche,2,Northwest,Western,74,2,136,0.5441176470588235,90,-16,74,0
2011-12,2012-03-09,Colorado Avalanche,0,Northwest,Western,74,2,138,0.5362318840579711,92,-18,75,-1
2011-12,2012-03-10,Colorado Avalanche,2,Northwest,Western,76,2,140,0.5428571428571428,92,-16,76,0
2011-12,2012-03-13,Colorado Avalanche,2,Northwest,Western,78,2,142,0.5492957746478874,92,-14,78,0
2011-12,2012-03-14,Colorado Avalanche,2,Northwest,Western,80,2,144,0.5555555555555556,92,-12,79,1
2011-12,2012-03-15,Colorado Avalanche,1,Northwest,Western,81,2,146,0.5547945205479452,92,-11,81,0
2011-12,2012-03-17,Colorado Avalanche,2,Northwest,Western,83,2,148,0.5608108108108109,92,-9,81,2
2011-12,2012-03-21,Colorado Avalanche,2,Northwest,Western,85,2,150,0.5666666666666667,94,-9,84,1
2011-12,2012-03-23,Colorado Avalanche,0,Northwest,Western,85,2,152,0.5592105263157895,97,-12,85,0
2011-12,2012-03-25,Colorado Avalanche,1,Northwest,Western,86,2,154,0.5584415584415584,99,-13,86,0
2011-12,2012-03-27,Colorado Avalanche,0,Northwest,Western,86,2,156,0.5512820512820513,101,-15,87,-1
2011-12,2012-03-29,Colorado Avalanche,0,Northwest,Western,86,2,158,0.5443037974683544,103,-17,88,-2
2011-12,2012-03-31,Colorado Avalanche,2,Northwest,Western,88,2,160,0.55,105,-17,89,-1
2011-12,2012-04-06,Colorado Avalanche,0,Northwest,Western,88,2,162,0.5432098765432098,109,-21,94,-6
2011-12,2012-04-08,Colorado Avalanche,0,Northwest,Western,88,2,164,0.5365853658536586,111,-23,95,-7
2011-12,2011-10-07,Columbus Blue Jackets,0,Central,Western,0,2,2,0.0,2,-2,0,0
2011-12,2011-10-09,Columbus Blue Jackets,0,Central,Western,0,2,4,0.0,4,-4,2,-2
2011-12,2011-10-10,Columbus Blue Jackets,0,Central,Western,0,2,6,0.0,4,-4,2,-2
2011-12,2011-10-12,Columbus Blue Jackets,1,Central,Western,1,2,8,0.125,4,-3,2,-1
2011-12,2011-10-16,Columbus Blue Jackets,0,Central,Western,1,2,10,0.1,8,-7,5,-4
2011-12,2011-10-18,Columbus Blue Jackets,0,Central,Western,1,2,12,0.08333333333333333,8,-7,5,-4
2011-12,2011-10-21,Columbus Blue Jackets,0,Central,Western,1,2,14,0.07142857142857142,10,-9,7,-6
2011-12,2011-10-22,Columbus Blue Jackets,0,Central,Western,1,2,16,0.0625,10,-9,8,-7
2011-12,2011-10-25,Columbus Blue Jackets,2,Central,Western,3,2,18,0.16666666666666666,10,-7,8,-5
2011-12,2011-10-27,Columbus Blue Jackets,0,Central,Western,3,2,20,0.15,12,-9,9,-6
2011-12,2011-10-30,Columbus Blue Jackets,0,Central,Western,3,2,22,0.13636363636363635,14,-11,11,-8
2011-12,2011-10-30,Columbus Blue Jackets,2,Central,Western,5,2,24,0.20833333333333334,14,-9,11,-6
2011-12,2011-11-03,Columbus Blue Jackets,0,Central,Western,5,2,26,0.19230769230769232,18,-13,13,-8
2011-12,2011-11-05,Columbus Blue Jackets,0,Central,Western,5,2,28,0.17857142857142858,19,-14,14,-9
2011-12,2011-11-11,Columbus Blue Jackets,0,Central,Western,5,2,30,0.16666666666666666,21,-16,17,-12
2011-12,2011-11-13,Columbus Blue Jackets,2,Central,Western,7,2,32,0.21875,23,-16,19,-12
2011-12,2011-11-16,Columbus Blue Jackets,0,Central,Western,7,2,34,0.20588235294117646,25,-18,19,-12
2011-12,2011-11-18,Columbus Blue Jackets,1,Central,Western,8,2,36,0.2222222222222222,27,-19,21,-13
2011-12,2011-11-20,Columbus Blue Jackets,2,Central,Western,10,2,38,0.2631578947368421,27,-17,22,-12
2011-12,2011-11-22,Columbus Blue Jackets,2,Central,Western,12,2,40,0.3,27,-15,23,-11
2011-12,2011-11-24,Columbus Blue Jackets,1,Central,Western,13,2,42,0.30952380952380953,27,-14,24,-11
2011-12,2011-11-26,Columbus Blue Jackets,2,Central,Western,15,2,44,0.3409090909090909,29,-14,26,-11
2011-12,2011-11-27,Columbus Blue Jackets,0,Central,Western,15,2,46,0.32608695652173914,31,-16,27,-12
2011-12,2011-11-30,Columbus Blue Jackets,0,Central,Western,15,2,48,0.3125,31,-16,28,-13
2011-12,2011-12-02,Columbus Blue Jackets,2,Central,Western,17,2,50,0.34,31,-14,29,-12
2011-12,2011-12-03,Columbus Blue Jackets,0,Central,Western,17,2,52,0.3269230769230769,33,-16,29,-12
2011-12,2011-12-07,Columbus Blue Jackets,2,Central,Western,19,2,54,0.35185185185185186,36,-17,30,-11
2011-12,2011-12-09,Columbus Blue Jackets,1,Central,Western,20,2,56,0.35714285714285715,38,-18,31,-11
2011-12,2011-12-11,Columbus Blue Jackets,0,Central,Western,20,2,58,0.3448275862068966,38,-18,32,-12
2011-12,2011-12-14,Columbus Blue Jackets,2,Central,Western,22,2,60,0.36666666666666664,40,-18,33,-11
2011-12,2011-12-16,Columbus Blue Jackets,0,Central,Western,22,2,62,0.3548387096774194,42,-20,35,-13
2011-12,2011-12-18,Columbus Blue Jackets,0,Central,Western,22,2,64,0.34375,44,-22,37,-15
2011-12,2011-12-19,Columbus Blue Jackets,0,Central,Western,22,2,66,0.3333333333333333,46,-24,37,-15
2011-12,2011-12-23,Columbus Blue Jackets,0,Central,Western,22,2,68,0.3235294117647059,48,-26,39,-17
2011-12,2011-12-27,Columbus Blue Jackets,0,Central,Western,22,2,70,0.3142857142857143,50,-28,40,-18
2011-12,2011-12-28,Columbus Blue Jackets,1,Central,Western,23,2,72,0.3194444444444444,50,-27,40,-17
2011-12,2011-12-30,Columbus Blue Jackets,2,Central,Western,25,2,74,0.33783783783783783,50,-25,42,-17
2011-12,2012-01-01,Columbus Blue Jackets,0,Central,Western,25,2,76,0.32894736842105265,52,-27,43,-18
2011-12,2012-01-06,Columbus Blue Jackets,0,Central,Western,25,2,78,0.32051282051282054,52,-27,46,-21
2011-12,2012-01-07,Columbus Blue Jackets,2,Central,Western,27,2,80,0.3375,52,-25,47,-20
2011-12,2012-01-09,Columbus Blue Jackets,0,Central,Western,27,2,82,0.32926829268292684,53,-26,47,-20
2011-12,2012-01-11,Columbus Blue Jackets,0,Central,Western,27,2,84,0.32142857142857145,55,-28,49,-22
2011-12,2012-01-14,Columbus Blue Jackets,2,Central,Western,29,2,86,0.3372093023255814,58,-29,50,-21
2011-12,2012-01-15,Columbus Blue Jackets,0,Central,Western,29,2,88,0.32954545454545453,58,-29,51,-22
2011-12,2012-01-18,Columbus Blue Jackets,2,Central,Western,31,2,90,0.34444444444444444,61,-30,51,-20
2011-12,2012-01-20,Columbus Blue Jackets,0,Central,Western,31,2,92,0.33695652173913043,63,-32,52,-21
2011-12,2012-01-22,Columbus Blue Jackets,1,Central,Western,32,2,94,0.3404255319148936,65,-33,54,-22
2011-12,2012-01-24,Columbus Blue Jackets,0,Central,Western,32,2,96,0.3333333333333333,67,-35,54,-22
2011-12,2012-01-25,Columbus Blue Jackets,0,Central,Western,32,2,98,0.32653061224489793,67,-35,55,-23
2011-12,2012-02-01,Columbus Blue Jackets,0,Central,Western,32,2,100,0.32,69,-37,55,-23
2011-12,2012-02-02,Columbus Blue Jackets,0,Central,Western,32,2,102,0.3137254901960784,69,-37,55,-23
2011-12,2012-02-04,Columbus Blue Jackets,2,Central,Western,34,2,104,0.3269230769230769,71,-37,57,-23
2011-12,2012-02-08,Columbus Blue Jackets,2,Central,Western,36,2,106,0.33962264150943394,72,-36,58,-22
2011-12,2012-02-10,Columbus Blue Jackets,0,Central,Western,36,2,108,0.3333333333333333,74,-38,60,-24
2011-12,2012-02-12,Columbus Blue Jackets,0,Central,Western,36,2,110,0.32727272727272727,76,-40,62,-26
2011-12,2012-02-12,Columbus Blue Jackets,2,Central,Western,38,2,112,0.3392857142857143,76,-38,62,-24
2011-12,2012-02-15,Columbus Blue Jackets,2,Central,Western,40,2,114,0.3508771929824561,80,-40,63,-23
2011-12,2012-02-18,Columbus Blue Jackets,0,Central,Western,40,2,116,0.3448275862068966,82,-42,65,-25
2011-12,2012-02-20,Columbus Blue Jackets,1,Central,Western,41,2,118,0.3474576271186441,84,-43,65,-24
2011-12,2012-02-22,Columbus Blue Jackets,2,Central,Western,43,2,120,0.35833333333333334,84,-41,66,-23
2011-12,2012-02-25,Columbus Blue Jackets,0,Central,Western,43,2,122,0.3524590163934426,85,-42,68,-25
2011-12,2012-02-26,Columbus Blue Jackets,0,Central,Western,43,2,124,0.3467741935483871,85,-42,70,-27
2011-12,2012-02-29,Columbus Blue Jackets,0,Central,Western,43,2,126,0.3412698412698413,87,-44,70,-27
2011-12,2012-03-02,Columbus Blue Jackets,2,Central,Western,45,2,128,0.3515625,87,-42,71,-26
2011-12,2012-03-04,Columbus Blue Jackets,2,Central,Western,47,2,130,0.36153846153846153,89,-42,73,-26
2011-12,2012-03-07,Columbus Blue Jackets,2,Central,Western,49,2,132,0.3712121212121212,91,-42,74,-25
2011-12,2012-03-09,Columbus Blue Jackets,2,Central,Western,51,2,134,0.3805970149253731,93,-42,75,-24
2011-12,2012-03-11,Columbus Blue Jackets,0,Central,Western,51,2,136,0.375,97,-46,76,-25
2011-12,2012-03-11,Columbus Blue Jackets,0,Central,Western,51,2,138,0.3695652173913043,97,-46,76,-25
2011-12,2012-03-15,Columbus Blue Jackets,0,Central,Western,51,2,140,0.36428571428571427,98,-47,81,-30
2011-12,2012-03-18,Columbus Blue Jackets,0,Central,Western,51,2,142,0.3591549295774648,100,-49,82,-31
2011-12,2012-03-19,Columbus Blue Jackets,2,Central,Western,53,2,144,0.3680555555555556,100,-47,83,-30
2011-12,2012-03-20,Columbus Blue Jackets,0,Central,Western,53,2,146,0.363013698630137,100,-47,83,-30
2011-12,2012-03-23,Columbus Blue Jackets,2,Central,Western,55,2,148,0.3716216216216216,101,-46,85,-30
2011-12,2012-03-25,Columbus Blue Jackets,0,Central,Western,55,2,150,0.36666666666666664,101,-46,86,-31
2011-12,2012-03-26,Columbus Blue Jackets,0,Central,Western,55,2,152,0.3618421052631579,103,-48,86,-31
2011-12,2012-03-28,Columbus Blue Jackets,2,Central,Western,57,2,154,0.37012987012987014,105,-48,87,-30
2011-12,2012-03-30,Columbus Blue Jackets,2,Central,Western,59,2,156,0.3782051282051282,106,-47,88,-29
2011-12,2012-04-01,Columbus Blue Jackets,2,Central,Western,61,2,158,0.3860759493670886,106,-45,90,-29
2011-12,2012-04-04,Columbus Blue Jackets,0,Central,Western,61,2,160,0.38125,107,-46,92,-31
2011-12,2012-04-06,Columbus Blue Jackets,2,Central,Western,63,2,162,0.3888888888888889,107,-44,94,-31
2011-12,2012-04-07,Columbus Blue Jackets,2,Central,Western,65,2,164,0.39634146341463417,107,-42,94,-29
2011-12,2011-10-08,Dallas Stars,2,Pacific,Western,2,2,2,1.0,2,0,0,2
2011-12,2011-10-09,Dallas Stars,0,Pacific,Western,2,2,4,0.5,2,0,2,0
2011-12,2011-10-10,Dallas Stars,2,Pacific,Western,4,2,6,0.6666666666666666,4,0,2,2
2011-12,2011-10-14,Dallas Stars,2,Pacific,Western,6,2,8,0.75,6,0,3,3
2011-12,2011-10-16,Dallas Stars,2,Pacific,Western,8,2,10,0.8,8,0,5,3
2011-12,2011-10-18,Dallas Stars,2,Pacific,Western,10,2,12,0.8333333333333334,10,0,5,5
2011-12,2011-10-22,Dallas Stars,2,Pacific,Western,12,2,14,0.8571428571428571,12,0,8,4
2011-12,2011-10-23,Dallas Stars,0,Pacific,Western,12,2,16,0.75,12,0,8,4
2011-12,2011-10-26,Dallas Stars,2,Pacific,Western,14,2,18,0.7777777777777778,14,0,9,5
2011-12,2011-10-28,Dallas Stars,0,Pacific,Western,14,2,20,0.7,14,0,10,4
2011-12,2011-10-30,Dallas Stars,2,Pacific,Western,16,2,22,0.7272727272727273,16,0,11,5
2011-12,2011-11-05,Dallas Stars,2,Pacific,Western,18,2,24,0.75,18,0,14,4
2011-12,2011-11-06,Dallas Stars,2,Pacific,Western,20,2,26,0.7692307692307693,20,0,15,5
2011-12,2011-11-09,Dallas Stars,2,Pacific,Western,22,2,28,0.7857142857142857,22,0,16,6
2011-12,2011-11-12,Dallas Stars,0,Pacific,Western,22,2,30,0.7333333333333333,22,0,17,5
2011-12,2011-11-13,Dallas Stars,0,Pacific,Western,22,2,32,0.6875,22,0,19,3
2011-12,2011-11-16,Dallas Stars,0,Pacific,Western,22,2,34,0.6470588235294118,22,0,19,3
2011-12,2011-11-19,Dallas Stars,0,Pacific,Western,22,2,36,0.6111111111111112,23,-1,21,1
2011-12,2011-11-20,Dallas Stars,0,Pacific,Western,22,2,38,0.5789473684210527,23,-1,22,0
2011-12,2011-11-22,Dallas Stars,2,Pacific,Western,24,2,40,0.6,25,-1,23,1
2011-12,2011-11-24,Dallas Stars,2,Pacific,Western,26,2,42,0.6190476190476191,27,-1,24,2
2011-12,2011-11-26,Dallas Stars,1,Pacific,Western,27,2,44,0.6136363636363636,27,0,26,1
2011-12,2011-11-27,Dallas Stars,0,Pacific,Western,27,2,46,0.5869565217391305,27,0,27,0
2011-12,2011-11-29,Dallas Stars,2,Pacific,Western,29,2,48,0.6041666666666666,29,0,27,2
2011-12,2011-12-02,Dallas Stars,2,Pacific,Western,31,2,50,0.62,31,0,29,2
2011-12,2011-12-04,Dallas Stars,0,Pacific,Western,31,2,52,0.5961538461538461,31,0,29,2
2011-12,2011-12-09,Dallas Stars,0,Pacific,Western,31,2,54,0.5740740740740741,33,-2,31,0
2011-12,2011-12-11,Dallas Stars,2,Pacific,Western,33,2,56,0.5892857142857143,33,0,32,1
2011-12,2011-12-14,Dallas Stars,2,Pacific,Western,35,2,58,0.603448275862069,35,0,33,2
2011-12,2011-12-16,Dallas Stars,2,Pacific,Western,37,2,60,0.6166666666666667,37,0,35,2
2011-12,2011-12-17,Dallas Stars,0,Pacific,Western,37,2,62,0.5967741935483871,37,0,35,2
2011-12,2011-12-20,Dallas Stars,2,Pacific,Western,39,2,64,0.609375,39,0,37,2
2011-12,2011-12-22,Dallas Stars,0,Pacific,Western,39,2,66,0.5909090909090909,39,0,39,0
2011-12,2011-12-24,Dallas Stars,2,Pacific,Western,41,2,68,0.6029411764705882,41,0,40,1
2011-12,2011-12-27,Dallas Stars,0,Pacific,Western,41,2,70,0.5857142857142857,41,0,40,1
2011-12,2011-12-30,Dallas Stars,0,Pacific,Western,41,2,72,0.5694444444444444,42,-1,42,-1
2011-12,2012-01-01,Dallas Stars,2,Pacific,Western,43,2,74,0.581081081081081,44,-1,43,0
2011-12,2012-01-04,Dallas Stars,0,Pacific,Western,43,2,76,0.5657894736842105,45,-2,45,-2
2011-12,2012-01-06,Dallas Stars,2,Pacific,Western,45,2,78,0.5769230769230769,48,-3,46,-1
2011-12,2012-01-07,Dallas Stars,2,Pacific,Western,47,2,80,0.5875,48,-1,47,0
2011-12,2012-01-11,Dallas Stars,0,Pacific,Western,47,2,82,0.573170731707317,51,-4,49,-2
2011-12,2012-01-13,Dallas Stars,2,Pacific,Western,49,2,84,0.5833333333333334,53,-4,50,-1
2011-12,2012-01-14,Dallas Stars,0,Pacific,Western,49,2,86,0.5697674418604651,53,-4,50,-1
2011-12,2012-01-17,Dallas Stars,0,Pacific,Western,49,2,88,0.5568181818181818,55,-6,51,-2
2011-12,2012-01-18,Dallas Stars,1,Pacific,Western,50,2,90,0.5555555555555556,57,-7,51,-1
2011-12,2012-01-21,Dallas Stars,0,Pacific,Western,50,2,92,0.5434782608695652,57,-7,52,-2
2011-12,2012-01-22,Dallas Stars,0,Pacific,Western,50,2,94,0.5319148936170213,57,-7,54,-4
2011-12,2012-01-25,Dallas Stars,2,Pacific,Western,52,2,96,0.5416666666666666,60,-8,55,-3
2011-12,2012-02-02,Dallas Stars,2,Pacific,Western,54,2,98,0.5510204081632653,62,-8,55,-1
2011-12,2012-02-03,Dallas Stars,0,Pacific,Western,54,2,100,0.54,64,-10,57,-3
2011-12,2012-02-05,Dallas Stars,2,Pacific,Western,56,2,102,0.5490196078431373,64,-8,58,-2
2011-12,2012-02-08,Dallas Stars,0,Pacific,Western,56,2,104,0.5384615384615384,64,-8,58,-2
2011-12,2012-02-10,Dallas Stars,2,Pacific,Western,58,2,106,0.5471698113207547,64,-6,60,-2
2011-12,2012-02-11,Dallas Stars,1,Pacific,Western,59,2,108,0.5462962962962963,66,-7,60,-1
2011-12,2012-02-12,Dallas Stars,0,Pacific,Western,59,2,110,0.5363636363636364,66,-7,62,-3
2011-12,2012-02-15,Dallas Stars,0,Pacific,Western,59,2,112,0.5267857142857143,68,-9,63,-4
2011-12,2012-02-17,Dallas Stars,2,Pacific,Western,61,2,114,0.5350877192982456,69,-8,65,-4
2011-12,2012-02-19,Dallas Stars,1,Pacific,Western,62,2,116,0.5344827586206896,69,-7,65,-3
2011-12,2012-02-20,Dallas Stars,0,Pacific,Western,62,2,118,0.5254237288135594,69,-7,65,-3
2011-12,2012-02-22,Dallas Stars,2,Pacific,Western,64,2,120,0.5333333333333333,69,-5,66,-2
2011-12,2012-02-24,Dallas Stars,2,Pacific,Western,66,2,122,0.5409836065573771,71,-5,66,0
2011-12,2012-02-25,Dallas Stars,2,Pacific,Western,68,2,124,0.5483870967741935,73,-5,68,0
2011-12,2012-02-26,Dallas Stars,2,Pacific,Western,70,2,126,0.5555555555555556,73,-3,70,0
2011-12,2012-03-01,Dallas Stars,1,Pacific,Western,71,2,128,0.5546875,75,-4,71,0
2011-12,2012-03-03,Dallas Stars,2,Pacific,Western,73,2,130,0.5615384615384615,75,-2,73,0
2011-12,2012-03-04,Dallas Stars,2,Pacific,Western,75,2,132,0.5681818181818182,75,0,73,2
2011-12,2012-03-07,Dallas Stars,2,Pacific,Western,77,2,134,0.5746268656716418,77,0,74,3
2011-12,2012-03-09,Dallas Stars,2,Pacific,Western,79,2,136,0.5808823529411765,79,0,75,4
2011-12,2012-03-11,Dallas Stars,2,Pacific,Western,81,2,138,0.5869565217391305,81,0,76,5
2011-12,2012-03-14,Dallas Stars,2,Pacific,Western,83,2,140,0.5928571428571429,83,0,79,4
2011-12,2012-03-15,Dallas Stars,0,Pacific,Western,83,2,142,0.5845070422535211,83,0,81,2
2011-12,2012-03-17,Dallas Stars,0,Pacific,Western,83,2,144,0.5763888888888888,83,0,81,2
2011-12,2012-03-21,Dallas Stars,2,Pacific,Western,85,2,146,0.5821917808219178,85,0,84,1
2011-12,2012-03-23,Dallas Stars,0,Pacific,Western,85,2,148,0.5743243243243243,86,-1,85,0
2011-12,2012-03-24,Dallas Stars,2,Pacific,Western,87,2,150,0.58,87,0,86,1
2011-12,2012-03-27,Dallas Stars,0,Pacific,Western,87,2,152,0.5723684210526315,88,-1,87,0
2011-12,2012-03-29,Dallas Stars,2,Pacific,Western,89,2,154,0.577922077922078,89,0,88,1
2011-12,2012-03-31,Dallas Stars,0,Pacific,Western,89,2,156,0.5705128205128205,90,-1,89,0
2011-12,2012-04-01,Dallas Stars,0,Pacific,Western,89,2,158,0.5632911392405063,91,-2,90,-1
2011-12,2012-04-04,Dallas Stars,0,Pacific,Western,89,2,160,0.55625,93,-4,92,-3
2011-12,2012-04-06,Dallas Stars,0,Pacific,Western,89,2,162,0.5493827160493827,95,-6,94,-5
2011-12,2012-04-08,Dallas Stars,0,Pacific,Western,89,2,164,0.5426829268292683,97,-8,95,-6
2011-12,2011-10-07,Detroit Red Wings,2,Central,Western,2,2,2,1.0,2,0,0,2
2011-12,2011-10-09,Detroit Red Wings,2,Central,Western,4,2,4,1.0,4,0,2,2
2011-12,2011-10-14,Detroit Red Wings,2,Central,Western,6,2,6,1.0,6,0,3,3
2011-12,2011-10-16,Detroit Red Wings,2,Central,Western,8,2,8,1.0,8,0,5,3
2011-12,2011-10-21,Detroit Red Wings,2,Central,Western,10,2,10,1.0,10,0,7,3
2011-12,2011-10-22,Detroit Red Wings,0,Central,Western,10,2,12,0.8333333333333334,10,0,8,2
2011-12,2011-10-25,Detroit Red Wings,0,Central,Western,10,2,14,0.7142857142857143,10,0,8,2
2011-12,2011-10-28,Detroit Red Wings,0,Central,Western,10,2,16,0.625,12,-2,10,0
2011-12,2011-10-30,Detroit Red Wings,0,Central,Western,10,2,18,0.5555555555555556,14,-4,11,-1
2011-12,2011-11-01,Detroit Red Wings,1,Central,Western,11,2,20,0.55,16,-5,12,-1
2011-12,2011-11-03,Detroit Red Wings,0,Central,Western,11,2,22,0.5,18,-7,13,-2
2011-12,2011-11-05,Detroit Red Wings,2,Central,Western,13,2,24,0.5416666666666666,19,-6,14,-1
2011-12,2011-11-09,Detroit Red Wings,2,Central,Western,15,2,26,0.5769230769230769,19,-4,16,-1
2011-12,2011-11-12,Detroit Red Wings,2,Central,Western,17,2,28,0.6071428571428571,23,-6,17,0
2011-12,2011-11-13,Detroit Red Wings,2,Central,Western,19,2,30,0.6333333333333333,23,-4,19,0
2011-12,2011-11-16,Detroit Red Wings,0,Central,Western,19,2,32,0.59375,25,-6,19,0
2011-12,2011-11-18,Detroit Red Wings,0,Central,Western,19,2,34,0.5588235294117647,27,-8,21,-2
2011-12,2011-11-19,Detroit Red Wings,2,Central,Western,21,2,36,0.5833333333333334,27,-6,21,0
2011-12,2011-11-21,Detroit Red Wings,2,Central,Western,23,2,38,0.6052631578947368,27,-4,22,1
2011-12,2011-11-24,Detroit Red Wings,2,Central,Western,25,2,40,0.625,27,-2,24,1
2011-12,2011-11-25,Detroit Red Wings,2,Central,Western,27,2,42,0.6428571428571429,29,-2,25,2
2011-12,2011-11-27,Detroit Red Wings,2,Central,Western,29,2,44,0.6590909090909091,31,-2,27,2
2011-12,2011-12-01,Detroit Red Wings,2,Central,Western,31,2,46,0.6739130434782609,31,0,28,3
2011-12,2011-12-03,Detroit Red Wings,2,Central,Western,33,2,48,0.6875,33,0,29,4
2011-12,2011-12-05,Detroit Red Wings,0,Central,Western,33,2,50,0.66,35,-2,29,4
2011-12,2011-12-07,Detroit Red Wings,0,Central,Western,33,2,52,0.6346153846153846,36,-3,30,3
2011-12,2011-12-09,Detroit Red Wings,2,Central,Western,35,2,54,0.6481481481481481,38,-3,31,4
2011-12,2011-12-11,Detroit Red Wings,2,Central,Western,37,2,56,0.6607142857142857,38,-1,32,5
2011-12,2011-12-14,Detroit Red Wings,2,Central,Western,39,2,58,0.6724137931034483,40,-1,33,6
2011-12,2011-12-16,Detroit Red Wings,0,Central,Western,39,2,60,0.65,42,-3,35,4
2011-12,2011-12-18,Detroit Red Wings,2,Central,Western,41,2,62,0.6612903225806451,44,-3,37,4
2011-12,2011-12-20,Detroit Red Wings,2,Central,Western,43,2,64,0.671875,46,-3,37,6
2011-12,2011-12-22,Detroit Red Wings,0,Central,Western,43,2,66,0.6515151515151515,48,-5,39,4
2011-12,2011-12-23,Detroit Red Wings,0,Central,Western,43,2,68,0.6323529411764706,48,-5,39,4
2011-12,2011-12-27,Detroit Red Wings,2,Central,Western,45,2,70,0.6428571428571429,50,-5,40,5
2011-12,2011-12-28,Detroit Red Wings,2,Central,Western,47,2,72,0.6527777777777778,50,-3,40,7
2011-12,2011-12-31,Detroit Red Wings,0,Central,Western,47,2,74,0.6351351351351351,52,-5,42,5
2011-12,2012-01-01,Detroit Red Wings,2,Central,Western,49,2,76,0.6447368421052632,52,-3,43,6
2011-12,2012-01-04,Detroit Red Wings,2,Central,Western,51,2,78,0.6538461538461539,52,-1,45,6
2011-12,2012-01-08,Detroit Red Wings,0,Central,Western,51,2,80,0.6375,53,-2,47,4
2011-12,2012-01-09,Detroit Red Wings,2,Central,Western,53,2,82,0.6463414634146342,53,0,47,6
2011-12,2012-01-11,Detroit Red Wings,0,Central,Western,53,2,84,0.6309523809523809,55,-2,49,4
2011-12,2012-01-13,Detroit Red Wings,2,Central,Western,55,2,86,0.6395348837209303,57,-2,50,5
2011-12,2012-01-14,Detroit Red Wings,2,Central,Western,57,2,88,0.6477272727272727,58,-1,50,7
2011-12,2012-01-17,Detroit Red Wings,2,Central,Western,59,2,90,0.6555555555555556,60,-1,51,8
2011-12,2012-01-18,Detroit Red Wings,2,Central,Western,61,2,92,0.6630434782608695,61,0,51,10
2011-12,2012-01-20,Detroit Red Wings,2,Central,Western,63,2,94,0.6702127659574468,63,0,52,11
2011-12,2012-01-22,Detroit Red Wings,2,Central,Western,65,2,96,0.6770833333333334,65,0,54,11
2011-12,2012-01-24,Detroit Red Wings,2,Central,Western,67,2,98,0.6836734693877551,67,0,54,13
2011-12,2012-01-26,Detroit Red Wings,0,Central,Western,67,2,100,0.67,67,0,55,12
2011-12,2012-02-01,Detroit Red Wings,2,Central,Western,69,2,102,0.6764705882352942,69,0,55,14
2011-12,2012-02-03,Detroit Red Wings,2,Central,Western,71,2,104,0.6826923076923077,71,0,57,14
2011-12,2012-02-05,Detroit Red Wings,1,Central,Western,72,2,106,0.6792452830188679,72,0,58,14
2011-12,2012-02-07,Detroit Red Wings,0,Central,Western,72,2,108,0.6666666666666666,72,0,58,14
2011-12,2012-02-09,Detroit Red Wings,2,Central,Western,74,2,110,0.6727272727272727,74,0,58,16
2011-12,2012-02-11,Detroit Red Wings,2,Central,Western,76,2,112,0.6785714285714286,76,0,60,16
2011-12,2012-02-13,Detroit Red Wings,2,Central,Western,78,2,114,0.6842105263157895,78,0,62,16
2011-12,2012-02-15,Detroit Red Wings,2,Central,Western,80,2,116,0.6896551724137931,80,0,63,17
2011-12,2012-02-18,Detroit Red Wings,2,Central,Western,82,2,118,0.6949152542372882,82,0,65,17
2011-12,2012-02-19,Detroit Red Wings,2,Central,Western,84,2,120,0.7,84,0,65,19
2011-12,2012-02-22,Detroit Red Wings,0,Central,Western,84,2,122,0.6885245901639344,84,0,66,18
2011-12,2012-02-24,Detroit Red Wings,1,Central,Western,85,2,124,0.6854838709677419,85,0,66,19
2011-12,2012-02-26,Detroit Red Wings,0,Central,Western,85,2,126,0.6746031746031746,85,0,70,15
2011-12,2012-02-29,Detroit Red Wings,2,Central,Western,87,2,128,0.6796875,87,0,70,17
2011-12,2012-03-03,Detroit Red Wings,2,Central,Western,89,2,130,0.6846153846153846,89,0,73,16
2011-12,2012-03-04,Detroit Red Wings,0,Central,Western,89,2,132,0.6742424242424242,89,0,73,16
2011-12,2012-03-07,Detroit Red Wings,0,Central,Western,89,2,134,0.664179104477612,91,-2,74,15
2011-12,2012-03-10,Detroit Red Wings,2,Central,Western,91,2,136,0.6691176470588235,93,-2,76,15
2011-12,2012-03-11,Detroit Red Wings,0,Central,Western,91,2,138,0.6594202898550725,97,-6,76,15
2011-12,2012-03-14,Detroit Red Wings,0,Central,Western,91,2,140,0.65,98,-7,79,12
2011-12,2012-03-15,Detroit Red Wings,0,Central,Western,91,2,142,0.6408450704225352,98,-7,81,10
2011-12,2012-03-18,Detroit Red Wings,1,Central,Western,92,2,144,0.6388888888888888,100,-8,82,10
2011-12,2012-03-19,Detroit Red Wings,0,Central,Western,92,2,146,0.6301369863013698,100,-8,83,9
2011-12,2012-03-21,Detroit Red Wings,1,Central,Western,93,2,148,0.6283783783783784,100,-7,84,9
2011-12,2012-03-24,Detroit Red Wings,2,Central,Western,95,2,150,0.6333333333333333,101,-6,86,9
2011-12,2012-03-26,Detroit Red Wings,2,Central,Western,97,2,152,0.6381578947368421,103,-6,86,11
2011-12,2012-03-28,Detroit Red Wings,0,Central,Western,97,2,154,0.6298701298701299,105,-8,87,10
2011-12,2012-03-30,Detroit Red Wings,0,Central,Western,97,2,156,0.6217948717948718,106,-9,88,9
2011-12,2012-04-01,Detroit Red Wings,2,Central,Western,99,2,158,0.6265822784810127,106,-7,90,9
2011-12,2012-04-04,Detroit Red Wings,2,Central,Western,101,2,160,0.63125,107,-6,92,9
2011-12,2012-04-05,Detroit Red Wings,0,Central,Western,101,2,162,0.6234567901234568,107,-6,92,9
2011-12,2012-04-07,Detroit Red Wings,1,Central,Western,102,2,164,0.6219512195121951,107,-5,94,8
2011-12,2011-10-10,Edmonton Oilers,2,Northwest,Western,2,2,2,1.0,3,-1,2,0
2011-12,2011-10-14,Edmonton Oilers,1,Northwest,Western,3,2,4,0.75,6,-3,3,0
2011-12,2011-10-16,Edmonton Oilers,0,Northwest,Western,3,2,6,0.5,8,-5,5,-2
2011-12,2011-10-18,Edmonton Oilers,2,Northwest,Western,5,2,8,0.625,10,-5,5,0
2011-12,2011-10-19,Edmonton Oilers,0,Northwest,Western,5,2,10,0.5,10,-5,5,0
2011-12,2011-10-21,Edmonton Oilers,1,Northwest,Western,6,2,12,0.5,10,-4,7,-1
2011-12,2011-10-23,Edmonton Oilers,2,Northwest,Western,8,2,14,0.5714285714285714,12,-4,8,0
2011-12,2011-10-26,Edmonton Oilers,2,Northwest,Western,10,2,16,0.625,12,-2,9,1
2011-12,2011-10-28,Edmonton Oilers,2,Northwest,Western,12,2,18,0.6666666666666666,12,0,10,2
2011-12,2011-10-29,Edmonton Oilers,2,Northwest,Western,14,2,20,0.7,14,0,10,4
2011-12,2011-10-31,Edmonton Oilers,2,Northwest,Western,16,2,22,0.7272727272727273,16,0,11,5
2011-12,2011-11-04,Edmonton Oilers,2,Northwest,Western,18,2,24,0.75,18,0,14,4
2011-12,2011-11-06,Edmonton Oilers,0,Northwest,Western,18,2,26,0.6923076923076923,18,0,15,3
2011-12,2011-11-09,Edmonton Oilers,2,Northwest,Western,20,2,28,0.7142857142857143,20,0,16,4
2011-12,2011-11-11,Edmonton Oilers,0,Northwest,Western,20,2,30,0.6666666666666666,20,0,17,3
2011-12,2011-11-12,Edmonton Oilers,0,Northwest,Western,20,2,32,0.625,20,0,17,3
2011-12,2011-11-14,Edmonton Oilers,0,Northwest,Western,20,2,34,0.5882352941176471,21,-1,19,1
2011-12,2011-11-18,Edmonton Oilers,0,Northwest,Western,20,2,36,0.5555555555555556,25,-5,21,-1
2011-12,2011-11-20,Edmonton Oilers,2,Northwest,Western,22,2,38,0.5789473684210527,27,-5,22,0
2011-12,2011-11-22,Edmonton Oilers,0,Northwest,Western,22,2,40,0.55,27,-5,23,-1
2011-12,2011-11-23,Edmonton Oilers,2,Northwest,Western,24,2,42,0.5714285714285714,27,-3,23,1
2011-12,2011-11-25,Edmonton Oilers,2,Northwest,Western,26,2,44,0.5909090909090909,29,-3,25,1
2011-12,2011-11-27,Edmonton Oilers,0,Northwest,Western,26,2,46,0.5652173913043478,29,-3,27,-1
2011-12,2011-11-29,Edmonton Oilers,0,Northwest,Western,26,2,48,0.5416666666666666,31,-5,27,-1
2011-12,2011-12-01,Edmonton Oilers,1,Northwest,Western,27,2,50,0.54,33,-6,28,-1
2011-12,2011-12-03,Edmonton Oilers,2,Northwest,Western,29,2,52,0.5576923076923077,35,-6,29,0
2011-12,2011-12-04,Edmonton Oilers,0,Northwest,Western,29,2,54,0.5370370370370371,35,-6,29,0
2011-12,2011-12-08,Edmonton Oilers,0,Northwest,Western,29,2,56,0.5178571428571429,39,-10,30,-1
2011-12,2011-12-10,Edmonton Oilers,2,Northwest,Western,31,2,58,0.5344827586206896,41,-10,31,0
2011-12,2011-12-11,Edmonton Oilers,0,Northwest,Western,31,2,60,0.5166666666666667,43,-12,32,-1
2011-12,2011-12-16,Edmonton Oilers,0,Northwest,Western,31,2,62,0.5,44,-13,35,-4
2011-12,2011-12-18,Edmonton Oilers,0,Northwest,Western,31,2,64,0.484375,45,-14,37,-6
2011-12,2011-12-20,Edmonton Oilers,0,Northwest,Western,31,2,66,0.4696969696969697,45,-14,37,-6
2011-12,2011-12-23,Edmonton Oilers,2,Northwest,Western,33,2,68,0.4852941176470588,45,-12,39,-6
2011-12,2011-12-27,Edmonton Oilers,0,Northwest,Western,33,2,70,0.4714285714285714,46,-13,40,-7
2011-12,2011-12-30,Edmonton Oilers,0,Northwest,Western,33,2,72,0.4583333333333333,50,-17,42,-9
2011-12,2011-12-31,Edmonton Oilers,0,Northwest,Western,33,2,74,0.44594594594594594,50,-17,42,-9
2011-12,2012-01-03,Edmonton Oilers,2,Northwest,Western,35,2,76,0.4605263157894737,51,-16,45,-10
2011-12,2012-01-04,Edmonton Oilers,0,Northwest,Western,35,2,78,0.44871794871794873,51,-16,45,-10
2011-12,2012-01-06,Edmonton Oilers,0,Northwest,Western,35,2,80,0.4375,53,-18,46,-11
2011-12,2012-01-07,Edmonton Oilers,0,Northwest,Western,35,2,82,0.4268292682926829,55,-20,47,-12
2011-12,2012-01-12,Edmonton Oilers,1,Northwest,Western,36,2,84,0.42857142857142855,57,-21,49,-13
2011-12,2012-01-14,Edmonton Oilers,0,Northwest,Western,36,2,86,0.4186046511627907,59,-23,50,-14
2011-12,2012-01-16,Edmonton Oilers,2,Northwest,Western,38,2,88,0.4318181818181818,59,-21,51,-13
2011-12,2012-01-18,Edmonton Oilers,0,Northwest,Western,38,2,90,0.4222222222222222,60,-22,51,-13
2011-12,2012-01-20,Edmonton Oilers,0,Northwest,Western,38,2,92,0.41304347826086957,60,-22,52,-14
2011-12,2012-01-22,Edmonton Oilers,0,Northwest,Western,38,2,94,0.40425531914893614,62,-24,54,-16
2011-12,2012-01-24,Edmonton Oilers,2,Northwest,Western,40,2,96,0.4166666666666667,62,-22,54,-14
2011-12,2012-01-25,Edmonton Oilers,1,Northwest,Western,41,2,98,0.41836734693877553,64,-23,55,-14
2011-12,2012-02-01,Edmonton Oilers,2,Northwest,Western,43,2,100,0.43,66,-23,55,-12
2011-12,2012-02-03,Edmonton Oilers,2,Northwest,Western,45,2,102,0.4411764705882353,67,-22,57,-12
2011-12,2012-02-05,Edmonton Oilers,2,Northwest,Western,47,2,104,0.4519230769230769,69,-22,58,-11
2011-12,2012-02-07,Edmonton Oilers,0,Northwest,Western,47,2,106,0.44339622641509435,69,-22,58,-11
2011-12,2012-02-09,Edmonton Oilers,0,Northwest,Western,47,2,108,0.4351851851851852,71,-24,58,-11
2011-12,2012-02-11,Edmonton Oilers,2,Northwest,Western,49,2,110,0.44545454545454544,73,-24,60,-11
2011-12,2012-02-16,Edmonton Oilers,1,Northwest,Western,50,2,112,0.44642857142857145,78,-28,63,-13
2011-12,2012-02-18,Edmonton Oilers,0,Northwest,Western,50,2,114,0.43859649122807015,78,-28,65,-15
2011-12,2012-02-20,Edmonton Oilers,0,Northwest,Western,50,2,116,0.43103448275862066,82,-32,65,-15
2011-12,2012-02-22,Edmonton Oilers,2,Northwest,Western,52,2,118,0.4406779661016949,82,-30,66,-14
2011-12,2012-02-24,Edmonton Oilers,2,Northwest,Western,54,2,120,0.45,84,-30,66,-12
2011-12,2012-02-25,Edmonton Oilers,0,Northwest,Western,54,2,122,0.4426229508196721,86,-32,68,-14
2011-12,2012-02-28,Edmonton Oilers,2,Northwest,Western,56,2,124,0.45161290322580644,87,-31,70,-14
2011-12,2012-03-01,Edmonton Oilers,0,Northwest,Western,56,2,126,0.4444444444444444,88,-32,71,-15
2011-12,2012-03-03,Edmonton Oilers,0,Northwest,Western,56,2,128,0.4375,90,-34,73,-17
2011-12,2012-03-06,Edmonton Oilers,0,Northwest,Western,56,2,130,0.4307692307692308,90,-34,73,-17
2011-12,2012-03-07,Edmonton Oilers,2,Northwest,Western,58,2,132,0.4393939393939394,90,-32,74,-16
2011-12,2012-03-09,Edmonton Oilers,0,Northwest,Western,58,2,134,0.43283582089552236,92,-34,75,-17
2011-12,2012-03-10,Edmonton Oilers,1,Northwest,Western,59,2,136,0.4338235294117647,92,-33,76,-17
2011-12,2012-03-13,Edmonton Oilers,0,Northwest,Western,59,2,138,0.427536231884058,92,-33,78,-19
2011-12,2012-03-15,Edmonton Oilers,2,Northwest,Western,61,2,140,0.4357142857142857,92,-31,81,-20
2011-12,2012-03-17,Edmonton Oilers,2,Northwest,Western,63,2,142,0.44366197183098594,92,-29,81,-18
2011-12,2012-03-19,Edmonton Oilers,1,Northwest,Western,64,2,144,0.4444444444444444,94,-30,83,-19
2011-12,2012-03-21,Edmonton Oilers,2,Northwest,Western,66,2,146,0.4520547945205479,94,-28,84,-18
2011-12,2012-03-22,Edmonton Oilers,1,Northwest,Western,67,2,148,0.4527027027027027,95,-28,84,-17
2011-12,2012-03-23,Edmonton Oilers,2,Northwest,Western,69,2,150,0.46,97,-28,85,-16
2011-12,2012-03-25,Edmonton Oilers,2,Northwest,Western,71,2,152,0.46710526315789475,99,-28,86,-15
2011-12,2012-03-29,Edmonton Oilers,0,Northwest,Western,71,2,154,0.461038961038961,103,-32,88,-17
2011-12,2012-03-31,Edmonton Oilers,0,Northwest,Western,71,2,156,0.4551282051282051,105,-34,89,-18
2011-12,2012-04-02,Edmonton Oilers,2,Northwest,Western,73,2,158,0.4620253164556962,107,-34,90,-17
2011-12,2012-04-03,Edmonton Oilers,0,Northwest,Western,73,2,160,0.45625,107,-34,90,-17
2011-12,2012-04-06,Edmonton Oilers,1,Northwest,Western,74,2,162,0.4567901234567901,109,-35,94,-20
2011-12,2012-04-08,Edmonton Oilers,0,Northwest,Western,74,2,164,0.45121951219512196,111,-37,95,-21
2011-12,2011-10-09,Florida Panthers,2,Southeast,Eastern,2,2,2,1.0,2,0,2,0
2011-12,2011-10-11,Florida Panthers,0,Southeast,Eastern,2,2,4,0.5,4,-2,2,0
2011-12,2011-10-15,Florida Panthers,2,Southeast,Eastern,4,2,6,0.6666666666666666,8,-4,4,0
2011-12,2011-10-17,Florida Panthers,2,Southeast,Eastern,6,2,8,0.75,8,-2,6,0
2011-12,2011-10-18,Florida Panthers,0,Southeast,Eastern,6,2,10,0.6,10,-4,6,0
2011-12,2011-10-20,Florida Panthers,0,Southeast,Eastern,6,2,12,0.5,12,-6,6,0
2011-12,2011-10-22,Florida Panthers,2,Southeast,Eastern,8,2,14,0.5714285714285714,14,-6,8,0
2011-12,2011-10-24,Florida Panthers,2,Southeast,Eastern,10,2,16,0.625,14,-4,8,2
2011-12,2011-10-27,Florida Panthers,0,Southeast,Eastern,10,2,18,0.5555555555555556,14,-4,10,0
2011-12,2011-10-29,Florida Panthers,2,Southeast,Eastern,12,2,20,0.6,14,-2,12,0
2011-12,2011-10-31,Florida Panthers,1,Southeast,Eastern,13,2,22,0.5909090909090909,14,-1,12,1
2011-12,2011-11-03,Florida Panthers,1,Southeast,Eastern,14,2,24,0.5833333333333334,16,-2,13,1
2011-12,2011-11-06,Florida Panthers,1,Southeast,Eastern,15,2,26,0.5769230769230769,18,-3,15,0
2011-12,2011-11-09,Florida Panthers,2,Southeast,Eastern,17,2,28,0.6071428571428571,18,-1,16,1
2011-12,2011-11-11,Florida Panthers,2,Southeast,Eastern,19,2,30,0.6333333333333333,19,0,18,1
2011-12,2011-11-13,Florida Panthers,0,Southeast,Eastern,19,2,32,0.59375,21,-2,18,1
2011-12,2011-11-16,Florida Panthers,2,Southeast,Eastern,21,2,34,0.6176470588235294,21,0,19,2
2011-12,2011-11-18,Florida Panthers,0,Southeast,Eastern,21,2,36,0.5833333333333334,21,0,21,0
2011-12,2011-11-20,Florida Panthers,2,Southeast,Eastern,23,2,38,0.6052631578947368,23,0,21,2
2011-12,2011-11-22,Florida Panthers,2,Southeast,Eastern,25,2,40,0.625,25,0,23,2
2011-12,2011-11-24,Florida Panthers,2,Southeast,Eastern,27,2,42,0.6428571428571429,27,0,23,4
2011-12,2011-11-26,Florida Panthers,1,Southeast,Eastern,28,2,44,0.6363636363636364,28,0,25,3
2011-12,2011-11-27,Florida Panthers,0,Southeast,Eastern,28,2,46,0.6086956521739131,28,0,25,3
2011-12,2011-11-30,Florida Panthers,2,Southeast,Eastern,30,2,48,0.625,30,0,26,4
2011-12,2011-12-02,Florida Panthers,0,Southeast,Eastern,30,2,50,0.6,30,0,26,4
2011-12,2011-12-04,Florida Panthers,2,Southeast,Eastern,32,2,52,0.6153846153846154,32,0,27,5
2011-12,2011-12-06,Florida Panthers,2,Southeast,Eastern,34,2,54,0.6296296296296297,34,0,29,5
2011-12,2011-12-09,Florida Panthers,2,Southeast,Eastern,36,2,56,0.6428571428571429,36,0,30,6
2011-12,2011-12-10,Florida Panthers,1,Southeast,Eastern,37,2,58,0.6379310344827587,37,0,31,6
2011-12,2011-12-12,Florida Panthers,0,Southeast,Eastern,37,2,60,0.6166666666666667,37,0,31,6
2011-12,2011-12-14,Florida Panthers,1,Southeast,Eastern,38,2,62,0.6129032258064516,38,0,33,5
2011-12,2011-12-17,Florida Panthers,2,Southeast,Eastern,40,2,64,0.625,40,0,35,5
2011-12,2011-12-18,Florida Panthers,2,Southeast,Eastern,42,2,66,0.6363636363636364,42,0,35,7
2011-12,2011-12-21,Florida Panthers,0,Southeast,Eastern,42,2,68,0.6176470588235294,42,0,36,6
2011-12,2011-12-23,Florida Panthers,1,Southeast,Eastern,43,2,70,0.6142857142857143,43,0,37,6
2011-12,2011-12-24,Florida Panthers,0,Southeast,Eastern,43,2,72,0.5972222222222222,43,0,39,4
2011-12,2011-12-28,Florida Panthers,2,Southeast,Eastern,45,2,74,0.6081081081081081,45,0,39,6
2011-12,2011-12-31,Florida Panthers,0,Southeast,Eastern,45,2,76,0.5921052631578947,45,0,41,4
2011-12,2012-01-01,Florida Panthers,2,Southeast,Eastern,47,2,78,0.6025641025641025,47,0,43,4
2011-12,2012-01-06,Florida Panthers,1,Southeast,Eastern,48,2,80,0.6,48,0,44,4
2011-12,2012-01-07,Florida Panthers,0,Southeast,Eastern,48,2,82,0.5853658536585366,48,0,45,3
2011-12,2012-01-10,Florida Panthers,2,Southeast,Eastern,50,2,84,0.5952380952380952,50,0,46,4
2011-12,2012-01-14,Florida Panthers,0,Southeast,Eastern,50,2,86,0.5813953488372093,50,0,48,2
2011-12,2012-01-17,Florida Panthers,1,Southeast,Eastern,51,2,88,0.5795454545454546,51,0,50,1
2011-12,2012-01-19,Florida Panthers,1,Southeast,Eastern,52,2,90,0.5777777777777777,52,0,52,0
2011-12,2012-01-21,Florida Panthers,0,Southeast,Eastern,52,2,92,0.5652173913043478,52,0,52,0
2011-12,2012-01-22,Florida Panthers,2,Southeast,Eastern,54,2,94,0.574468085106383,54,0,53,1
2011-12,2012-01-25,Florida Panthers,1,Southeast,Eastern,55,2,96,0.5729166666666666,55,0,55,0
2011-12,2012-02-02,Florida Panthers,2,Southeast,Eastern,57,2,98,0.5816326530612245,57,0,57,0
2011-12,2012-02-04,Florida Panthers,2,Southeast,Eastern,59,2,100,0.59,59,0,58,1
2011-12,2012-02-05,Florida Panthers,0,Southeast,Eastern,59,2,102,0.5784313725490197,59,0,59,0
2011-12,2012-02-08,Florida Panthers,0,Southeast,Eastern,59,2,104,0.5673076923076923,60,-1,60,-1
2011-12,2012-02-10,Florida Panthers,2,Southeast,Eastern,61,2,106,0.5754716981132075,61,0,61,0
2011-12,2012-02-11,Florida Panthers,2,Southeast,Eastern,63,2,108,0.5833333333333334,63,0,62,1
2011-12,2012-02-12,Florida Panthers,2,Southeast,Eastern,65,2,110,0.5909090909090909,65,0,62,3
2011-12,2012-02-16,Florida Panthers,0,Southeast,Eastern,65,2,112,0.5803571428571429,65,0,64,1
2011-12,2012-02-18,Florida Panthers,0,Southeast,Eastern,65,2,114,0.5701754385964912,65,0,64,1
2011-12,2012-02-19,Florida Panthers,0,Southeast,Eastern,65,2,116,0.5603448275862069,65,0,64,1
2011-12,2012-02-24,Florida Panthers,1,Southeast,Eastern,66,2,118,0.559322033898305,67,-1,66,0
2011-12,2012-02-26,Florida Panthers,2,Southeast,Eastern,68,2,120,0.5666666666666667,70,-2,68,0
2011-12,2012-02-26,Florida Panthers,2,Southeast,Eastern,70,2,122,0.5737704918032787,70,0,68,2
2011-12,2012-02-29,Florida Panthers,2,Southeast,Eastern,72,2,124,0.5806451612903226,72,0,69,3
2011-12,2012-03-02,Florida Panthers,0,Southeast,Eastern,72,2,126,0.5714285714285714,72,0,70,2
2011-12,2012-03-04,Florida Panthers,2,Southeast,Eastern,74,2,128,0.578125,74,0,70,4
2011-12,2012-03-04,Florida Panthers,0,Southeast,Eastern,74,2,130,0.5692307692307692,74,0,70,4
2011-12,2012-03-09,Florida Panthers,0,Southeast,Eastern,74,2,132,0.5606060606060606,74,0,72,2
2011-12,2012-03-10,Florida Panthers,1,Southeast,Eastern,75,2,134,0.5597014925373134,75,0,74,1
2011-12,2012-03-11,Florida Panthers,2,Southeast,Eastern,77,2,136,0.5661764705882353,77,0,76,1
2011-12,2012-03-13,Florida Panthers,2,Southeast,Eastern,79,2,138,0.572463768115942,79,0,78,1
2011-12,2012-03-15,Florida Panthers,2,Southeast,Eastern,81,2,140,0.5785714285714286,81,0,78,3
2011-12,2012-03-17,Florida Panthers,2,Southeast,Eastern,83,2,142,0.5845070422535211,83,0,78,5
2011-12,2012-03-20,Florida Panthers,2,Southeast,Eastern,85,2,144,0.5902777777777778,85,0,80,5
2011-12,2012-03-21,Florida Panthers,0,Southeast,Eastern,85,2,146,0.5821917808219178,85,0,80,5
2011-12,2012-03-23,Florida Panthers,1,Southeast,Eastern,86,2,148,0.581081081081081,86,0,82,4
2011-12,2012-03-25,Florida Panthers,1,Southeast,Eastern,87,2,150,0.58,87,0,84,3
2011-12,2012-03-27,Florida Panthers,2,Southeast,Eastern,89,2,152,0.5855263157894737,89,0,86,3
2011-12,2012-03-30,Florida Panthers,1,Southeast,Eastern,90,2,154,0.5844155844155844,90,0,86,4
2011-12,2012-03-30,Florida Panthers,0,Southeast,Eastern,90,2,156,0.5769230769230769,90,0,86,4
2011-12,2012-04-01,Florida Panthers,1,Southeast,Eastern,91,2,158,0.5759493670886076,91,0,88,3
2011-12,2012-04-03,Florida Panthers,1,Southeast,Eastern,92,2,160,0.575,92,0,88,4
2011-12,2012-04-05,Florida Panthers,0,Southeast,Eastern,92,2,162,0.5679012345679012,92,0,90,2
2011-12,2012-04-07,Florida Panthers,2,Southeast,Eastern,94,2,164,0.573170731707317,94,0,92,2
2011-12,2011-10-08,Los Angeles Kings,2,Pacific,Western,2,2,2,1.0,2,0,0,2
2011-12,2011-10-09,Los Angeles Kings,0,Pacific,Western,2,2,4,0.5,2,0,2,0
2011-12,2011-10-13,Los Angeles Kings,1,Pacific,Western,3,2,6,0.5,4,-1,2,1
2011-12,2011-10-15,Los Angeles Kings,2,Pacific,Western,5,2,8,0.625,6,-1,4,1
2011-12,2011-10-19,Los Angeles Kings,2,Pacific,Western,7,2,10,0.7,10,-3,5,2
2011-12,2011-10-21,Los Angeles Kings,2,Pacific,Western,9,2,12,0.75,10,-1,7,2
2011-12,2011-10-23,Los Angeles Kings,2,Pacific,Western,11,2,14,0.7857142857142857,12,-1,8,3
2011-12,2011-10-26,Los Angeles Kings,0,Pacific,Western,11,2,16,0.6875,14,-3,9,2
2011-12,2011-10-28,Los Angeles Kings,2,Pacific,Western,13,2,18,0.7222222222222222,14,-1,10,3
2011-12,2011-10-30,Los Angeles Kings,1,Pacific,Western,14,2,20,0.7,16,-2,11,3
2011-12,2011-10-31,Los Angeles Kings,0,Pacific,Western,14,2,22,0.6363636363636364,16,-2,11,3
2011-12,2011-11-04,Los Angeles Kings,0,Pacific,Western,14,2,24,0.5833333333333334,16,-2,14,0
2011-12,2011-11-06,Los Angeles Kings,1,Pacific,Western,15,2,26,0.5769230769230769,20,-5,15,0
2011-12,2011-11-08,Los Angeles Kings,0,Pacific,Western,15,2,28,0.5357142857142857,20,-5,15,0
2011-12,2011-11-09,Los Angeles Kings,2,Pacific,Western,17,2,30,0.5666666666666667,22,-5,16,1
2011-12,2011-11-11,Los Angeles Kings,0,Pacific,Western,17,2,32,0.53125,22,-5,17,0
2011-12,2011-11-13,Los Angeles Kings,2,Pacific,Western,19,2,34,0.5588235294117647,22,-3,19,0
2011-12,2011-11-17,Los Angeles Kings,2,Pacific,Western,21,2,36,0.5833333333333334,22,-1,19,2
2011-12,2011-11-18,Los Angeles Kings,2,Pacific,Western,23,2,38,0.6052631578947368,23,0,21,2
2011-12,2011-11-19,Los Angeles Kings,0,Pacific,Western,23,2,40,0.575,23,0,21,2
2011-12,2011-11-23,Los Angeles Kings,2,Pacific,Western,25,2,42,0.5952380952380952,25,0,23,2
2011-12,2011-11-24,Los Angeles Kings,1,Pacific,Western,26,2,44,0.5909090909090909,27,-1,24,2
2011-12,2011-11-27,Los Angeles Kings,0,Pacific,Western,26,2,46,0.5652173913043478,27,-1,27,-1
2011-12,2011-11-29,Los Angeles Kings,2,Pacific,Western,28,2,48,0.5833333333333334,29,-1,27,1
2011-12,2011-12-02,Los Angeles Kings,2,Pacific,Western,30,2,50,0.6,31,-1,29,1
2011-12,2011-12-03,Los Angeles Kings,0,Pacific,Western,30,2,52,0.5769230769230769,31,-1,29,1
2011-12,2011-12-07,Los Angeles Kings,0,Pacific,Western,30,2,54,0.5555555555555556,33,-3,30,0
2011-12,2011-12-09,Los Angeles Kings,0,Pacific,Western,30,2,56,0.5357142857142857,33,-3,31,-1
2011-12,2011-12-11,Los Angeles Kings,0,Pacific,Western,30,2,58,0.5172413793103449,33,-3,32,-2
2011-12,2011-12-14,Los Angeles Kings,0,Pacific,Western,30,2,60,0.5,35,-5,33,-3
2011-12,2011-12-16,Los Angeles Kings,2,Pacific,Western,32,2,62,0.5161290322580645,37,-5,35,-3
2011-12,2011-12-18,Los Angeles Kings,0,Pacific,Western,32,2,64,0.5,37,-5,37,-5
2011-12,2011-12-20,Los Angeles Kings,2,Pacific,Western,34,2,66,0.5151515151515151,39,-5,37,-3
2011-12,2011-12-23,Los Angeles Kings,2,Pacific,Western,36,2,68,0.5294117647058824,39,-3,39,-3
2011-12,2011-12-24,Los Angeles Kings,1,Pacific,Western,37,2,70,0.5285714285714286,41,-4,40,-3
2011-12,2011-12-27,Los Angeles Kings,2,Pacific,Western,39,2,72,0.5416666666666666,41,-2,40,-1
2011-12,2011-12-29,Los Angeles Kings,2,Pacific,Western,41,2,74,0.5540540540540541,42,-1,41,0
2011-12,2011-12-30,Los Angeles Kings,1,Pacific,Western,42,2,76,0.5526315789473685,42,0,42,0
2011-12,2012-01-01,Los Angeles Kings,2,Pacific,Western,44,2,78,0.5641025641025641,44,0,43,1
2011-12,2012-01-03,Los Angeles Kings,1,Pacific,Western,45,2,80,0.5625,45,0,45,0
2011-12,2012-01-06,Los Angeles Kings,2,Pacific,Western,47,2,82,0.573170731707317,48,-1,46,1
2011-12,2012-01-07,Los Angeles Kings,0,Pacific,Western,47,2,84,0.5595238095238095,48,-1,47,0
2011-12,2012-01-10,Los Angeles Kings,2,Pacific,Western,49,2,86,0.5697674418604651,50,-1,48,1
2011-12,2012-01-13,Los Angeles Kings,1,Pacific,Western,50,2,88,0.5681818181818182,53,-3,50,0
2011-12,2012-01-15,Los Angeles Kings,2,Pacific,Western,52,2,90,0.5777777777777777,55,-3,51,1
2011-12,2012-01-16,Los Angeles Kings,1,Pacific,Western,53,2,92,0.5760869565217391,55,-2,51,2
2011-12,2012-01-18,Los Angeles Kings,2,Pacific,Western,55,2,94,0.5851063829787234,57,-2,51,4
2011-12,2012-01-20,Los Angeles Kings,1,Pacific,Western,56,2,96,0.5833333333333334,57,-1,52,4
2011-12,2012-01-22,Los Angeles Kings,0,Pacific,Western,56,2,98,0.5714285714285714,57,-1,54,2
2011-12,2012-01-24,Los Angeles Kings,2,Pacific,Western,58,2,100,0.58,58,0,54,4
2011-12,2012-02-02,Los Angeles Kings,2,Pacific,Western,60,2,102,0.5882352941176471,62,-2,55,5
2011-12,2012-02-04,Los Angeles Kings,0,Pacific,Western,60,2,104,0.5769230769230769,64,-4,57,3
2011-12,2012-02-05,Los Angeles Kings,0,Pacific,Western,60,2,106,0.5660377358490566,64,-4,58,2
2011-12,2012-02-08,Los Angeles Kings,2,Pacific,Western,62,2,108,0.5740740740740741,64,-2,58,4
2011-12,2012-02-10,Los Angeles Kings,0,Pacific,Western,62,2,110,0.5636363636363636,64,-2,60,2
2011-12,2012-02-11,Los Angeles Kings,1,Pacific,Western,63,2,112,0.5625,66,-3,60,3
2011-12,2012-02-12,Los Angeles Kings,2,Pacific,Western,65,2,114,0.5701754385964912,66,-1,62,3
2011-12,2012-02-17,Los Angeles Kings,0,Pacific,Western,65,2,116,0.5603448275862069,69,-4,65,0
2011-12,2012-02-19,Los Angeles Kings,0,Pacific,Western,65,2,118,0.5508474576271186,69,-4,65,0
2011-12,2012-02-22,Los Angeles Kings,1,Pacific,Western,66,2,120,0.55,69,-3,66,0
2011-12,2012-02-23,Los Angeles Kings,0,Pacific,Western,66,2,122,0.5409836065573771,69,-3,66,0
2011-12,2012-02-26,Los Angeles Kings,2,Pacific,Western,68,2,124,0.5483870967741935,73,-5,70,-2
2011-12,2012-02-28,Los Angeles Kings,0,Pacific,Western,68,2,126,0.5396825396825397,73,-5,70,-2
2011-12,2012-02-29,Los Angeles Kings,2,Pacific,Western,70,2,128,0.546875,75,-5,70,0
2011-12,2012-03-04,Los Angeles Kings,2,Pacific,Western,72,2,130,0.5538461538461539,75,-3,73,-1
2011-12,2012-03-07,Los Angeles Kings,2,Pacific,Western,74,2,132,0.5606060606060606,77,-3,74,0
2011-12,2012-03-09,Los Angeles Kings,0,Pacific,Western,74,2,134,0.5522388059701493,79,-5,75,-1
2011-12,2012-03-10,Los Angeles Kings,0,Pacific,Western,74,2,136,0.5441176470588235,79,-5,76,-2
2011-12,2012-03-12,Los Angeles Kings,2,Pacific,Western,76,2,138,0.5507246376811594,81,-5,76,0
2011-12,2012-03-14,Los Angeles Kings,2,Pacific,Western,78,2,140,0.5571428571428572,83,-5,79,-1
2011-12,2012-03-17,Los Angeles Kings,2,Pacific,Western,80,2,142,0.5633802816901409,83,-3,81,-1
2011-12,2012-03-18,Los Angeles Kings,2,Pacific,Western,82,2,144,0.5694444444444444,83,-1,82,0
2011-12,2012-03-21,Los Angeles Kings,2,Pacific,Western,84,2,146,0.5753424657534246,85,-1,84,0
2011-12,2012-03-23,Los Angeles Kings,2,Pacific,Western,86,2,148,0.581081081081081,86,0,85,1
2011-12,2012-03-25,Los Angeles Kings,0,Pacific,Western,86,2,150,0.5733333333333334,87,-1,86,0
2011-12,2012-03-27,Los Angeles Kings,0,Pacific,Western,86,2,152,0.5657894736842105,88,-2,87,-1
2011-12,2012-03-29,Los Angeles Kings,2,Pacific,Western,88,2,154,0.5714285714285714,89,-1,88,0
2011-12,2012-03-31,Los Angeles Kings,2,Pacific,Western,90,2,156,0.5769230769230769,90,0,89,1
2011-12,2012-04-01,Los Angeles Kings,1,Pacific,Western,91,2,158,0.5759493670886076,91,0,90,1
2011-12,2012-04-03,Los Angeles Kings,2,Pacific,Western,93,2,160,0.58125,93,0,90,3
2011-12,2012-04-06,Los Angeles Kings,1,Pacific,Western,94,2,162,0.5802469135802469,95,-1,94,0
2011-12,2012-04-08,Los Angeles Kings,1,Pacific,Western,95,2,164,0.5792682926829268,97,-2,95,0
2011-12,2011-10-09,Minnesota Wild,2,Northwest,Western,2,2,2,1.0,2,0,2,0
2011-12,2011-10-10,Minnesota Wild,0,Northwest,Western,2,2,4,0.5,3,-1,2,0
2011-12,2011-10-11,Minnesota Wild,1,Northwest,Western,3,2,6,0.5,3,0,2,1
2011-12,2011-10-14,Minnesota Wild,2,Northwest,Western,5,2,8,0.625,6,-1,3,2
2011-12,2011-10-16,Minnesota Wild,1,Northwest,Western,6,2,10,0.6,8,-2,5,1
2011-12,2011-10-18,Minnesota Wild,0,Northwest,Western,6,2,12,0.5,10,-4,5,1
2011-12,2011-10-21,Minnesota Wild,2,Northwest,Western,8,2,14,0.5714285714285714,10,-2,7,1
2011-12,2011-10-22,Minnesota Wild,1,Northwest,Western,9,2,16,0.5625,10,-1,8,1
2011-12,2011-10-28,Minnesota Wild,0,Northwest,Western,9,2,18,0.5,12,-3,10,-1
2011-12,2011-10-30,Minnesota Wild,2,Northwest,Western,11,2,20,0.55,14,-3,11,0
2011-12,2011-11-01,Minnesota Wild,2,Northwest,Western,13,2,22,0.5909090909090909,16,-3,12,1
2011-12,2011-11-04,Minnesota Wild,2,Northwest,Western,15,2,24,0.625,18,-3,14,1
2011-12,2011-11-06,Minnesota Wild,2,Northwest,Western,17,2,26,0.6538461538461539,18,-1,15,2
2011-12,2011-11-09,Minnesota Wild,2,Northwest,Western,19,2,28,0.6785714285714286,20,-1,16,3
2011-12,2011-11-11,Minnesota Wild,0,Northwest,Western,19,2,30,0.6333333333333333,20,-1,17,2
2011-12,2011-11-13,Minnesota Wild,0,Northwest,Western,19,2,32,0.59375,20,-1,19,0
2011-12,2011-11-14,Minnesota Wild,2,Northwest,Western,21,2,34,0.6176470588235294,21,0,19,2
2011-12,2011-11-16,Minnesota Wild,2,Northwest,Western,23,2,36,0.6388888888888888,23,0,19,4
2011-12,2011-11-18,Minnesota Wild,2,Northwest,Western,25,2,38,0.6578947368421053,25,0,21,4
2011-12,2011-11-20,Minnesota Wild,2,Northwest,Western,27,2,40,0.675,27,0,22,5
2011-12,2011-11-24,Minnesota Wild,2,Northwest,Western,29,2,42,0.6904761904761905,29,0,24,5
2011-12,2011-11-25,Minnesota Wild,0,Northwest,Western,29,2,44,0.6590909090909091,29,0,25,4
2011-12,2011-11-27,Minnesota Wild,0,Northwest,Western,29,2,46,0.6304347826086957,29,0,27,2
2011-12,2011-11-29,Minnesota Wild,2,Northwest,Western,31,2,48,0.6458333333333334,31,0,27,4
2011-12,2011-12-01,Minnesota Wild,2,Northwest,Western,33,2,50,0.66,33,0,28,5
2011-12,2011-12-03,Minnesota Wild,2,Northwest,Western,35,2,52,0.6730769230769231,35,0,29,6
2011-12,2011-12-05,Minnesota Wild,2,Northwest,Western,37,2,54,0.6851851851851852,37,0,29,8
2011-12,2011-12-07,Minnesota Wild,2,Northwest,Western,39,2,56,0.6964285714285714,39,0,30,9
2011-12,2011-12-09,Minnesota Wild,2,Northwest,Western,41,2,58,0.7068965517241379,41,0,31,10
2011-12,2011-12-11,Minnesota Wild,2,Northwest,Western,43,2,60,0.7166666666666667,43,0,32,11
2011-12,2011-12-14,Minnesota Wild,0,Northwest,Western,43,2,62,0.6935483870967742,43,0,33,10
2011-12,2011-12-15,Minnesota Wild,1,Northwest,Western,44,2,64,0.6875,44,0,33,11
2011-12,2011-12-18,Minnesota Wild,1,Northwest,Western,45,2,66,0.6818181818181818,45,0,37,8
2011-12,2011-12-20,Minnesota Wild,0,Northwest,Western,45,2,68,0.6617647058823529,45,0,37,8
2011-12,2011-12-21,Minnesota Wild,0,Northwest,Western,45,2,70,0.6428571428571429,45,0,37,8
2011-12,2011-12-23,Minnesota Wild,0,Northwest,Western,45,2,72,0.625,45,0,39,6
2011-12,2011-12-26,Minnesota Wild,0,Northwest,Western,45,2,74,0.6081081081081081,45,0,40,5
2011-12,2011-12-29,Minnesota Wild,1,Northwest,Western,46,2,76,0.6052631578947368,48,-2,41,5
2011-12,2011-12-30,Minnesota Wild,2,Northwest,Western,48,2,78,0.6153846153846154,50,-2,42,6
2011-12,2011-12-31,Minnesota Wild,0,Northwest,Western,48,2,80,0.6,50,-2,42,6
2011-12,2012-01-05,Minnesota Wild,0,Northwest,Western,48,2,82,0.5853658536585366,53,-5,45,3
2011-12,2012-01-08,Minnesota Wild,0,Northwest,Western,48,2,84,0.5714285714285714,55,-7,47,1
2011-12,2012-01-11,Minnesota Wild,2,Northwest,Western,50,2,86,0.5813953488372093,57,-7,49,1
2011-12,2012-01-13,Minnesota Wild,0,Northwest,Western,50,2,88,0.5681818181818182,59,-9,50,0
2011-12,2012-01-15,Minnesota Wild,1,Northwest,Western,51,2,90,0.5666666666666667,59,-8,51,0
2011-12,2012-01-18,Minnesota Wild,0,Northwest,Western,51,2,92,0.5543478260869565,60,-9,51,0
2011-12,2012-01-20,Minnesota Wild,0,Northwest,Western,51,2,94,0.5425531914893617,60,-9,52,-1
2011-12,2012-01-22,Minnesota Wild,2,Northwest,Western,53,2,96,0.5520833333333334,62,-9,54,-1
2011-12,2012-01-25,Minnesota Wild,2,Northwest,Western,55,2,98,0.5612244897959183,64,-9,55,0
2011-12,2012-02-01,Minnesota Wild,0,Northwest,Western,55,2,100,0.55,66,-11,55,0
2011-12,2012-02-03,Minnesota Wild,2,Northwest,Western,57,2,102,0.5588235294117647,67,-10,57,0
2011-12,2012-02-05,Minnesota Wild,1,Northwest,Western,58,2,104,0.5576923076923077,69,-11,58,0
2011-12,2012-02-08,Minnesota Wild,0,Northwest,Western,58,2,106,0.5471698113207547,71,-13,58,0
2011-12,2012-02-10,Minnesota Wild,0,Northwest,Western,58,2,108,0.5370370370370371,73,-15,60,-2
2011-12,2012-02-12,Minnesota Wild,0,Northwest,Western,58,2,110,0.5272727272727272,74,-16,62,-4
2011-12,2012-02-15,Minnesota Wild,0,Northwest,Western,58,2,112,0.5178571428571429,76,-18,63,-5
2011-12,2012-02-17,Minnesota Wild,1,Northwest,Western,59,2,114,0.5175438596491229,78,-19,65,-6
2011-12,2012-02-18,Minnesota Wild,0,Northwest,Western,59,2,116,0.5086206896551724,78,-19,65,-6
2011-12,2012-02-19,Minnesota Wild,2,Northwest,Western,61,2,118,0.5169491525423728,80,-19,65,-4
2011-12,2012-02-24,Minnesota Wild,2,Northwest,Western,63,2,120,0.525,84,-21,66,-3
2011-12,2012-02-25,Minnesota Wild,0,Northwest,Western,63,2,122,0.5163934426229508,86,-23,68,-5
2011-12,2012-02-26,Minnesota Wild,2,Northwest,Western,65,2,124,0.5241935483870968,87,-22,70,-5
2011-12,2012-02-29,Minnesota Wild,0,Northwest,Western,65,2,126,0.5158730158730159,88,-23,70,-5
2011-12,2012-03-02,Minnesota Wild,1,Northwest,Western,66,2,128,0.515625,90,-24,71,-5
2011-12,2012-03-03,Minnesota Wild,0,Northwest,Western,66,2,130,0.5076923076923077,90,-24,73,-7
2011-12,2012-03-05,Minnesota Wild,0,Northwest,Western,66,2,132,0.5,90,-24,73,-7
2011-12,2012-03-07,Minnesota Wild,0,Northwest,Western,66,2,134,0.4925373134328358,90,-24,74,-8
2011-12,2012-03-09,Minnesota Wild,2,Northwest,Western,68,2,136,0.5,92,-24,75,-7
2011-12,2012-03-11,Minnesota Wild,0,Northwest,Western,68,2,138,0.4927536231884058,92,-24,76,-8
2011-12,2012-03-14,Minnesota Wild,0,Northwest,Western,68,2,140,0.4857142857142857,92,-24,79,-11
2011-12,2012-03-17,Minnesota Wild,0,Northwest,Western,68,2,142,0.4788732394366197,92,-24,81,-13
2011-12,2012-03-20,Minnesota Wild,2,Northwest,Western,70,2,144,0.4861111111111111,94,-24,83,-13
2011-12,2012-03-23,Minnesota Wild,2,Northwest,Western,72,2,146,0.4931506849315068,97,-25,85,-13
2011-12,2012-03-24,Minnesota Wild,0,Northwest,Western,72,2,148,0.4864864864864865,97,-25,86,-14
2011-12,2012-03-25,Minnesota Wild,0,Northwest,Western,72,2,150,0.48,99,-27,86,-14
2011-12,2012-03-28,Minnesota Wild,0,Northwest,Western,72,2,152,0.47368421052631576,101,-29,87,-15
2011-12,2012-03-30,Minnesota Wild,2,Northwest,Western,74,2,154,0.4805194805194805,103,-29,88,-14
2011-12,2012-04-01,Minnesota Wild,2,Northwest,Western,76,2,156,0.48717948717948717,107,-31,90,-14
2011-12,2012-04-01,Minnesota Wild,2,Northwest,Western,78,2,158,0.4936708860759494,107,-29,90,-12
2011-12,2012-04-04,Minnesota Wild,1,Northwest,Western,79,2,160,0.49375,109,-30,92,-13
2011-12,2012-04-06,Minnesota Wild,2,Northwest,Western,81,2,162,0.5,109,-28,94,-13
2011-12,2012-04-08,Minnesota Wild,0,Northwest,Western,81,2,164,0.49390243902439024,111,-30,95,-14
2011-12,2011-10-06,Montréal Canadiens,0,Northeast,Eastern,0,2,2,0.0,2,-2,0,0
2011-12,2011-10-09,Montréal Canadiens,2,Northeast,Eastern,2,2,4,0.5,4,-2,2,0
2011-12,2011-10-13,Montréal Canadiens,0,Northeast,Eastern,2,2,6,0.3333333333333333,4,-2,3,-1
2011-12,2011-10-15,Montréal Canadiens,1,Northeast,Eastern,3,2,8,0.375,6,-3,4,-1
2011-12,2011-10-18,Montréal Canadiens,0,Northeast,Eastern,3,2,10,0.3,8,-5,6,-3
2011-12,2011-10-20,Montréal Canadiens,0,Northeast,Eastern,3,2,12,0.25,10,-7,6,-3
2011-12,2011-10-22,Montréal Canadiens,1,Northeast,Eastern,4,2,14,0.2857142857142857,11,-7,8,-4
2011-12,2011-10-24,Montréal Canadiens,0,Northeast,Eastern,4,2,16,0.25,11,-7,8,-4
2011-12,2011-10-26,Montréal Canadiens,2,Northeast,Eastern,6,2,18,0.3333333333333333,11,-5,9,-3
2011-12,2011-10-27,Montréal Canadiens,2,Northeast,Eastern,8,2,20,0.4,13,-5,10,-2
2011-12,2011-10-29,Montréal Canadiens,2,Northeast,Eastern,10,2,22,0.45454545454545453,15,-5,12,-2
2011-12,2011-11-04,Montréal Canadiens,2,Northeast,Eastern,12,2,24,0.5,19,-7,14,-2
2011-12,2011-11-05,Montréal Canadiens,0,Northeast,Eastern,12,2,26,0.46153846153846156,19,-7,14,-2
2011-12,2011-11-09,Montréal Canadiens,0,Northeast,Eastern,12,2,28,0.42857142857142855,19,-7,16,-4
2011-12,2011-11-11,Montréal Canadiens,2,Northeast,Eastern,14,2,30,0.4666666666666667,21,-7,18,-4
2011-12,2011-11-13,Montréal Canadiens,2,Northeast,Eastern,16,2,32,0.5,21,-5,18,-2
2011-12,2011-11-15,Montréal Canadiens,1,Northeast,Eastern,17,2,34,0.5,22,-5,18,-1
2011-12,2011-11-17,Montréal Canadiens,2,Northeast,Eastern,19,2,36,0.5277777777777778,22,-3,19,0
2011-12,2011-11-18,Montréal Canadiens,0,Northeast,Eastern,19,2,38,0.5,22,-3,21,-2
2011-12,2011-11-20,Montréal Canadiens,2,Northeast,Eastern,21,2,40,0.525,24,-3,21,0
2011-12,2011-11-22,Montréal Canadiens,0,Northeast,Eastern,21,2,42,0.5,24,-3,23,-2
2011-12,2011-11-24,Montréal Canadiens,2,Northeast,Eastern,23,2,44,0.5227272727272727,26,-3,23,0
2011-12,2011-11-25,Montréal Canadiens,0,Northeast,Eastern,23,2,46,0.5,27,-4,25,-2
2011-12,2011-11-27,Montréal Canadiens,1,Northeast,Eastern,24,2,48,0.5,29,-5,25,-1
2011-12,2011-12-01,Montréal Canadiens,0,Northeast,Eastern,24,2,50,0.48,31,-7,26,-2
2011-12,2011-12-02,Montréal Canadiens,1,Northeast,Eastern,25,2,52,0.4807692307692308,31,-6,26,-1
2011-12,2011-12-03,Montréal Canadiens,2,Northeast,Eastern,27,2,54,0.5,31,-4,27,0
2011-12,2011-12-07,Montréal Canadiens,1,Northeast,Eastern,28,2,56,0.5,35,-7,29,-1
2011-12,2011-12-09,Montréal Canadiens,1,Northeast,Eastern,29,2,58,0.5,35,-6,30,-1
2011-12,2011-12-10,Montréal Canadiens,2,Northeast,Eastern,31,2,60,0.5166666666666667,35,-4,31,0
2011-12,2011-12-14,Montréal Canadiens,2,Northeast,Eastern,33,2,62,0.532258064516129,39,-6,33,0
2011-12,2011-12-16,Montréal Canadiens,0,Northeast,Eastern,33,2,64,0.515625,41,-8,33,0
2011-12,2011-12-18,Montréal Canadiens,0,Northeast,Eastern,33,2,66,0.5,43,-10,35,-2
2011-12,2011-12-20,Montréal Canadiens,0,Northeast,Eastern,33,2,68,0.4852941176470588,45,-12,35,-2
2011-12,2011-12-22,Montréal Canadiens,0,Northeast,Eastern,33,2,70,0.4714285714285714,45,-12,36,-3
2011-12,2011-12-23,Montréal Canadiens,0,Northeast,Eastern,33,2,72,0.4583333333333333,45,-12,37,-4
2011-12,2011-12-28,Montréal Canadiens,2,Northeast,Eastern,35,2,74,0.47297297297297297,47,-12,39,-4
2011-12,2011-12-30,Montréal Canadiens,0,Northeast,Eastern,35,2,76,0.4605263157894737,49,-14,41,-6
2011-12,2012-01-01,Montréal Canadiens,0,Northeast,Eastern,35,2,78,0.44871794871794873,49,-14,43,-8
2011-12,2012-01-05,Montréal Canadiens,2,Northeast,Eastern,37,2,80,0.4625,51,-14,44,-7
2011-12,2012-01-08,Montréal Canadiens,2,Northeast,Eastern,39,2,82,0.47560975609756095,53,-14,46,-7
2011-12,2012-01-11,Montréal Canadiens,0,Northeast,Eastern,39,2,84,0.4642857142857143,55,-16,46,-7
2011-12,2012-01-13,Montréal Canadiens,0,Northeast,Eastern,39,2,86,0.45348837209302323,57,-18,46,-7
2011-12,2012-01-15,Montréal Canadiens,1,Northeast,Eastern,40,2,88,0.45454545454545453,57,-17,50,-10
2011-12,2012-01-16,Montréal Canadiens,2,Northeast,Eastern,42,2,90,0.4666666666666667,57,-15,50,-8
2011-12,2012-01-19,Montréal Canadiens,0,Northeast,Eastern,42,2,92,0.45652173913043476,59,-17,52,-10
2011-12,2012-01-21,Montréal Canadiens,1,Northeast,Eastern,43,2,94,0.4574468085106383,62,-19,52,-9
2011-12,2012-01-22,Montréal Canadiens,2,Northeast,Eastern,45,2,96,0.46875,64,-19,53,-8
2011-12,2012-01-26,Montréal Canadiens,2,Northeast,Eastern,47,2,98,0.47959183673469385,64,-17,55,-8
2011-12,2012-02-01,Montréal Canadiens,0,Northeast,Eastern,47,2,100,0.47,66,-19,56,-9
2011-12,2012-02-03,Montréal Canadiens,0,Northeast,Eastern,47,2,102,0.46078431372549017,66,-19,57,-10
2011-12,2012-02-04,Montréal Canadiens,0,Northeast,Eastern,47,2,104,0.4519230769230769,66,-19,58,-11
2011-12,2012-02-05,Montréal Canadiens,2,Northeast,Eastern,49,2,106,0.46226415094339623,68,-19,59,-10
2011-12,2012-02-08,Montréal Canadiens,2,Northeast,Eastern,51,2,108,0.4722222222222222,68,-17,60,-9
2011-12,2012-02-10,Montréal Canadiens,2,Northeast,Eastern,53,2,110,0.4818181818181818,68,-15,61,-8
2011-12,2012-02-12,Montréal Canadiens,2,Northeast,Eastern,55,2,112,0.49107142857142855,70,-15,62,-7
2011-12,2012-02-14,Montréal Canadiens,0,Northeast,Eastern,55,2,114,0.4824561403508772,70,-15,62,-7
2011-12,2012-02-16,Montréal Canadiens,1,Northeast,Eastern,56,2,116,0.4827586206896552,72,-16,64,-8
2011-12,2012-02-18,Montréal Canadiens,2,Northeast,Eastern,58,2,118,0.4915254237288136,72,-14,64,-6
2011-12,2012-02-19,Montréal Canadiens,0,Northeast,Eastern,58,2,120,0.48333333333333334,72,-14,64,-6
2011-12,2012-02-22,Montréal Canadiens,0,Northeast,Eastern,58,2,122,0.47540983606557374,72,-14,65,-7
2011-12,2012-02-25,Montréal Canadiens,0,Northeast,Eastern,58,2,124,0.46774193548387094,75,-17,66,-8
2011-12,2012-02-26,Montréal Canadiens,0,Northeast,Eastern,58,2,126,0.4603174603174603,77,-19,68,-10
2011-12,2012-02-29,Montréal Canadiens,0,Northeast,Eastern,58,2,128,0.453125,77,-19,69,-11
2011-12,2012-03-02,Montréal Canadiens,2,Northeast,Eastern,60,2,130,0.46153846153846156,79,-19,70,-10
2011-12,2012-03-04,Montréal Canadiens,0,Northeast,Eastern,60,2,132,0.45454545454545453,79,-19,70,-10
2011-12,2012-03-07,Montréal Canadiens,0,Northeast,Eastern,60,2,134,0.44776119402985076,81,-21,72,-12
2011-12,2012-03-09,Montréal Canadiens,2,Northeast,Eastern,62,2,136,0.45588235294117646,83,-21,72,-10
2011-12,2012-03-11,Montréal Canadiens,2,Northeast,Eastern,64,2,138,0.463768115942029,83,-19,76,-12
2011-12,2012-03-12,Montréal Canadiens,1,Northeast,Eastern,65,2,140,0.4642857142857143,83,-18,76,-11
2011-12,2012-03-14,Montréal Canadiens,2,Northeast,Eastern,67,2,142,0.47183098591549294,83,-16,78,-11
2011-12,2012-03-16,Montréal Canadiens,1,Northeast,Eastern,68,2,144,0.4722222222222222,84,-16,78,-10
2011-12,2012-03-17,Montréal Canadiens,1,Northeast,Eastern,69,2,146,0.4726027397260274,85,-16,78,-9
2011-12,2012-03-21,Montréal Canadiens,0,Northeast,Eastern,69,2,148,0.46621621621621623,87,-18,80,-11
2011-12,2012-03-23,Montréal Canadiens,2,Northeast,Eastern,71,2,150,0.47333333333333333,87,-16,82,-11
2011-12,2012-03-24,Montréal Canadiens,0,Northeast,Eastern,71,2,152,0.46710526315789475,87,-16,84,-13
2011-12,2012-03-27,Montréal Canadiens,1,Northeast,Eastern,72,2,154,0.4675324675324675,93,-21,86,-14
2011-12,2012-03-30,Montréal Canadiens,0,Northeast,Eastern,72,2,156,0.46153846153846156,94,-22,86,-14
2011-12,2012-03-31,Montréal Canadiens,1,Northeast,Eastern,73,2,158,0.4620253164556962,96,-23,88,-15
2011-12,2012-04-04,Montréal Canadiens,2,Northeast,Eastern,75,2,160,0.46875,98,-23,88,-13
2011-12,2012-04-05,Montréal Canadiens,1,Northeast,Eastern,76,2,162,0.4691358024691358,100,-24,90,-14
2011-12,2012-04-07,Montréal Canadiens,2,Northeast,Eastern,78,2,164,0.47560975609756095,102,-24,92,-14
2011-12,2011-10-07,Nashville Predators,2,Central,Western,2,2,2,1.0,2,0,0,2
2011-12,2011-10-09,Nashville Predators,2,Central,Western,4,2,4,1.0,4,0,2,2
2011-12,2011-10-14,Nashville Predators,0,Central,Western,4,2,6,0.6666666666666666,6,-2,3,1
2011-12,2011-10-16,Nashville Predators,1,Central,Western,5,2,8,0.625,8,-3,5,0
2011-12,2011-10-18,Nashville Predators,0,Central,Western,5,2,10,0.5,8,-3,5,0
2011-12,2011-10-21,Nashville Predators,0,Central,Western,5,2,12,0.4166666666666667,10,-5,7,-2
2011-12,2011-10-22,Nashville Predators,2,Central,Western,7,2,14,0.5,10,-3,8,-1
2011-12,2011-10-26,Nashville Predators,0,Central,Western,7,2,16,0.4375,12,-5,9,-2
2011-12,2011-10-28,Nashville Predators,2,Central,Western,9,2,18,0.5,12,-3,10,-1
2011-12,2011-10-30,Nashville Predators,2,Central,Western,11,2,20,0.55,14,-3,11,0
2011-12,2011-11-01,Nashville Predators,1,Central,Western,12,2,22,0.5454545454545454,16,-4,12,0
2011-12,2011-11-04,Nashville Predators,2,Central,Western,14,2,24,0.5833333333333334,19,-5,14,0
2011-12,2011-11-06,Nashville Predators,2,Central,Western,16,2,26,0.6153846153846154,19,-3,15,1
2011-12,2011-11-09,Nashville Predators,0,Central,Western,16,2,28,0.5714285714285714,19,-3,16,0
2011-12,2011-11-10,Nashville Predators,2,Central,Western,18,2,30,0.6,19,-1,16,2
2011-12,2011-11-13,Nashville Predators,1,Central,Western,19,2,32,0.59375,23,-4,19,0
2011-12,2011-11-16,Nashville Predators,2,Central,Western,21,2,34,0.6176470588235294,25,-4,19,2
2011-12,2011-11-18,Nashville Predators,2,Central,Western,23,2,36,0.6388888888888888,27,-4,21,2
2011-12,2011-11-20,Nashville Predators,1,Central,Western,24,2,38,0.631578947368421,27,-3,22,2
2011-12,2011-11-23,Nashville Predators,0,Central,Western,24,2,40,0.6,27,-3,23,1
2011-12,2011-11-24,Nashville Predators,0,Central,Western,24,2,42,0.5714285714285714,27,-3,24,0
2011-12,2011-11-27,Nashville Predators,0,Central,Western,24,2,44,0.5454545454545454,31,-7,27,-3
2011-12,2011-11-29,Nashville Predators,2,Central,Western,26,2,46,0.5652173913043478,31,-5,27,-1
2011-12,2011-11-30,Nashville Predators,0,Central,Western,26,2,48,0.5416666666666666,31,-5,28,-2
2011-12,2011-12-02,Nashville Predators,2,Central,Western,28,2,50,0.56,31,-3,29,-1
2011-12,2011-12-04,Nashville Predators,0,Central,Western,28,2,52,0.5384615384615384,35,-7,29,-1
2011-12,2011-12-07,Nashville Predators,0,Central,Western,28,2,54,0.5185185185185185,36,-8,30,-2
2011-12,2011-12-09,Nashville Predators,2,Central,Western,30,2,56,0.5357142857142857,38,-8,31,-1
2011-12,2011-12-11,Nashville Predators,2,Central,Western,32,2,58,0.5517241379310345,38,-6,32,0
2011-12,2011-12-14,Nashville Predators,2,Central,Western,34,2,60,0.5666666666666667,40,-6,33,1
2011-12,2011-12-16,Nashville Predators,2,Central,Western,36,2,62,0.5806451612903226,42,-6,35,1
2011-12,2011-12-18,Nashville Predators,2,Central,Western,38,2,64,0.59375,44,-6,37,1
2011-12,2011-12-21,Nashville Predators,0,Central,Western,38,2,66,0.5757575757575758,46,-8,37,1
2011-12,2011-12-23,Nashville Predators,2,Central,Western,40,2,68,0.5882352941176471,48,-8,39,1
2011-12,2011-12-24,Nashville Predators,0,Central,Western,40,2,70,0.5714285714285714,48,-8,40,0
2011-12,2011-12-27,Nashville Predators,0,Central,Western,40,2,72,0.5555555555555556,50,-10,40,0
2011-12,2011-12-29,Nashville Predators,2,Central,Western,42,2,74,0.5675675675675675,50,-8,41,1
2011-12,2011-12-31,Nashville Predators,2,Central,Western,44,2,76,0.5789473684210527,52,-8,42,2
2011-12,2012-01-01,Nashville Predators,2,Central,Western,46,2,78,0.5897435897435898,52,-6,43,3
2011-12,2012-01-06,Nashville Predators,0,Central,Western,46,2,80,0.575,52,-6,46,0
2011-12,2012-01-08,Nashville Predators,2,Central,Western,48,2,82,0.5853658536585366,53,-5,47,1
2011-12,2012-01-11,Nashville Predators,2,Central,Western,50,2,84,0.5952380952380952,55,-5,49,1
2011-12,2012-01-13,Nashville Predators,2,Central,Western,52,2,86,0.6046511627906976,57,-5,50,2
2011-12,2012-01-15,Nashville Predators,2,Central,Western,54,2,88,0.6136363636363636,58,-4,51,3
2011-12,2012-01-16,Nashville Predators,2,Central,Western,56,2,90,0.6222222222222222,60,-4,51,5
2011-12,2012-01-18,Nashville Predators,0,Central,Western,56,2,92,0.6086956521739131,61,-5,51,5
2011-12,2012-01-20,Nashville Predators,2,Central,Western,58,2,94,0.6170212765957447,63,-5,52,6
2011-12,2012-01-22,Nashville Predators,2,Central,Western,60,2,96,0.625,65,-5,54,6
2011-12,2012-01-24,Nashville Predators,2,Central,Western,62,2,98,0.6326530612244898,67,-5,54,8
2011-12,2012-01-25,Nashville Predators,2,Central,Western,64,2,100,0.64,67,-3,55,9
2011-12,2012-02-01,Nashville Predators,2,Central,Western,66,2,102,0.6470588235294118,69,-3,55,11
2011-12,2012-02-03,Nashville Predators,0,Central,Western,66,2,104,0.6346153846153846,71,-5,57,9
2011-12,2012-02-05,Nashville Predators,2,Central,Western,68,2,106,0.6415094339622641,72,-4,58,10
2011-12,2012-02-08,Nashville Predators,1,Central,Western,69,2,108,0.6388888888888888,72,-3,58,11
2011-12,2012-02-10,Nashville Predators,0,Central,Western,69,2,110,0.6272727272727273,74,-5,60,9
2011-12,2012-02-11,Nashville Predators,1,Central,Western,70,2,112,0.625,76,-6,60,10
2011-12,2012-02-15,Nashville Predators,2,Central,Western,72,2,114,0.631578947368421,80,-8,63,9
2011-12,2012-02-18,Nashville Predators,0,Central,Western,72,2,116,0.6206896551724138,82,-10,65,7
2011-12,2012-02-20,Nashville Predators,2,Central,Western,74,2,118,0.6271186440677966,84,-10,65,9
2011-12,2012-02-22,Nashville Predators,2,Central,Western,76,2,120,0.6333333333333333,84,-8,66,10
2011-12,2012-02-24,Nashville Predators,1,Central,Western,77,2,122,0.6311475409836066,85,-8,66,11
2011-12,2012-02-26,Nashville Predators,2,Central,Western,79,2,124,0.6370967741935484,85,-6,70,9
2011-12,2012-02-28,Nashville Predators,2,Central,Western,81,2,126,0.6428571428571429,85,-4,70,11
2011-12,2012-02-29,Nashville Predators,0,Central,Western,81,2,128,0.6328125,87,-6,70,11
2011-12,2012-03-04,Nashville Predators,2,Central,Western,83,2,130,0.6384615384615384,89,-6,73,10
2011-12,2012-03-07,Nashville Predators,0,Central,Western,83,2,132,0.6287878787878788,91,-8,74,9
2011-12,2012-03-09,Nashville Predators,2,Central,Western,85,2,134,0.6343283582089553,93,-8,75,10
2011-12,2012-03-11,Nashville Predators,2,Central,Western,87,2,136,0.6397058823529411,97,-10,76,11
2011-12,2012-03-13,Nashville Predators,2,Central,Western,89,2,138,0.644927536231884,97,-8,78,11
2011-12,2012-03-16,Nashville Predators,1,Central,Western,90,2,140,0.6428571428571429,98,-8,81,9
2011-12,2012-03-18,Nashville Predators,0,Central,Western,90,2,142,0.6338028169014085,100,-10,82,8
2011-12,2012-03-19,Nashville Predators,2,Central,Western,92,2,144,0.6388888888888888,100,-8,83,9
2011-12,2012-03-21,Nashville Predators,0,Central,Western,92,2,146,0.6301369863013698,100,-8,84,8
2011-12,2012-03-22,Nashville Predators,0,Central,Western,92,2,148,0.6216216216216216,100,-8,84,8
2011-12,2012-03-24,Nashville Predators,2,Central,Western,94,2,150,0.6266666666666667,101,-7,86,8
2011-12,2012-03-25,Nashville Predators,2,Central,Western,96,2,152,0.631578947368421,101,-5,86,10
2011-12,2012-03-28,Nashville Predators,0,Central,Western,96,2,154,0.6233766233766234,105,-9,87,9
2011-12,2012-03-30,Nashville Predators,2,Central,Western,98,2,156,0.6282051282051282,106,-8,88,10
2011-12,2012-04-01,Nashville Predators,0,Central,Western,98,2,158,0.620253164556962,106,-8,90,8
2011-12,2012-04-04,Nashville Predators,2,Central,Western,100,2,160,0.625,107,-7,92,8
2011-12,2012-04-06,Nashville Predators,2,Central,Western,102,2,162,0.6296296296296297,107,-5,94,8
2011-12,2012-04-08,Nashville Predators,2,Central,Western,104,2,164,0.6341463414634146,109,-5,95,9
2011-12,2011-10-08,New Jersey Devils,0,Atlantic,Eastern,0,2,2,0.0,4,-4,1,-1
2011-12,2011-10-10,New Jersey Devils,2,Atlantic,Eastern,2,2,4,0.5,5,-3,2,0
2011-12,2011-10-13,New Jersey Devils,2,Atlantic,Eastern,4,2,6,0.6666666666666666,8,-4,3,1
2011-12,2011-10-16,New Jersey Devils,2,Atlantic,Eastern,6,2,8,0.75,8,-2,5,1
2011-12,2011-10-21,New Jersey Devils,1,Atlantic,Eastern,7,2,10,0.7,12,-5,6,1
2011-12,2011-10-22,New Jersey Devils,0,Atlantic,Eastern,7,2,12,0.5833333333333334,14,-7,8,-1
2011-12,2011-10-26,New Jersey Devils,2,Atlantic,Eastern,9,2,14,0.6428571428571429,16,-7,9,0
2011-12,2011-10-28,New Jersey Devils,0,Atlantic,Eastern,9,2,16,0.5625,18,-9,10,-1
2011-12,2011-10-30,New Jersey Devils,0,Atlantic,Eastern,9,2,18,0.5,18,-9,12,-3
2011-12,2011-11-02,New Jersey Devils,0,Atlantic,Eastern,9,2,20,0.45,18,-9,12,-3
2011-12,2011-11-03,New Jersey Devils,2,Atlantic,Eastern,11,2,22,0.5,18,-7,13,-2
2011-12,2011-11-05,New Jersey Devils,2,Atlantic,Eastern,13,2,24,0.5416666666666666,19,-6,14,-1
2011-12,2011-11-09,New Jersey Devils,2,Atlantic,Eastern,15,2,26,0.5769230769230769,21,-6,16,-1
2011-12,2011-11-12,New Jersey Devils,0,Atlantic,Eastern,15,2,28,0.5357142857142857,23,-8,18,-3
2011-12,2011-11-13,New Jersey Devils,2,Atlantic,Eastern,17,2,30,0.5666666666666667,23,-6,18,-1
2011-12,2011-11-16,New Jersey Devils,0,Atlantic,Eastern,17,2,32,0.53125,25,-8,19,-2
2011-12,2011-11-17,New Jersey Devils,2,Atlantic,Eastern,19,2,34,0.5588235294117647,25,-6,19,0
2011-12,2011-11-20,New Jersey Devils,2,Atlantic,Eastern,21,2,36,0.5833333333333334,25,-4,21,0
2011-12,2011-11-22,New Jersey Devils,0,Atlantic,Eastern,21,2,38,0.5526315789473685,27,-6,23,-2
2011-12,2011-11-24,New Jersey Devils,2,Atlantic,Eastern,23,2,40,0.575,28,-5,23,0
2011-12,2011-11-25,New Jersey Devils,2,Atlantic,Eastern,25,2,42,0.5952380952380952,29,-4,25,0
2011-12,2011-11-26,New Jersey Devils,0,Atlantic,Eastern,25,2,44,0.5681818181818182,30,-5,25,0
2011-12,2011-12-01,New Jersey Devils,0,Atlantic,Eastern,25,2,46,0.5434782608695652,32,-7,26,-1
2011-12,2011-12-03,New Jersey Devils,0,Atlantic,Eastern,25,2,48,0.5208333333333334,34,-9,27,-2
2011-12,2011-12-04,New Jersey Devils,0,Atlantic,Eastern,25,2,50,0.5,36,-11,27,-2
2011-12,2011-12-07,New Jersey Devils,2,Atlantic,Eastern,27,2,52,0.5192307692307693,36,-9,29,-2
2011-12,2011-12-09,New Jersey Devils,2,Atlantic,Eastern,29,2,54,0.5370370370370371,37,-8,30,-1
2011-12,2011-12-10,New Jersey Devils,0,Atlantic,Eastern,29,2,56,0.5178571428571429,37,-8,31,-2
2011-12,2011-12-13,New Jersey Devils,2,Atlantic,Eastern,31,2,58,0.5344827586206896,39,-8,31,0
2011-12,2011-12-14,New Jersey Devils,2,Atlantic,Eastern,33,2,60,0.55,41,-8,33,0
2011-12,2011-12-17,New Jersey Devils,2,Atlantic,Eastern,35,2,62,0.5645161290322581,43,-8,35,0
2011-12,2011-12-18,New Jersey Devils,2,Atlantic,Eastern,37,2,64,0.578125,43,-6,35,2
2011-12,2011-12-21,New Jersey Devils,0,Atlantic,Eastern,37,2,66,0.5606060606060606,44,-7,36,1
2011-12,2011-12-24,New Jersey Devils,2,Atlantic,Eastern,39,2,68,0.5735294117647058,46,-7,39,0
2011-12,2011-12-27,New Jersey Devils,0,Atlantic,Eastern,39,2,70,0.5571428571428572,48,-9,39,0
2011-12,2011-12-29,New Jersey Devils,2,Atlantic,Eastern,41,2,72,0.5694444444444444,48,-7,39,2
2011-12,2011-12-31,New Jersey Devils,2,Atlantic,Eastern,43,2,74,0.581081081081081,50,-7,41,2
2011-12,2012-01-03,New Jersey Devils,1,Atlantic,Eastern,44,2,76,0.5789473684210527,52,-8,43,1
2011-12,2012-01-05,New Jersey Devils,0,Atlantic,Eastern,44,2,78,0.5641025641025641,52,-8,44,0
2011-12,2012-01-07,New Jersey Devils,2,Atlantic,Eastern,46,2,80,0.575,56,-10,45,1
2011-12,2012-01-08,New Jersey Devils,2,Atlantic,Eastern,48,2,82,0.5853658536585366,56,-8,46,2
2011-12,2012-01-11,New Jersey Devils,0,Atlantic,Eastern,48,2,84,0.5714285714285714,58,-10,46,2
2011-12,2012-01-12,New Jersey Devils,2,Atlantic,Eastern,50,2,86,0.5813953488372093,58,-8,46,4
2011-12,2012-01-14,New Jersey Devils,2,Atlantic,Eastern,52,2,88,0.5909090909090909,58,-6,48,4
2011-12,2012-01-18,New Jersey Devils,2,Atlantic,Eastern,54,2,90,0.6,62,-8,50,4
2011-12,2012-01-20,New Jersey Devils,0,Atlantic,Eastern,54,2,92,0.5869565217391305,62,-8,52,2
2011-12,2012-01-21,New Jersey Devils,0,Atlantic,Eastern,54,2,94,0.574468085106383,64,-10,52,2
2011-12,2012-01-25,New Jersey Devils,1,Atlantic,Eastern,55,2,96,0.5729166666666666,66,-11,55,0
2011-12,2012-02-01,New Jersey Devils,2,Atlantic,Eastern,57,2,98,0.5816326530612245,67,-10,56,1
2011-12,2012-02-03,New Jersey Devils,2,Atlantic,Eastern,59,2,100,0.59,69,-10,57,2
2011-12,2012-02-04,New Jersey Devils,2,Atlantic,Eastern,61,2,102,0.5980392156862745,69,-8,58,3
2011-12,2012-02-05,New Jersey Devils,2,Atlantic,Eastern,63,2,104,0.6057692307692307,71,-8,59,4
2011-12,2012-02-08,New Jersey Devils,2,Atlantic,Eastern,65,2,106,0.6132075471698113,71,-6,60,5
2011-12,2012-02-10,New Jersey Devils,1,Atlantic,Eastern,66,2,108,0.6111111111111112,73,-7,61,5
2011-12,2012-02-11,New Jersey Devils,0,Atlantic,Eastern,66,2,110,0.6,75,-9,62,4
2011-12,2012-02-15,New Jersey Devils,2,Atlantic,Eastern,68,2,112,0.6071428571428571,79,-11,62,6
2011-12,2012-02-18,New Jersey Devils,2,Atlantic,Eastern,70,2,114,0.6140350877192983,79,-9,64,6
2011-12,2012-02-19,New Jersey Devils,2,Atlantic,Eastern,72,2,116,0.6206896551724138,79,-7,64,8
2011-12,2012-02-22,New Jersey Devils,2,Atlantic,Eastern,74,2,118,0.6271186440677966,81,-7,65,9
2011-12,2012-02-25,New Jersey Devils,0,Atlantic,Eastern,74,2,120,0.6166666666666667,82,-8,66,8
2011-12,2012-02-26,New Jersey Devils,0,Atlantic,Eastern,74,2,122,0.6065573770491803,84,-10,68,6
2011-12,2012-02-28,New Jersey Devils,0,Atlantic,Eastern,74,2,124,0.5967741935483871,86,-12,68,6
2011-12,2012-03-02,New Jersey Devils,1,Atlantic,Eastern,75,2,126,0.5952380952380952,88,-13,70,5
2011-12,2012-03-03,New Jersey Devils,2,Atlantic,Eastern,77,2,128,0.6015625,89,-12,70,7
2011-12,2012-03-04,New Jersey Devils,0,Atlantic,Eastern,77,2,130,0.5923076923076923,91,-14,70,7
2011-12,2012-03-07,New Jersey Devils,2,Atlantic,Eastern,79,2,132,0.5984848484848485,91,-12,72,7
2011-12,2012-03-09,New Jersey Devils,2,Atlantic,Eastern,81,2,134,0.6044776119402985,91,-10,72,9
2011-12,2012-03-11,New Jersey Devils,2,Atlantic,Eastern,83,2,136,0.6102941176470589,93,-10,76,7
2011-12,2012-03-11,New Jersey Devils,2,Atlantic,Eastern,85,2,138,0.6159420289855072,93,-8,76,9
2011-12,2012-03-13,New Jersey Devils,0,Atlantic,Eastern,85,2,140,0.6071428571428571,95,-10,78,7
2011-12,2012-03-15,New Jersey Devils,2,Atlantic,Eastern,87,2,142,0.6126760563380281,95,-8,78,9
2011-12,2012-03-17,New Jersey Devils,0,Atlantic,Eastern,87,2,144,0.6041666666666666,95,-8,78,9
2011-12,2012-03-19,New Jersey Devils,0,Atlantic,Eastern,87,2,146,0.5958904109589042,97,-10,80,7
2011-12,2012-03-20,New Jersey Devils,2,Atlantic,Eastern,89,2,148,0.6013513513513513,97,-8,80,9
2011-12,2012-03-23,New Jersey Devils,1,Atlantic,Eastern,90,2,150,0.6,99,-9,82,8
2011-12,2012-03-25,New Jersey Devils,0,Atlantic,Eastern,90,2,152,0.5921052631578947,101,-11,84,6
2011-12,2012-03-27,New Jersey Devils,2,Atlantic,Eastern,92,2,154,0.5974025974025974,101,-9,86,6
2011-12,2012-03-29,New Jersey Devils,2,Atlantic,Eastern,94,2,156,0.6025641025641025,103,-9,86,8
2011-12,2012-03-31,New Jersey Devils,2,Atlantic,Eastern,96,2,158,0.6075949367088608,107,-11,88,8
2011-12,2012-04-03,New Jersey Devils,2,Atlantic,Eastern,98,2,160,0.6125,109,-11,88,10
2011-12,2012-04-05,New Jersey Devils,2,Atlantic,Eastern,100,2,162,0.6172839506172839,109,-9,90,10
2011-12,2012-04-07,New Jersey Devils,2,Atlantic,Eastern,102,2,164,0.6219512195121951,109,-7,92,10
2011-12,2011-10-09,New York Islanders,0,Atlantic,Eastern,0,2,2,0.0,4,-4,2,-2
2011-12,2011-10-10,New York Islanders,2,Atlantic,Eastern,2,2,4,0.5,5,-3,2,0
2011-12,2011-10-13,New York Islanders,2,Atlantic,Eastern,4,2,6,0.6666666666666666,8,-4,3,1
2011-12,2011-10-15,New York Islanders,2,Atlantic,Eastern,6,2,8,0.75,8,-2,4,2
2011-12,2011-10-20,New York Islanders,0,Atlantic,Eastern,6,2,10,0.6,12,-6,6,0
2011-12,2011-10-22,New York Islanders,0,Atlantic,Eastern,6,2,12,0.5,14,-8,8,-2
2011-12,2011-10-25,New York Islanders,0,Atlantic,Eastern,6,2,14,0.42857142857142855,16,-10,9,-3
2011-12,2011-10-27,New York Islanders,1,Atlantic,Eastern,7,2,16,0.4375,18,-11,10,-3
2011-12,2011-10-29,New York Islanders,1,Atlantic,Eastern,8,2,18,0.4444444444444444,18,-10,12,-4
2011-12,2011-11-03,New York Islanders,0,Atlantic,Eastern,8,2,20,0.4,18,-10,13,-5
2011-12,2011-11-05,New York Islanders,2,Atlantic,Eastern,10,2,22,0.45454545454545453,19,-9,14,-4
2011-12,2011-11-08,New York Islanders,0,Atlantic,Eastern,10,2,24,0.4166666666666667,21,-11,15,-5
2011-12,2011-11-11,New York Islanders,1,Atlantic,Eastern,11,2,26,0.4230769230769231,21,-10,18,-7
2011-12,2011-11-14,New York Islanders,0,Atlantic,Eastern,11,2,28,0.39285714285714285,23,-12,18,-7
2011-12,2011-11-16,New York Islanders,0,Atlantic,Eastern,11,2,30,0.36666666666666664,25,-14,19,-8
2011-12,2011-11-18,New York Islanders,2,Atlantic,Eastern,13,2,32,0.40625,25,-12,21,-8
2011-12,2011-11-20,New York Islanders,0,Atlantic,Eastern,13,2,34,0.38235294117647056,25,-12,21,-8
2011-12,2011-11-22,New York Islanders,0,Atlantic,Eastern,13,2,36,0.3611111111111111,27,-14,23,-10
2011-12,2011-11-24,New York Islanders,1,Atlantic,Eastern,14,2,38,0.3684210526315789,28,-14,23,-9
2011-12,2011-11-25,New York Islanders,0,Atlantic,Eastern,14,2,40,0.35,29,-15,25,-11
2011-12,2011-11-26,New York Islanders,2,Atlantic,Eastern,16,2,42,0.38095238095238093,30,-14,25,-9
2011-12,2011-11-30,New York Islanders,2,Atlantic,Eastern,18,2,44,0.4090909090909091,32,-14,26,-8
2011-12,2011-12-03,New York Islanders,1,Atlantic,Eastern,19,2,46,0.41304347826086957,34,-15,27,-8
2011-12,2011-12-04,New York Islanders,2,Atlantic,Eastern,21,2,48,0.4375,36,-15,27,-6
2011-12,2011-12-07,New York Islanders,2,Atlantic,Eastern,23,2,50,0.46,36,-13,29,-6
2011-12,2011-12-09,New York Islanders,1,Atlantic,Eastern,24,2,52,0.46153846153846156,37,-13,30,-6
2011-12,2011-12-11,New York Islanders,0,Atlantic,Eastern,24,2,54,0.4444444444444444,39,-15,31,-7
2011-12,2011-12-14,New York Islanders,0,Atlantic,Eastern,24,2,56,0.42857142857142855,41,-17,33,-9
2011-12,2011-12-16,New York Islanders,0,Atlantic,Eastern,24,2,58,0.41379310344827586,43,-19,33,-9
2011-12,2011-12-18,New York Islanders,2,Atlantic,Eastern,26,2,60,0.43333333333333335,43,-17,35,-9
2011-12,2011-12-21,New York Islanders,2,Atlantic,Eastern,28,2,62,0.45161290322580644,44,-16,36,-8
2011-12,2011-12-23,New York Islanders,0,Atlantic,Eastern,28,2,64,0.4375,46,-18,37,-9
2011-12,2011-12-24,New York Islanders,0,Atlantic,Eastern,28,2,66,0.42424242424242425,46,-18,39,-11
2011-12,2011-12-27,New York Islanders,0,Atlantic,Eastern,28,2,68,0.4117647058823529,48,-20,39,-11
2011-12,2011-12-30,New York Islanders,2,Atlantic,Eastern,30,2,70,0.42857142857142855,48,-18,41,-11
2011-12,2011-12-31,New York Islanders,2,Atlantic,Eastern,32,2,72,0.4444444444444444,50,-18,41,-9
2011-12,2012-01-04,New York Islanders,2,Atlantic,Eastern,34,2,74,0.4594594594594595,52,-18,44,-10
2011-12,2012-01-07,New York Islanders,0,Atlantic,Eastern,34,2,76,0.4473684210526316,56,-22,45,-11
2011-12,2012-01-08,New York Islanders,0,Atlantic,Eastern,34,2,78,0.4358974358974359,56,-22,46,-12
2011-12,2012-01-11,New York Islanders,2,Atlantic,Eastern,36,2,80,0.45,58,-22,46,-10
2011-12,2012-01-13,New York Islanders,0,Atlantic,Eastern,36,2,82,0.43902439024390244,58,-22,46,-10
2011-12,2012-01-15,New York Islanders,2,Atlantic,Eastern,38,2,84,0.4523809523809524,60,-22,50,-12
2011-12,2012-01-16,New York Islanders,0,Atlantic,Eastern,38,2,86,0.4418604651162791,60,-22,50,-12
2011-12,2012-01-18,New York Islanders,2,Atlantic,Eastern,40,2,88,0.45454545454545453,62,-22,50,-10
2011-12,2012-01-20,New York Islanders,2,Atlantic,Eastern,42,2,90,0.4666666666666667,62,-20,52,-10
2011-12,2012-01-22,New York Islanders,2,Atlantic,Eastern,44,2,92,0.4782608695652174,64,-20,53,-9
2011-12,2012-01-24,New York Islanders,0,Atlantic,Eastern,44,2,94,0.46808510638297873,64,-20,53,-9
2011-12,2012-01-25,New York Islanders,1,Atlantic,Eastern,45,2,96,0.46875,66,-21,55,-10
2011-12,2012-02-01,New York Islanders,2,Atlantic,Eastern,47,2,98,0.47959183673469385,67,-20,56,-9
2011-12,2012-02-04,New York Islanders,2,Atlantic,Eastern,49,2,100,0.49,69,-20,58,-9
2011-12,2012-02-05,New York Islanders,1,Atlantic,Eastern,50,2,102,0.49019607843137253,71,-21,59,-9
2011-12,2012-02-08,New York Islanders,2,Atlantic,Eastern,52,2,104,0.5,71,-19,60,-8
2011-12,2012-02-10,New York Islanders,0,Atlantic,Eastern,52,2,106,0.49056603773584906,73,-21,61,-9
2011-12,2012-02-11,New York Islanders,2,Atlantic,Eastern,54,2,108,0.5,75,-21,62,-8
2011-12,2012-02-12,New York Islanders,0,Atlantic,Eastern,54,2,110,0.4909090909090909,77,-23,62,-8
2011-12,2012-02-15,New York Islanders,2,Atlantic,Eastern,56,2,112,0.5,79,-23,62,-6
2011-12,2012-02-17,New York Islanders,0,Atlantic,Eastern,56,2,114,0.49122807017543857,79,-23,64,-8
2011-12,2012-02-19,New York Islanders,2,Atlantic,Eastern,58,2,116,0.5,79,-21,64,-6
2011-12,2012-02-20,New York Islanders,0,Atlantic,Eastern,58,2,118,0.4915254237288136,81,-23,64,-6
2011-12,2012-02-22,New York Islanders,0,Atlantic,Eastern,58,2,120,0.48333333333333334,81,-23,65,-7
2011-12,2012-02-25,New York Islanders,2,Atlantic,Eastern,60,2,122,0.4918032786885246,82,-22,66,-6
2011-12,2012-02-26,New York Islanders,0,Atlantic,Eastern,60,2,124,0.4838709677419355,84,-24,68,-8
2011-12,2012-02-29,New York Islanders,1,Atlantic,Eastern,61,2,126,0.48412698412698413,86,-25,69,-8
2011-12,2012-03-02,New York Islanders,0,Atlantic,Eastern,61,2,128,0.4765625,88,-27,70,-9
2011-12,2012-03-03,New York Islanders,2,Atlantic,Eastern,63,2,130,0.4846153846153846,89,-26,70,-7
2011-12,2012-03-04,New York Islanders,2,Atlantic,Eastern,65,2,132,0.49242424242424243,91,-26,70,-5
2011-12,2012-03-09,New York Islanders,0,Atlantic,Eastern,65,2,134,0.48507462686567165,91,-26,72,-7
2011-12,2012-03-11,New York Islanders,0,Atlantic,Eastern,65,2,136,0.47794117647058826,93,-28,76,-11
2011-12,2012-03-11,New York Islanders,1,Atlantic,Eastern,66,2,138,0.4782608695652174,93,-27,76,-10
2011-12,2012-03-13,New York Islanders,1,Atlantic,Eastern,67,2,140,0.4785714285714286,95,-28,78,-11
2011-12,2012-03-15,New York Islanders,0,Atlantic,Eastern,67,2,142,0.47183098591549294,95,-28,78,-11
2011-12,2012-03-17,New York Islanders,2,Atlantic,Eastern,69,2,144,0.4791666666666667,95,-26,78,-9
2011-12,2012-03-20,New York Islanders,2,Atlantic,Eastern,71,2,146,0.4863013698630137,97,-26,80,-9
2011-12,2012-03-24,New York Islanders,0,Atlantic,Eastern,71,2,148,0.4797297297297297,101,-30,84,-13
2011-12,2012-03-25,New York Islanders,2,Atlantic,Eastern,73,2,150,0.4866666666666667,101,-28,84,-11
2011-12,2012-03-27,New York Islanders,2,Atlantic,Eastern,75,2,152,0.4934210526315789,101,-26,86,-11
2011-12,2012-03-29,New York Islanders,2,Atlantic,Eastern,77,2,154,0.5,103,-26,86,-9
2011-12,2012-03-31,New York Islanders,0,Atlantic,Eastern,77,2,156,0.4935897435897436,107,-30,88,-11
2011-12,2012-04-01,New York Islanders,0,Atlantic,Eastern,77,2,158,0.4873417721518987,107,-30,88,-11
2011-12,2012-04-03,New York Islanders,0,Atlantic,Eastern,77,2,160,0.48125,109,-32,88,-11
2011-12,2012-04-05,New York Islanders,2,Atlantic,Eastern,79,2,162,0.4876543209876543,109,-30,90,-11
2011-12,2012-04-07,New York Islanders,0,Atlantic,Eastern,79,2,164,0.4817073170731707,109,-30,92,-13
2011-12,2011-10-08,New York Rangers,1,Atlantic,Eastern,1,2,2,0.5,4,-3,1,0
2011-12,2011-10-09,New York Rangers,1,Atlantic,Eastern,2,2,4,0.5,4,-2,2,0
2011-12,2011-10-15,New York Rangers,0,Atlantic,Eastern,2,2,6,0.3333333333333333,8,-6,4,-2
2011-12,2011-10-19,New York Rangers,2,Atlantic,Eastern,4,2,8,0.5,10,-6,6,-2
2011-12,2011-10-21,New York Rangers,2,Atlantic,Eastern,6,2,10,0.6,12,-6,6,0
2011-12,2011-10-23,New York Rangers,0,Atlantic,Eastern,6,2,12,0.5,14,-8,8,-2
2011-12,2011-10-25,New York Rangers,2,Atlantic,Eastern,8,2,14,0.5714285714285714,16,-8,9,-1
2011-12,2011-10-27,New York Rangers,0,Atlantic,Eastern,8,2,16,0.5,18,-10,10,-2
2011-12,2011-10-29,New York Rangers,1,Atlantic,Eastern,9,2,18,0.5,18,-9,12,-3
2011-12,2011-10-31,New York Rangers,2,Atlantic,Eastern,11,2,20,0.55,18,-7,12,-1
2011-12,2011-11-03,New York Rangers,2,Atlantic,Eastern,13,2,22,0.5909090909090909,18,-5,13,0
2011-12,2011-11-05,New York Rangers,2,Atlantic,Eastern,15,2,24,0.625,19,-4,14,1
2011-12,2011-11-07,New York Rangers,2,Atlantic,Eastern,17,2,26,0.6538461538461539,21,-4,15,2
2011-12,2011-11-10,New York Rangers,2,Atlantic,Eastern,19,2,28,0.6785714285714286,21,-2,17,2
2011-12,2011-11-12,New York Rangers,2,Atlantic,Eastern,21,2,30,0.7,23,-2,18,3
2011-12,2011-11-16,New York Rangers,2,Atlantic,Eastern,23,2,32,0.71875,25,-2,19,4
2011-12,2011-11-20,New York Rangers,0,Atlantic,Eastern,23,2,34,0.6764705882352942,25,-2,21,2
2011-12,2011-11-24,New York Rangers,0,Atlantic,Eastern,23,2,36,0.6388888888888888,28,-5,23,0
2011-12,2011-11-25,New York Rangers,2,Atlantic,Eastern,25,2,38,0.6578947368421053,29,-4,25,0
2011-12,2011-11-26,New York Rangers,2,Atlantic,Eastern,27,2,40,0.675,30,-3,25,2
2011-12,2011-11-30,New York Rangers,2,Atlantic,Eastern,29,2,42,0.6904761904761905,32,-3,26,3
2011-12,2011-12-02,New York Rangers,2,Atlantic,Eastern,31,2,44,0.7045454545454546,34,-3,26,5
2011-12,2011-12-04,New York Rangers,2,Atlantic,Eastern,33,2,46,0.717391304347826,36,-3,27,6
2011-12,2011-12-06,New York Rangers,0,Atlantic,Eastern,33,2,48,0.6875,36,-3,29,4
2011-12,2011-12-09,New York Rangers,1,Atlantic,Eastern,34,2,50,0.68,37,-3,30,4
2011-12,2011-12-11,New York Rangers,2,Atlantic,Eastern,36,2,52,0.6923076923076923,39,-3,31,5
2011-12,2011-12-12,New York Rangers,2,Atlantic,Eastern,38,2,54,0.7037037037037037,39,-1,31,7
2011-12,2011-12-14,New York Rangers,0,Atlantic,Eastern,38,2,56,0.6785714285714286,41,-3,33,5
2011-12,2011-12-16,New York Rangers,0,Atlantic,Eastern,38,2,58,0.6551724137931034,43,-5,33,5
2011-12,2011-12-18,New York Rangers,2,Atlantic,Eastern,40,2,60,0.6666666666666666,43,-3,35,5
2011-12,2011-12-21,New York Rangers,2,Atlantic,Eastern,42,2,62,0.6774193548387096,44,-2,36,6
2011-12,2011-12-23,New York Rangers,2,Atlantic,Eastern,44,2,64,0.6875,46,-2,37,7
2011-12,2011-12-24,New York Rangers,2,Atlantic,Eastern,46,2,66,0.696969696969697,46,0,39,7
2011-12,2011-12-27,New York Rangers,2,Atlantic,Eastern,48,2,68,0.7058823529411765,48,0,39,9
2011-12,2011-12-29,New York Rangers,0,Atlantic,Eastern,48,2,70,0.6857142857142857,48,0,39,9
2011-12,2011-12-31,New York Rangers,2,Atlantic,Eastern,50,2,72,0.6944444444444444,50,0,41,9
2011-12,2012-01-02,New York Rangers,2,Atlantic,Eastern,52,2,74,0.7027027027027027,52,0,43,9
2011-12,2012-01-06,New York Rangers,2,Atlantic,Eastern,54,2,76,0.7105263157894737,54,0,44,10
2011-12,2012-01-07,New York Rangers,2,Atlantic,Eastern,56,2,78,0.717948717948718,56,0,45,11
2011-12,2012-01-11,New York Rangers,2,Atlantic,Eastern,58,2,80,0.725,58,0,46,12
2011-12,2012-01-13,New York Rangers,0,Atlantic,Eastern,58,2,82,0.7073170731707317,58,0,46,12
2011-12,2012-01-15,New York Rangers,2,Atlantic,Eastern,60,2,84,0.7142857142857143,60,0,50,10
2011-12,2012-01-16,New York Rangers,0,Atlantic,Eastern,60,2,86,0.6976744186046512,60,0,50,10
2011-12,2012-01-18,New York Rangers,2,Atlantic,Eastern,62,2,88,0.7045454545454546,62,0,50,12
2011-12,2012-01-20,New York Rangers,0,Atlantic,Eastern,62,2,90,0.6888888888888889,62,0,52,10
2011-12,2012-01-21,New York Rangers,2,Atlantic,Eastern,64,2,92,0.6956521739130435,64,0,52,12
2011-12,2012-01-25,New York Rangers,2,Atlantic,Eastern,66,2,94,0.7021276595744681,66,0,55,11
2011-12,2012-02-01,New York Rangers,1,Atlantic,Eastern,67,2,96,0.6979166666666666,67,0,56,11
2011-12,2012-02-02,New York Rangers,2,Atlantic,Eastern,69,2,98,0.7040816326530612,69,0,57,12
2011-12,2012-02-05,New York Rangers,2,Atlantic,Eastern,71,2,100,0.71,71,0,59,12
2011-12,2012-02-08,New York Rangers,0,Atlantic,Eastern,71,2,102,0.696078431372549,71,0,60,11
2011-12,2012-02-10,New York Rangers,2,Atlantic,Eastern,73,2,104,0.7019230769230769,73,0,61,12
2011-12,2012-02-11,New York Rangers,2,Atlantic,Eastern,75,2,106,0.7075471698113207,75,0,62,13
2011-12,2012-02-12,New York Rangers,2,Atlantic,Eastern,77,2,108,0.7129629629629629,77,0,62,15
2011-12,2012-02-15,New York Rangers,2,Atlantic,Eastern,79,2,110,0.7181818181818181,79,0,62,17
2011-12,2012-02-17,New York Rangers,0,Atlantic,Eastern,79,2,112,0.7053571428571429,79,0,64,15
2011-12,2012-02-20,New York Rangers,2,Atlantic,Eastern,81,2,114,0.7105263157894737,81,0,64,17
2011-12,2012-02-22,New York Rangers,0,Atlantic,Eastern,81,2,116,0.6982758620689655,81,0,65,16
2011-12,2012-02-25,New York Rangers,1,Atlantic,Eastern,82,2,118,0.6949152542372882,82,0,66,16
2011-12,2012-02-26,New York Rangers,2,Atlantic,Eastern,84,2,120,0.7,84,0,68,16
2011-12,2012-02-28,New York Rangers,2,Atlantic,Eastern,86,2,122,0.7049180327868853,86,0,68,18
2011-12,2012-03-02,New York Rangers,2,Atlantic,Eastern,88,2,124,0.7096774193548387,88,0,70,18
2011-12,2012-03-03,New York Rangers,1,Atlantic,Eastern,89,2,126,0.7063492063492064,89,0,70,19
2011-12,2012-03-04,New York Rangers,2,Atlantic,Eastern,91,2,128,0.7109375,91,0,70,21
2011-12,2012-03-07,New York Rangers,0,Atlantic,Eastern,91,2,130,0.7,91,0,72,19
2011-12,2012-03-09,New York Rangers,0,Atlantic,Eastern,91,2,132,0.6893939393939394,91,0,72,19
2011-12,2012-03-10,New York Rangers,0,Atlantic,Eastern,91,2,134,0.6791044776119403,91,0,74,17
2011-12,2012-03-11,New York Rangers,2,Atlantic,Eastern,93,2,136,0.6838235294117647,93,0,76,17
2011-12,2012-03-13,New York Rangers,2,Atlantic,Eastern,95,2,138,0.6884057971014492,95,0,78,17
2011-12,2012-03-15,New York Rangers,0,Atlantic,Eastern,95,2,140,0.6785714285714286,95,0,78,17
2011-12,2012-03-17,New York Rangers,0,Atlantic,Eastern,95,2,142,0.6690140845070423,95,0,78,17
2011-12,2012-03-19,New York Rangers,2,Atlantic,Eastern,97,2,144,0.6736111111111112,97,0,80,17
2011-12,2012-03-21,New York Rangers,2,Atlantic,Eastern,99,2,146,0.678082191780822,99,0,80,19
2011-12,2012-03-23,New York Rangers,0,Atlantic,Eastern,99,2,148,0.668918918918919,99,0,82,17
2011-12,2012-03-24,New York Rangers,2,Atlantic,Eastern,101,2,150,0.6733333333333333,101,0,84,17
2011-12,2012-03-28,New York Rangers,2,Atlantic,Eastern,103,2,152,0.6776315789473685,103,0,86,17
2011-12,2012-03-28,New York Rangers,2,Atlantic,Eastern,105,2,154,0.6818181818181818,103,2,86,19
2011-12,2012-03-30,New York Rangers,2,Atlantic,Eastern,107,2,156,0.6858974358974359,107,0,86,21
2011-12,2012-04-01,New York Rangers,0,Atlantic,Eastern,107,2,158,0.6772151898734177,107,0,88,19
2011-12,2012-04-03,New York Rangers,2,Atlantic,Eastern,109,2,160,0.68125,109,0,88,21
2011-12,2012-04-05,New York Rangers,0,Atlantic,Eastern,109,2,162,0.6728395061728395,109,0,90,19
2011-12,2012-04-07,New York Rangers,0,Atlantic,Eastern,109,2,164,0.6646341463414634,109,0,92,17
2011-12,2011-10-07,Ottawa Senators,0,Northeast,Eastern,0,2,2,0.0,2,-2,0,0
2011-12,2011-10-08,Ottawa Senators,0,Northeast,Eastern,0,2,4,0.0,4,-4,1,-1
2011-12,2011-10-11,Ottawa Senators,2,Northeast,Eastern,2,2,6,0.3333333333333333,4,-2,2,0
2011-12,2011-10-13,Ottawa Senators,0,Northeast,Eastern,2,2,8,0.25,4,-2,3,-1
2011-12,2011-10-15,Ottawa Senators,0,Northeast,Eastern,2,2,10,0.2,6,-4,4,-2
2011-12,2011-10-18,Ottawa Senators,0,Northeast,Eastern,2,2,12,0.16666666666666666,8,-6,6,-4
2011-12,2011-10-20,Ottawa Senators,2,Northeast,Eastern,4,2,14,0.2857142857142857,10,-6,6,-2
2011-12,2011-10-22,Ottawa Senators,2,Northeast,Eastern,6,2,16,0.375,11,-5,8,-2
2011-12,2011-10-25,Ottawa Senators,2,Northeast,Eastern,8,2,18,0.4444444444444444,11,-3,9,-1
2011-12,2011-10-27,Ottawa Senators,2,Northeast,Eastern,10,2,20,0.5,13,-3,10,0
2011-12,2011-10-29,Ottawa Senators,2,Northeast,Eastern,12,2,22,0.5454545454545454,15,-3,12,0
2011-12,2011-10-30,Ottawa Senators,2,Northeast,Eastern,14,2,24,0.5833333333333334,15,-1,12,2
2011-12,2011-11-01,Ottawa Senators,0,Northeast,Eastern,14,2,26,0.5384615384615384,15,-1,12,2
2011-12,2011-11-04,Ottawa Senators,0,Northeast,Eastern,14,2,28,0.5,19,-5,14,0
2011-12,2011-11-05,Ottawa Senators,1,Northeast,Eastern,15,2,30,0.5,19,-4,14,1
2011-12,2011-11-10,Ottawa Senators,0,Northeast,Eastern,15,2,32,0.46875,19,-4,17,-2
2011-12,2011-11-12,Ottawa Senators,0,Northeast,Eastern,15,2,34,0.4411764705882353,21,-6,18,-3
2011-12,2011-11-13,Ottawa Senators,2,Northeast,Eastern,17,2,36,0.4722222222222222,21,-4,18,-1
2011-12,2011-11-16,Ottawa Senators,2,Northeast,Eastern,19,2,38,0.5,22,-3,19,0
2011-12,2011-11-18,Ottawa Senators,2,Northeast,Eastern,21,2,40,0.525,22,-1,21,0
2011-12,2011-11-21,Ottawa Senators,1,Northeast,Eastern,22,2,42,0.5238095238095238,24,-2,22,0
2011-12,2011-11-26,Ottawa Senators,0,Northeast,Eastern,22,2,44,0.5,28,-6,25,-3
2011-12,2011-11-27,Ottawa Senators,2,Northeast,Eastern,24,2,46,0.5217391304347826,29,-5,25,-1
2011-12,2011-11-30,Ottawa Senators,2,Northeast,Eastern,26,2,48,0.5416666666666666,30,-4,26,0
2011-12,2011-12-02,Ottawa Senators,0,Northeast,Eastern,26,2,50,0.52,31,-5,26,0
2011-12,2011-12-04,Ottawa Senators,1,Northeast,Eastern,27,2,52,0.5192307692307693,33,-6,27,0
2011-12,2011-12-06,Ottawa Senators,2,Northeast,Eastern,29,2,54,0.5370370370370371,35,-6,29,0
2011-12,2011-12-08,Ottawa Senators,0,Northeast,Eastern,29,2,56,0.5178571428571429,35,-6,29,0
2011-12,2011-12-09,Ottawa Senators,1,Northeast,Eastern,30,2,58,0.5172413793103449,35,-5,30,0
2011-12,2011-12-11,Ottawa Senators,0,Northeast,Eastern,30,2,60,0.5,37,-7,31,-1
2011-12,2011-12-14,Ottawa Senators,2,Northeast,Eastern,32,2,62,0.5161290322580645,39,-7,33,-1
2011-12,2011-12-15,Ottawa Senators,0,Northeast,Eastern,32,2,64,0.5,41,-9,33,-1
2011-12,2011-12-17,Ottawa Senators,2,Northeast,Eastern,34,2,66,0.5151515151515151,43,-9,35,-1
2011-12,2011-12-21,Ottawa Senators,2,Northeast,Eastern,36,2,68,0.5294117647058824,45,-9,36,0
2011-12,2011-12-23,Ottawa Senators,2,Northeast,Eastern,38,2,70,0.5428571428571428,45,-7,37,1
2011-12,2011-12-24,Ottawa Senators,1,Northeast,Eastern,39,2,72,0.5416666666666666,47,-8,39,0
2011-12,2011-12-28,Ottawa Senators,0,Northeast,Eastern,39,2,74,0.527027027027027,47,-8,39,0
2011-12,2011-12-31,Ottawa Senators,2,Northeast,Eastern,41,2,76,0.5394736842105263,49,-8,41,0
2011-12,2012-01-01,Ottawa Senators,2,Northeast,Eastern,43,2,78,0.5512820512820513,49,-6,43,0
2011-12,2012-01-03,Ottawa Senators,2,Northeast,Eastern,45,2,80,0.5625,49,-4,43,2
2011-12,2012-01-06,Ottawa Senators,2,Northeast,Eastern,47,2,82,0.573170731707317,53,-6,44,3
2011-12,2012-01-07,Ottawa Senators,1,Northeast,Eastern,48,2,84,0.5714285714285714,53,-5,45,3
2011-12,2012-01-08,Ottawa Senators,2,Northeast,Eastern,50,2,86,0.5813953488372093,53,-3,46,4
2011-12,2012-01-11,Ottawa Senators,2,Northeast,Eastern,52,2,88,0.5909090909090909,55,-3,46,6
2011-12,2012-01-13,Ottawa Senators,2,Northeast,Eastern,54,2,90,0.6,57,-3,46,8
2011-12,2012-01-15,Ottawa Senators,2,Northeast,Eastern,56,2,92,0.6086956521739131,57,-1,50,6
2011-12,2012-01-17,Ottawa Senators,0,Northeast,Eastern,56,2,94,0.5957446808510638,59,-3,50,6
2011-12,2012-01-18,Ottawa Senators,2,Northeast,Eastern,58,2,96,0.6041666666666666,59,-1,50,8
2011-12,2012-01-20,Ottawa Senators,2,Northeast,Eastern,60,2,98,0.6122448979591837,61,-1,52,8
2011-12,2012-01-21,Ottawa Senators,0,Northeast,Eastern,60,2,100,0.6,62,-2,52,8
2011-12,2012-01-24,Ottawa Senators,0,Northeast,Eastern,60,2,102,0.5882352941176471,64,-4,53,7
2011-12,2012-01-25,Ottawa Senators,0,Northeast,Eastern,60,2,104,0.5769230769230769,64,-4,55,5
2011-12,2012-02-01,Ottawa Senators,0,Northeast,Eastern,60,2,106,0.5660377358490566,66,-6,56,4
2011-12,2012-02-04,Ottawa Senators,1,Northeast,Eastern,61,2,108,0.5648148148148148,66,-5,58,3
2011-12,2012-02-05,Ottawa Senators,0,Northeast,Eastern,61,2,110,0.5545454545454546,68,-7,59,2
2011-12,2012-02-08,Ottawa Senators,0,Northeast,Eastern,61,2,112,0.5446428571428571,68,-7,60,1
2011-12,2012-02-10,Ottawa Senators,2,Northeast,Eastern,63,2,114,0.5526315789473685,68,-5,61,2
2011-12,2012-02-11,Ottawa Senators,1,Northeast,Eastern,64,2,116,0.5517241379310345,70,-6,62,2
2011-12,2012-02-15,Ottawa Senators,2,Northeast,Eastern,66,2,118,0.559322033898305,70,-4,62,4
2011-12,2012-02-16,Ottawa Senators,2,Northeast,Eastern,68,2,120,0.5666666666666667,72,-4,64,4
2011-12,2012-02-20,Ottawa Senators,2,Northeast,Eastern,70,2,122,0.5737704918032787,72,-2,64,6
2011-12,2012-02-23,Ottawa Senators,2,Northeast,Eastern,72,2,124,0.5806451612903226,74,-2,65,7
2011-12,2012-02-26,Ottawa Senators,2,Northeast,Eastern,74,2,126,0.5873015873015873,77,-3,68,6
2011-12,2012-02-26,Ottawa Senators,0,Northeast,Eastern,74,2,128,0.578125,77,-3,68,6
2011-12,2012-02-29,Ottawa Senators,2,Northeast,Eastern,76,2,130,0.5846153846153846,77,-1,69,7
2011-12,2012-03-03,Ottawa Senators,0,Northeast,Eastern,76,2,132,0.5757575757575758,79,-3,70,6
2011-12,2012-03-04,Ottawa Senators,0,Northeast,Eastern,76,2,134,0.5671641791044776,79,-3,70,6
2011-12,2012-03-07,Ottawa Senators,2,Northeast,Eastern,78,2,136,0.5735294117647058,81,-3,72,6
2011-12,2012-03-09,Ottawa Senators,2,Northeast,Eastern,80,2,138,0.5797101449275363,83,-3,72,8
2011-12,2012-03-11,Ottawa Senators,1,Northeast,Eastern,81,2,140,0.5785714285714286,83,-2,76,5
2011-12,2012-03-14,Ottawa Senators,1,Northeast,Eastern,82,2,142,0.5774647887323944,83,-1,78,4
2011-12,2012-03-16,Ottawa Senators,2,Northeast,Eastern,84,2,144,0.5833333333333334,84,0,78,6
2011-12,2012-03-17,Ottawa Senators,0,Northeast,Eastern,84,2,146,0.5753424657534246,85,-1,78,6
2011-12,2012-03-20,Ottawa Senators,0,Northeast,Eastern,84,2,148,0.5675675675675675,87,-3,80,4
2011-12,2012-03-23,Ottawa Senators,0,Northeast,Eastern,84,2,150,0.56,87,-3,82,2
2011-12,2012-03-24,Ottawa Senators,2,Northeast,Eastern,86,2,152,0.5657894736842105,87,-1,84,2
2011-12,2012-03-27,Ottawa Senators,2,Northeast,Eastern,88,2,154,0.5714285714285714,93,-5,86,2
2011-12,2012-03-31,Ottawa Senators,2,Northeast,Eastern,90,2,156,0.5769230769230769,96,-6,88,2
2011-12,2012-04-01,Ottawa Senators,2,Northeast,Eastern,92,2,158,0.5822784810126582,98,-6,88,4
2011-12,2012-04-03,Ottawa Senators,0,Northeast,Eastern,92,2,160,0.575,98,-6,88,4
2011-12,2012-04-05,Ottawa Senators,0,Northeast,Eastern,92,2,162,0.5679012345679012,100,-8,90,2
2011-12,2012-04-07,Ottawa Senators,0,Northeast,Eastern,92,2,164,0.5609756097560976,102,-10,92,0
2011-12,2011-10-06,Philadelphia Flyers,2,Atlantic,Eastern,2,2,2,1.0,2,0,0,2
2011-12,2011-10-08,Philadelphia Flyers,2,Atlantic,Eastern,4,2,4,1.0,4,0,1,3
2011-12,2011-10-12,Philadelphia Flyers,2,Atlantic,Eastern,6,2,6,1.0,7,-1,2,4
2011-12,2011-10-15,Philadelphia Flyers,1,Atlantic,Eastern,7,2,8,0.875,8,-1,4,3
2011-12,2011-10-18,Philadelphia Flyers,2,Atlantic,Eastern,9,2,10,0.9,10,-1,6,3
2011-12,2011-10-20,Philadelphia Flyers,0,Atlantic,Eastern,9,2,12,0.75,12,-3,6,3
2011-12,2011-10-22,Philadelphia Flyers,0,Atlantic,Eastern,9,2,14,0.6428571428571429,14,-5,8,1
2011-12,2011-10-24,Philadelphia Flyers,2,Atlantic,Eastern,11,2,16,0.6875,14,-3,8,3
2011-12,2011-10-26,Philadelphia Flyers,0,Atlantic,Eastern,11,2,18,0.6111111111111112,16,-5,9,2
2011-12,2011-10-27,Philadelphia Flyers,0,Atlantic,Eastern,11,2,20,0.55,18,-7,10,1
2011-12,2011-10-29,Philadelphia Flyers,2,Atlantic,Eastern,13,2,22,0.5909090909090909,18,-5,12,1
2011-12,2011-11-02,Philadelphia Flyers,2,Atlantic,Eastern,15,2,24,0.625,18,-3,12,3
2011-12,2011-11-03,Philadelphia Flyers,1,Atlantic,Eastern,16,2,26,0.6153846153846154,18,-2,13,3
2011-12,2011-11-05,Philadelphia Flyers,2,Atlantic,Eastern,18,2,28,0.6428571428571429,19,-1,14,4
2011-12,2011-11-10,Philadelphia Flyers,1,Atlantic,Eastern,19,2,30,0.6333333333333333,21,-2,17,2
2011-12,2011-11-13,Philadelphia Flyers,2,Atlantic,Eastern,21,2,32,0.65625,23,-2,18,3
2011-12,2011-11-15,Philadelphia Flyers,2,Atlantic,Eastern,23,2,34,0.6764705882352942,23,0,18,5
2011-12,2011-11-18,Philadelphia Flyers,2,Atlantic,Eastern,25,2,36,0.6944444444444444,25,0,21,4
2011-12,2011-11-19,Philadelphia Flyers,0,Atlantic,Eastern,25,2,38,0.6578947368421053,25,0,21,4
2011-12,2011-11-22,Philadelphia Flyers,0,Atlantic,Eastern,25,2,40,0.625,27,-2,23,2
2011-12,2011-11-24,Philadelphia Flyers,2,Atlantic,Eastern,27,2,42,0.6428571428571429,28,-1,23,4
2011-12,2011-11-25,Philadelphia Flyers,2,Atlantic,Eastern,29,2,44,0.6590909090909091,29,0,25,4
2011-12,2011-11-26,Philadelphia Flyers,0,Atlantic,Eastern,29,2,46,0.6304347826086957,30,-1,25,4
2011-12,2011-12-03,Philadelphia Flyers,2,Atlantic,Eastern,31,2,48,0.6458333333333334,34,-3,27,4
2011-12,2011-12-04,Philadelphia Flyers,2,Atlantic,Eastern,33,2,50,0.66,36,-3,27,6
2011-12,2011-12-08,Philadelphia Flyers,2,Atlantic,Eastern,35,2,52,0.6730769230769231,36,-1,29,6
2011-12,2011-12-09,Philadelphia Flyers,2,Atlantic,Eastern,37,2,54,0.6851851851851852,37,0,30,7
2011-12,2011-12-11,Philadelphia Flyers,2,Atlantic,Eastern,39,2,56,0.6964285714285714,39,0,31,8
2011-12,2011-12-14,Philadelphia Flyers,2,Atlantic,Eastern,41,2,58,0.7068965517241379,41,0,33,8
2011-12,2011-12-16,Philadelphia Flyers,2,Atlantic,Eastern,43,2,60,0.7166666666666667,43,0,33,10
2011-12,2011-12-17,Philadelphia Flyers,0,Atlantic,Eastern,43,2,62,0.6935483870967742,43,0,35,8
2011-12,2011-12-20,Philadelphia Flyers,1,Atlantic,Eastern,44,2,64,0.6875,44,0,35,9
2011-12,2011-12-22,Philadelphia Flyers,2,Atlantic,Eastern,46,2,66,0.696969696969697,46,0,36,10
2011-12,2011-12-24,Philadelphia Flyers,0,Atlantic,Eastern,46,2,68,0.6764705882352942,46,0,39,7
2011-12,2011-12-28,Philadelphia Flyers,0,Atlantic,Eastern,46,2,70,0.6571428571428571,48,-2,39,7
2011-12,2011-12-30,Philadelphia Flyers,2,Atlantic,Eastern,48,2,72,0.6666666666666666,48,0,41,7
2011-12,2012-01-02,Philadelphia Flyers,0,Atlantic,Eastern,48,2,74,0.6486486486486487,52,-4,43,5
2011-12,2012-01-06,Philadelphia Flyers,2,Atlantic,Eastern,50,2,76,0.6578947368421053,54,-4,44,6
2011-12,2012-01-07,Philadelphia Flyers,2,Atlantic,Eastern,52,2,78,0.6666666666666666,56,-4,45,7
2011-12,2012-01-08,Philadelphia Flyers,0,Atlantic,Eastern,52,2,80,0.65,56,-4,46,6
2011-12,2012-01-11,Philadelphia Flyers,2,Atlantic,Eastern,54,2,82,0.6585365853658537,58,-4,46,8
2011-12,2012-01-13,Philadelphia Flyers,2,Atlantic,Eastern,56,2,84,0.6666666666666666,58,-2,46,10
2011-12,2012-01-15,Philadelphia Flyers,0,Atlantic,Eastern,56,2,86,0.6511627906976745,60,-4,50,6
2011-12,2012-01-18,Philadelphia Flyers,2,Atlantic,Eastern,58,2,88,0.6590909090909091,62,-4,50,8
2011-12,2012-01-20,Philadelphia Flyers,0,Atlantic,Eastern,58,2,90,0.6444444444444445,62,-4,52,6
2011-12,2012-01-21,Philadelphia Flyers,2,Atlantic,Eastern,60,2,92,0.6521739130434783,64,-4,52,8
2011-12,2012-01-22,Philadelphia Flyers,1,Atlantic,Eastern,61,2,94,0.648936170212766,64,-3,53,8
2011-12,2012-01-25,Philadelphia Flyers,2,Atlantic,Eastern,63,2,96,0.65625,66,-3,55,8
2011-12,2012-02-01,Philadelphia Flyers,1,Atlantic,Eastern,64,2,98,0.6530612244897959,67,-3,56,8
2011-12,2012-02-03,Philadelphia Flyers,2,Atlantic,Eastern,66,2,100,0.66,69,-3,57,9
2011-12,2012-02-04,Philadelphia Flyers,0,Atlantic,Eastern,66,2,102,0.6470588235294118,69,-3,58,8
2011-12,2012-02-05,Philadelphia Flyers,0,Atlantic,Eastern,66,2,104,0.6346153846153846,71,-5,59,7
2011-12,2012-02-08,Philadelphia Flyers,1,Atlantic,Eastern,67,2,106,0.6320754716981132,71,-4,60,7
2011-12,2012-02-10,Philadelphia Flyers,2,Atlantic,Eastern,69,2,108,0.6388888888888888,73,-4,61,8
2011-12,2012-02-11,Philadelphia Flyers,0,Atlantic,Eastern,69,2,110,0.6272727272727273,75,-6,62,7
2011-12,2012-02-13,Philadelphia Flyers,0,Atlantic,Eastern,69,2,112,0.6160714285714286,77,-8,62,7
2011-12,2012-02-17,Philadelphia Flyers,2,Atlantic,Eastern,71,2,114,0.6228070175438597,79,-8,64,7
2011-12,2012-02-18,Philadelphia Flyers,0,Atlantic,Eastern,71,2,116,0.6120689655172413,79,-8,64,7
2011-12,2012-02-22,Philadelphia Flyers,2,Atlantic,Eastern,73,2,118,0.6186440677966102,81,-8,65,8
2011-12,2012-02-24,Philadelphia Flyers,0,Atlantic,Eastern,73,2,120,0.6083333333333333,81,-8,66,7
2011-12,2012-02-26,Philadelphia Flyers,2,Atlantic,Eastern,75,2,122,0.6147540983606558,84,-9,68,7
2011-12,2012-02-29,Philadelphia Flyers,0,Atlantic,Eastern,75,2,124,0.6048387096774194,86,-11,69,6
2011-12,2012-03-02,Philadelphia Flyers,2,Atlantic,Eastern,77,2,126,0.6111111111111112,88,-11,70,7
2011-12,2012-03-05,Philadelphia Flyers,2,Atlantic,Eastern,79,2,128,0.6171875,91,-12,70,9
2011-12,2012-03-07,Philadelphia Flyers,2,Atlantic,Eastern,81,2,130,0.6230769230769231,91,-10,72,9
2011-12,2012-03-09,Philadelphia Flyers,2,Atlantic,Eastern,83,2,132,0.6287878787878788,91,-8,72,11
2011-12,2012-03-11,Philadelphia Flyers,2,Atlantic,Eastern,85,2,134,0.6343283582089553,93,-8,76,9
2011-12,2012-03-11,Philadelphia Flyers,0,Atlantic,Eastern,85,2,136,0.625,93,-8,76,9
2011-12,2012-03-13,Philadelphia Flyers,2,Atlantic,Eastern,87,2,138,0.6304347826086957,95,-8,78,9
2011-12,2012-03-15,Philadelphia Flyers,2,Atlantic,Eastern,89,2,140,0.6357142857142857,95,-6,78,11
2011-12,2012-03-17,Philadelphia Flyers,1,Atlantic,Eastern,90,2,142,0.6338028169014085,95,-5,78,12
2011-12,2012-03-18,Philadelphia Flyers,2,Atlantic,Eastern,92,2,144,0.6388888888888888,95,-3,78,14
2011-12,2012-03-20,Philadelphia Flyers,0,Atlantic,Eastern,92,2,146,0.6301369863013698,97,-5,80,12
2011-12,2012-03-22,Philadelphia Flyers,2,Atlantic,Eastern,94,2,148,0.6351351351351351,99,-5,81,13
2011-12,2012-03-24,Philadelphia Flyers,2,Atlantic,Eastern,96,2,150,0.64,101,-5,84,12
2011-12,2012-03-26,Philadelphia Flyers,0,Atlantic,Eastern,96,2,152,0.631578947368421,101,-5,84,12
2011-12,2012-03-29,Philadelphia Flyers,2,Atlantic,Eastern,98,2,154,0.6363636363636364,103,-5,86,12
2011-12,2012-03-31,Philadelphia Flyers,1,Atlantic,Eastern,99,2,156,0.6346153846153846,107,-8,88,11
2011-12,2012-04-01,Philadelphia Flyers,2,Atlantic,Eastern,101,2,158,0.6392405063291139,107,-6,88,13
2011-12,2012-04-03,Philadelphia Flyers,0,Atlantic,Eastern,101,2,160,0.63125,109,-8,88,13
2011-12,2012-04-05,Philadelphia Flyers,2,Atlantic,Eastern,103,2,162,0.6358024691358025,109,-6,90,13
2011-12,2012-04-07,Philadelphia Flyers,0,Atlantic,Eastern,103,2,164,0.6280487804878049,109,-6,92,11
2011-12,2011-10-09,Phoenix Coyotes,0,Pacific,Western,0,2,2,0.0,2,-2,2,-2
2011-12,2011-10-10,Phoenix Coyotes,1,Pacific,Western,1,2,4,0.25,4,-3,2,-1
2011-12,2011-10-14,Phoenix Coyotes,2,Pacific,Western,3,2,6,0.5,6,-3,3,0
2011-12,2011-10-15,Phoenix Coyotes,2,Pacific,Western,5,2,8,0.625,6,-1,4,1
2011-12,2011-10-19,Phoenix Coyotes,0,Pacific,Western,5,2,10,0.5,10,-5,5,0
2011-12,2011-10-21,Phoenix Coyotes,0,Pacific,Western,5,2,12,0.4166666666666667,10,-5,7,-2
2011-12,2011-10-24,Phoenix Coyotes,2,Pacific,Western,7,2,14,0.5,12,-5,8,-1
2011-12,2011-10-26,Phoenix Coyotes,1,Pacific,Western,8,2,16,0.5,14,-6,9,-1
2011-12,2011-10-28,Phoenix Coyotes,2,Pacific,Western,10,2,18,0.5555555555555556,14,-4,10,0
2011-12,2011-10-30,Phoenix Coyotes,2,Pacific,Western,12,2,20,0.6,16,-4,11,1
2011-12,2011-11-03,Phoenix Coyotes,2,Pacific,Western,14,2,22,0.6363636363636364,16,-2,13,1
2011-12,2011-11-04,Phoenix Coyotes,0,Pacific,Western,14,2,24,0.5833333333333334,16,-2,14,0
2011-12,2011-11-06,Phoenix Coyotes,2,Pacific,Western,16,2,26,0.6153846153846154,20,-4,15,1
2011-12,2011-11-11,Phoenix Coyotes,1,Pacific,Western,17,2,28,0.6071428571428571,22,-5,17,0
2011-12,2011-11-13,Phoenix Coyotes,2,Pacific,Western,19,2,30,0.6333333333333333,22,-3,19,0
2011-12,2011-11-16,Phoenix Coyotes,2,Pacific,Western,21,2,32,0.65625,22,-1,19,2
2011-12,2011-11-18,Phoenix Coyotes,0,Pacific,Western,21,2,34,0.6176470588235294,23,-2,21,0
2011-12,2011-11-20,Phoenix Coyotes,2,Pacific,Western,23,2,36,0.6388888888888888,23,0,22,1
2011-12,2011-11-22,Phoenix Coyotes,0,Pacific,Western,23,2,38,0.6052631578947368,25,-2,23,0
2011-12,2011-11-24,Phoenix Coyotes,2,Pacific,Western,25,2,40,0.625,27,-2,24,1
2011-12,2011-11-26,Phoenix Coyotes,0,Pacific,Western,25,2,42,0.5952380952380952,27,-2,26,-1
2011-12,2011-11-27,Phoenix Coyotes,2,Pacific,Western,27,2,44,0.6136363636363636,27,0,27,0
2011-12,2011-11-30,Phoenix Coyotes,2,Pacific,Western,29,2,46,0.6304347826086957,29,0,28,1
2011-12,2011-12-02,Phoenix Coyotes,0,Pacific,Western,29,2,48,0.6041666666666666,31,-2,29,0
2011-12,2011-12-04,Phoenix Coyotes,0,Pacific,Western,29,2,50,0.58,31,-2,29,0
2011-12,2011-12-06,Phoenix Coyotes,2,Pacific,Western,31,2,52,0.5961538461538461,31,0,30,1
2011-12,2011-12-07,Phoenix Coyotes,2,Pacific,Western,33,2,54,0.6111111111111112,33,0,30,3
2011-12,2011-12-09,Phoenix Coyotes,0,Pacific,Western,33,2,56,0.5892857142857143,33,0,31,2
2011-12,2011-12-11,Phoenix Coyotes,0,Pacific,Western,33,2,58,0.5689655172413793,33,0,32,1
2011-12,2011-12-15,Phoenix Coyotes,0,Pacific,Western,33,2,60,0.55,35,-2,33,0
2011-12,2011-12-16,Phoenix Coyotes,2,Pacific,Western,35,2,62,0.5645161290322581,37,-2,35,0
2011-12,2011-12-18,Phoenix Coyotes,0,Pacific,Western,35,2,64,0.546875,37,-2,37,-2
2011-12,2011-12-21,Phoenix Coyotes,2,Pacific,Western,37,2,66,0.5606060606060606,39,-2,37,0
2011-12,2011-12-22,Phoenix Coyotes,2,Pacific,Western,39,2,68,0.5735294117647058,39,0,39,0
2011-12,2011-12-24,Phoenix Coyotes,0,Pacific,Western,39,2,70,0.5571428571428572,41,-2,40,-1
2011-12,2011-12-27,Phoenix Coyotes,0,Pacific,Western,39,2,72,0.5416666666666666,41,-2,40,-1
2011-12,2011-12-29,Phoenix Coyotes,1,Pacific,Western,40,2,74,0.5405405405405406,42,-2,41,-1
2011-12,2011-12-30,Phoenix Coyotes,0,Pacific,Western,40,2,76,0.5263157894736842,42,-2,42,-2
2011-12,2011-12-31,Phoenix Coyotes,2,Pacific,Western,42,2,78,0.5384615384615384,42,0,42,0
2011-12,2012-01-04,Phoenix Coyotes,0,Pacific,Western,42,2,80,0.525,45,-3,45,-3
2011-12,2012-01-06,Phoenix Coyotes,1,Pacific,Western,43,2,82,0.524390243902439,48,-5,46,-3
2011-12,2012-01-08,Phoenix Coyotes,2,Pacific,Western,45,2,84,0.5357142857142857,50,-5,47,-2
2011-12,2012-01-11,Phoenix Coyotes,1,Pacific,Western,46,2,86,0.5348837209302325,51,-5,49,-3
2011-12,2012-01-13,Phoenix Coyotes,1,Pacific,Western,47,2,88,0.5340909090909091,53,-6,50,-3
2011-12,2012-01-14,Phoenix Coyotes,0,Pacific,Western,47,2,90,0.5222222222222223,53,-6,50,-3
2011-12,2012-01-16,Phoenix Coyotes,2,Pacific,Western,49,2,92,0.532608695652174,55,-6,51,-2
2011-12,2012-01-19,Phoenix Coyotes,0,Pacific,Western,49,2,94,0.5212765957446809,57,-8,52,-3
2011-12,2012-01-20,Phoenix Coyotes,1,Pacific,Western,50,2,96,0.5208333333333334,57,-7,52,-2
2011-12,2012-01-22,Phoenix Coyotes,0,Pacific,Western,50,2,98,0.5102040816326531,57,-7,54,-4
2011-12,2012-01-25,Phoenix Coyotes,2,Pacific,Western,52,2,100,0.52,60,-8,55,-3
2011-12,2012-02-01,Phoenix Coyotes,0,Pacific,Western,52,2,102,0.5098039215686274,62,-10,55,-3
2011-12,2012-02-05,Phoenix Coyotes,2,Pacific,Western,54,2,104,0.5192307692307693,64,-10,58,-4
2011-12,2012-02-07,Phoenix Coyotes,2,Pacific,Western,56,2,106,0.5283018867924528,64,-8,58,-2
2011-12,2012-02-08,Phoenix Coyotes,2,Pacific,Western,58,2,108,0.5370370370370371,64,-6,58,0
2011-12,2012-02-10,Phoenix Coyotes,2,Pacific,Western,60,2,110,0.5454545454545454,64,-4,60,0
2011-12,2012-02-12,Phoenix Coyotes,2,Pacific,Western,62,2,112,0.5535714285714286,66,-4,62,0
2011-12,2012-02-14,Phoenix Coyotes,1,Pacific,Western,63,2,114,0.5526315789473685,68,-5,63,0
2011-12,2012-02-17,Phoenix Coyotes,2,Pacific,Western,65,2,116,0.5603448275862069,69,-4,65,0
2011-12,2012-02-19,Phoenix Coyotes,2,Pacific,Western,67,2,118,0.5677966101694916,69,-2,65,2
2011-12,2012-02-22,Phoenix Coyotes,2,Pacific,Western,69,2,120,0.575,69,0,66,3
2011-12,2012-02-24,Phoenix Coyotes,2,Pacific,Western,71,2,122,0.5819672131147541,71,0,66,5
2011-12,2012-02-25,Phoenix Coyotes,2,Pacific,Western,73,2,124,0.5887096774193549,73,0,68,5
2011-12,2012-02-29,Phoenix Coyotes,2,Pacific,Western,75,2,126,0.5952380952380952,75,0,70,5
2011-12,2012-03-02,Phoenix Coyotes,0,Pacific,Western,75,2,128,0.5859375,75,0,71,4
2011-12,2012-03-04,Phoenix Coyotes,0,Pacific,Western,75,2,130,0.5769230769230769,75,0,73,2
2011-12,2012-03-06,Phoenix Coyotes,0,Pacific,Western,75,2,132,0.5681818181818182,75,0,73,2
2011-12,2012-03-07,Phoenix Coyotes,0,Pacific,Western,75,2,134,0.5597014925373134,77,-2,74,1
2011-12,2012-03-09,Phoenix Coyotes,1,Pacific,Western,76,2,136,0.5588235294117647,79,-3,75,1
2011-12,2012-03-11,Phoenix Coyotes,2,Pacific,Western,78,2,138,0.5652173913043478,81,-3,76,2
2011-12,2012-03-13,Phoenix Coyotes,1,Pacific,Western,79,2,140,0.5642857142857143,81,-2,78,1
2011-12,2012-03-15,Phoenix Coyotes,2,Pacific,Western,81,2,142,0.5704225352112676,83,-2,81,0
2011-12,2012-03-16,Phoenix Coyotes,0,Pacific,Western,81,2,144,0.5625,83,-2,81,0
2011-12,2012-03-19,Phoenix Coyotes,2,Pacific,Western,83,2,146,0.5684931506849316,83,0,83,0
2011-12,2012-03-21,Phoenix Coyotes,1,Pacific,Western,84,2,148,0.5675675675675675,85,-1,84,0
2011-12,2012-03-23,Phoenix Coyotes,2,Pacific,Western,86,2,150,0.5733333333333334,86,0,85,1
2011-12,2012-03-25,Phoenix Coyotes,1,Pacific,Western,87,2,152,0.5723684210526315,87,0,86,1
2011-12,2012-03-26,Phoenix Coyotes,0,Pacific,Western,87,2,154,0.564935064935065,87,0,86,1
2011-12,2012-03-30,Phoenix Coyotes,2,Pacific,Western,89,2,156,0.5705128205128205,89,0,88,1
2011-12,2012-04-01,Phoenix Coyotes,2,Pacific,Western,91,2,158,0.5759493670886076,91,0,90,1
2011-12,2012-04-04,Phoenix Coyotes,2,Pacific,Western,93,2,160,0.58125,93,0,92,1
2011-12,2012-04-06,Phoenix Coyotes,2,Pacific,Western,95,2,162,0.5864197530864198,95,0,94,1
2011-12,2012-04-08,Phoenix Coyotes,2,Pacific,Western,97,2,164,0.5914634146341463,97,0,95,2
2011-12,2011-10-07,Pittsburgh Penguins,2,Atlantic,Eastern,2,2,2,1.0,2,0,0,2
2011-12,2011-10-09,Pittsburgh Penguins,2,Atlantic,Eastern,4,2,4,1.0,4,0,2,2
2011-12,2011-10-10,Pittsburgh Penguins,1,Atlantic,Eastern,5,2,6,0.8333333333333334,5,0,2,3
2011-12,2011-10-11,Pittsburgh Penguins,2,Atlantic,Eastern,7,2,8,0.875,7,0,2,5
2011-12,2011-10-13,Pittsburgh Penguins,1,Atlantic,Eastern,8,2,10,0.8,8,0,3,5
2011-12,2011-10-15,Pittsburgh Penguins,0,Atlantic,Eastern,8,2,12,0.6666666666666666,8,0,4,4
2011-12,2011-10-18,Pittsburgh Penguins,2,Atlantic,Eastern,10,2,14,0.7142857142857143,10,0,6,4
2011-12,2011-10-18,Pittsburgh Penguins,0,Atlantic,Eastern,10,2,16,0.625,10,0,6,4
2011-12,2011-10-20,Pittsburgh Penguins,2,Atlantic,Eastern,12,2,18,0.6666666666666666,12,0,6,6
2011-12,2011-10-22,Pittsburgh Penguins,2,Atlantic,Eastern,14,2,20,0.7,14,0,8,6
2011-12,2011-10-25,Pittsburgh Penguins,2,Atlantic,Eastern,16,2,22,0.7272727272727273,16,0,9,7
2011-12,2011-10-27,Pittsburgh Penguins,2,Atlantic,Eastern,18,2,24,0.75,18,0,10,8
2011-12,2011-10-29,Pittsburgh Penguins,0,Atlantic,Eastern,18,2,26,0.6923076923076923,18,0,12,6
2011-12,2011-11-04,Pittsburgh Penguins,1,Atlantic,Eastern,19,2,28,0.6785714285714286,19,0,14,5
2011-12,2011-11-06,Pittsburgh Penguins,2,Atlantic,Eastern,21,2,30,0.7,21,0,15,6
2011-12,2011-11-12,Pittsburgh Penguins,2,Atlantic,Eastern,23,2,32,0.71875,23,0,18,5
2011-12,2011-11-13,Pittsburgh Penguins,0,Atlantic,Eastern,23,2,34,0.6764705882352942,23,0,18,5
2011-12,2011-11-16,Pittsburgh Penguins,2,Atlantic,Eastern,25,2,36,0.6944444444444444,25,0,19,6
2011-12,2011-11-18,Pittsburgh Penguins,0,Atlantic,Eastern,25,2,38,0.6578947368421053,25,0,21,4
2011-12,2011-11-20,Pittsburgh Penguins,0,Atlantic,Eastern,25,2,40,0.625,25,0,21,4
2011-12,2011-11-22,Pittsburgh Penguins,2,Atlantic,Eastern,27,2,42,0.6428571428571429,27,0,23,4
2011-12,2011-11-24,Pittsburgh Penguins,1,Atlantic,Eastern,28,2,44,0.6363636363636364,28,0,23,5
2011-12,2011-11-26,Pittsburgh Penguins,2,Atlantic,Eastern,30,2,46,0.6521739130434783,30,0,25,5
2011-12,2011-11-27,Pittsburgh Penguins,2,Atlantic,Eastern,32,2,48,0.6666666666666666,32,0,25,7
2011-12,2011-11-30,Pittsburgh Penguins,0,Atlantic,Eastern,32,2,50,0.64,32,0,26,6
2011-12,2011-12-02,Pittsburgh Penguins,2,Atlantic,Eastern,34,2,52,0.6538461538461539,34,0,26,8
2011-12,2011-12-04,Pittsburgh Penguins,2,Atlantic,Eastern,36,2,54,0.6666666666666666,36,0,27,9
2011-12,2011-12-06,Pittsburgh Penguins,0,Atlantic,Eastern,36,2,56,0.6428571428571429,36,0,29,7
2011-12,2011-12-09,Pittsburgh Penguins,0,Atlantic,Eastern,36,2,58,0.6206896551724138,37,-1,30,6
2011-12,2011-12-11,Pittsburgh Penguins,2,Atlantic,Eastern,38,2,60,0.6333333333333333,39,-1,31,7
2011-12,2011-12-14,Pittsburgh Penguins,0,Atlantic,Eastern,38,2,62,0.6129032258064516,41,-3,33,5
2011-12,2011-12-17,Pittsburgh Penguins,0,Atlantic,Eastern,38,2,64,0.59375,43,-5,35,3
2011-12,2011-12-18,Pittsburgh Penguins,2,Atlantic,Eastern,40,2,66,0.6060606060606061,43,-3,35,5
2011-12,2011-12-21,Pittsburgh Penguins,2,Atlantic,Eastern,42,2,68,0.6176470588235294,44,-2,36,6
2011-12,2011-12-24,Pittsburgh Penguins,2,Atlantic,Eastern,44,2,70,0.6285714285714286,46,-2,39,5
2011-12,2011-12-28,Pittsburgh Penguins,2,Atlantic,Eastern,46,2,72,0.6388888888888888,48,-2,39,7
2011-12,2011-12-30,Pittsburgh Penguins,0,Atlantic,Eastern,46,2,74,0.6216216216216216,48,-2,41,5
2011-12,2011-12-31,Pittsburgh Penguins,0,Atlantic,Eastern,46,2,76,0.6052631578947368,50,-4,41,5
2011-12,2012-01-07,Pittsburgh Penguins,0,Atlantic,Eastern,46,2,78,0.5897435897435898,56,-10,45,1
2011-12,2012-01-08,Pittsburgh Penguins,0,Atlantic,Eastern,46,2,80,0.575,56,-10,46,0
2011-12,2012-01-11,Pittsburgh Penguins,0,Atlantic,Eastern,46,2,82,0.5609756097560976,58,-12,46,0
2011-12,2012-01-12,Pittsburgh Penguins,0,Atlantic,Eastern,46,2,84,0.5476190476190477,58,-12,46,0
2011-12,2012-01-14,Pittsburgh Penguins,2,Atlantic,Eastern,48,2,86,0.5581395348837209,58,-10,48,0
2011-12,2012-01-15,Pittsburgh Penguins,2,Atlantic,Eastern,50,2,88,0.5681818181818182,60,-10,50,0
2011-12,2012-01-18,Pittsburgh Penguins,2,Atlantic,Eastern,52,2,90,0.5777777777777777,62,-10,50,2
2011-12,2012-01-20,Pittsburgh Penguins,2,Atlantic,Eastern,54,2,92,0.5869565217391305,62,-8,52,2
2011-12,2012-01-21,Pittsburgh Penguins,2,Atlantic,Eastern,56,2,94,0.5957446808510638,64,-8,52,4
2011-12,2012-01-22,Pittsburgh Penguins,2,Atlantic,Eastern,58,2,96,0.6041666666666666,64,-6,53,5
2011-12,2012-01-25,Pittsburgh Penguins,2,Atlantic,Eastern,60,2,98,0.6122448979591837,66,-6,55,5
2011-12,2012-02-01,Pittsburgh Penguins,2,Atlantic,Eastern,62,2,100,0.62,67,-5,56,6
2011-12,2012-02-02,Pittsburgh Penguins,0,Atlantic,Eastern,62,2,102,0.6078431372549019,69,-7,57,5
2011-12,2012-02-04,Pittsburgh Penguins,2,Atlantic,Eastern,64,2,104,0.6153846153846154,69,-5,58,6
2011-12,2012-02-05,Pittsburgh Penguins,0,Atlantic,Eastern,64,2,106,0.6037735849056604,71,-7,59,5
2011-12,2012-02-08,Pittsburgh Penguins,1,Atlantic,Eastern,65,2,108,0.6018518518518519,71,-6,60,5
2011-12,2012-02-11,Pittsburgh Penguins,2,Atlantic,Eastern,67,2,110,0.6090909090909091,75,-8,62,5
2011-12,2012-02-13,Pittsburgh Penguins,2,Atlantic,Eastern,69,2,112,0.6160714285714286,77,-8,62,7
2011-12,2012-02-16,Pittsburgh Penguins,0,Atlantic,Eastern,69,2,114,0.6052631578947368,79,-10,64,5
2011-12,2012-02-18,Pittsburgh Penguins,2,Atlantic,Eastern,71,2,116,0.6120689655172413,79,-8,64,7
2011-12,2012-02-19,Pittsburgh Penguins,0,Atlantic,Eastern,71,2,118,0.6016949152542372,79,-8,64,7
2011-12,2012-02-22,Pittsburgh Penguins,2,Atlantic,Eastern,73,2,120,0.6083333333333333,81,-8,65,8
2011-12,2012-02-25,Pittsburgh Penguins,2,Atlantic,Eastern,75,2,122,0.6147540983606558,82,-7,66,9
2011-12,2012-02-26,Pittsburgh Penguins,2,Atlantic,Eastern,77,2,124,0.6209677419354839,84,-7,68,9
2011-12,2012-03-01,Pittsburgh Penguins,2,Atlantic,Eastern,79,2,126,0.626984126984127,86,-7,69,10
2011-12,2012-03-04,Pittsburgh Penguins,2,Atlantic,Eastern,81,2,128,0.6328125,91,-10,70,11
2011-12,2012-03-06,Pittsburgh Penguins,2,Atlantic,Eastern,83,2,130,0.6384615384615384,91,-8,72,11
2011-12,2012-03-08,Pittsburgh Penguins,2,Atlantic,Eastern,85,2,132,0.6439393939393939,91,-6,72,13
2011-12,2012-03-10,Pittsburgh Penguins,2,Atlantic,Eastern,87,2,134,0.6492537313432836,91,-4,74,13
2011-12,2012-03-11,Pittsburgh Penguins,2,Atlantic,Eastern,89,2,136,0.6544117647058824,93,-4,76,13
2011-12,2012-03-15,Pittsburgh Penguins,2,Atlantic,Eastern,91,2,138,0.6594202898550725,95,-4,78,13
2011-12,2012-03-17,Pittsburgh Penguins,2,Atlantic,Eastern,93,2,140,0.6642857142857143,95,-2,78,15
2011-12,2012-03-18,Pittsburgh Penguins,1,Atlantic,Eastern,94,2,142,0.6619718309859155,95,-1,78,16
2011-12,2012-03-20,Pittsburgh Penguins,2,Atlantic,Eastern,96,2,144,0.6666666666666666,97,-1,80,16
2011-12,2012-03-22,Pittsburgh Penguins,2,Atlantic,Eastern,98,2,146,0.6712328767123288,99,-1,81,17
2011-12,2012-03-24,Pittsburgh Penguins,0,Atlantic,Eastern,98,2,148,0.6621621621621622,101,-3,84,14
2011-12,2012-03-25,Pittsburgh Penguins,2,Atlantic,Eastern,100,2,150,0.6666666666666666,101,-1,84,16
2011-12,2012-03-27,Pittsburgh Penguins,0,Atlantic,Eastern,100,2,152,0.6578947368421053,101,-1,86,14
2011-12,2012-03-29,Pittsburgh Penguins,0,Atlantic,Eastern,100,2,154,0.6493506493506493,103,-3,86,14
2011-12,2012-03-30,Pittsburgh Penguins,2,Atlantic,Eastern,102,2,156,0.6538461538461539,107,-5,86,16
2011-12,2012-04-01,Pittsburgh Penguins,0,Atlantic,Eastern,102,2,158,0.6455696202531646,107,-5,88,14
2011-12,2012-04-03,Pittsburgh Penguins,2,Atlantic,Eastern,104,2,160,0.65,109,-5,88,16
2011-12,2012-04-05,Pittsburgh Penguins,2,Atlantic,Eastern,106,2,162,0.654320987654321,109,-3,90,16
2011-12,2012-04-07,Pittsburgh Penguins,2,Atlantic,Eastern,108,2,164,0.6585365853658537,109,-1,92,16
2011-12,2011-10-09,San Jose Sharks,2,Pacific,Western,2,2,2,1.0,2,0,2,0
2011-12,2011-10-15,San Jose Sharks,0,Pacific,Western,2,2,4,0.5,6,-4,4,-2
2011-12,2011-10-16,San Jose Sharks,0,Pacific,Western,2,2,6,0.3333333333333333,8,-6,5,-3
2011-12,2011-10-18,San Jose Sharks,0,Pacific,Western,2,2,8,0.25,10,-8,5,-3
2011-12,2011-10-21,San Jose Sharks,2,Pacific,Western,4,2,10,0.4,10,-6,7,-3
2011-12,2011-10-22,San Jose Sharks,2,Pacific,Western,6,2,12,0.5,12,-6,8,-2
2011-12,2011-10-26,San Jose Sharks,2,Pacific,Western,8,2,14,0.5714285714285714,14,-6,9,-1
2011-12,2011-10-28,San Jose Sharks,2,Pacific,Western,10,2,16,0.625,14,-4,10,0
2011-12,2011-10-29,San Jose Sharks,2,Pacific,Western,12,2,18,0.6666666666666666,14,-2,10,2
2011-12,2011-10-31,San Jose Sharks,0,Pacific,Western,12,2,20,0.6,16,-4,11,1
2011-12,2011-11-04,San Jose Sharks,2,Pacific,Western,14,2,22,0.6363636363636364,16,-2,14,0
2011-12,2011-11-06,San Jose Sharks,1,Pacific,Western,15,2,24,0.625,20,-5,15,0
2011-12,2011-11-08,San Jose Sharks,2,Pacific,Western,17,2,26,0.6538461538461539,20,-3,15,2
2011-12,2011-11-11,San Jose Sharks,2,Pacific,Western,19,2,28,0.6785714285714286,22,-3,17,2
2011-12,2011-11-13,San Jose Sharks,0,Pacific,Western,19,2,30,0.6333333333333333,22,-3,19,0
2011-12,2011-11-18,San Jose Sharks,2,Pacific,Western,21,2,32,0.65625,23,-2,21,0
2011-12,2011-11-20,San Jose Sharks,2,Pacific,Western,23,2,34,0.6764705882352942,23,0,22,1
2011-12,2011-11-21,San Jose Sharks,2,Pacific,Western,25,2,36,0.6944444444444444,25,0,22,3
2011-12,2011-11-24,San Jose Sharks,2,Pacific,Western,27,2,38,0.7105263157894737,27,0,24,3
2011-12,2011-11-27,San Jose Sharks,0,Pacific,Western,27,2,40,0.675,27,0,27,0
2011-12,2011-11-29,San Jose Sharks,0,Pacific,Western,27,2,42,0.6428571428571429,29,-2,27,0
2011-12,2011-12-02,San Jose Sharks,2,Pacific,Western,29,2,44,0.6590909090909091,31,-2,29,0
2011-12,2011-12-04,San Jose Sharks,0,Pacific,Western,29,2,46,0.6304347826086957,31,-2,29,0
2011-12,2011-12-07,San Jose Sharks,0,Pacific,Western,29,2,48,0.6041666666666666,33,-4,30,-1
2011-12,2011-12-09,San Jose Sharks,2,Pacific,Western,31,2,50,0.62,33,-2,31,0
2011-12,2011-12-11,San Jose Sharks,0,Pacific,Western,31,2,52,0.5961538461538461,33,-2,32,-1
2011-12,2011-12-12,San Jose Sharks,1,Pacific,Western,32,2,54,0.5925925925925926,33,-1,32,0
2011-12,2011-12-14,San Jose Sharks,1,Pacific,Western,33,2,56,0.5892857142857143,35,-2,33,0
2011-12,2011-12-16,San Jose Sharks,2,Pacific,Western,35,2,58,0.603448275862069,37,-2,35,0
2011-12,2011-12-18,San Jose Sharks,2,Pacific,Western,37,2,60,0.6166666666666667,37,0,37,0
2011-12,2011-12-22,San Jose Sharks,2,Pacific,Western,39,2,62,0.6290322580645161,39,0,39,0
2011-12,2011-12-24,San Jose Sharks,2,Pacific,Western,41,2,64,0.640625,41,0,40,1
2011-12,2011-12-27,San Jose Sharks,0,Pacific,Western,41,2,66,0.6212121212121212,41,0,40,1
2011-12,2011-12-29,San Jose Sharks,1,Pacific,Western,42,2,68,0.6176470588235294,42,0,41,1
2011-12,2012-01-03,San Jose Sharks,2,Pacific,Western,44,2,70,0.6285714285714286,45,-1,45,-1
2011-12,2012-01-05,San Jose Sharks,2,Pacific,Western,46,2,72,0.6388888888888888,46,0,45,1
2011-12,2012-01-06,San Jose Sharks,2,Pacific,Western,48,2,74,0.6486486486486487,48,0,46,2
2011-12,2012-01-08,San Jose Sharks,2,Pacific,Western,50,2,76,0.6578947368421053,50,0,47,3
2011-12,2012-01-11,San Jose Sharks,1,Pacific,Western,51,2,78,0.6538461538461539,51,0,49,2
2011-12,2012-01-13,San Jose Sharks,2,Pacific,Western,53,2,80,0.6625,53,0,50,3
2011-12,2012-01-15,San Jose Sharks,2,Pacific,Western,55,2,82,0.6707317073170732,55,0,51,4
2011-12,2012-01-16,San Jose Sharks,0,Pacific,Western,55,2,84,0.6547619047619048,55,0,51,4
2011-12,2012-01-18,San Jose Sharks,2,Pacific,Western,57,2,86,0.6627906976744186,57,0,51,6
2011-12,2012-01-20,San Jose Sharks,0,Pacific,Western,57,2,88,0.6477272727272727,57,0,52,5
2011-12,2012-01-21,San Jose Sharks,0,Pacific,Western,57,2,90,0.6333333333333333,57,0,52,5
2011-12,2012-01-24,San Jose Sharks,1,Pacific,Western,58,2,92,0.6304347826086957,58,0,54,4
2011-12,2012-01-25,San Jose Sharks,2,Pacific,Western,60,2,94,0.6382978723404256,60,0,55,5
2011-12,2012-02-01,San Jose Sharks,2,Pacific,Western,62,2,96,0.6458333333333334,62,0,55,7
2011-12,2012-02-03,San Jose Sharks,2,Pacific,Western,64,2,98,0.6530612244897959,64,0,57,7
2011-12,2012-02-05,San Jose Sharks,0,Pacific,Western,64,2,100,0.64,64,0,58,6
2011-12,2012-02-09,San Jose Sharks,0,Pacific,Western,64,2,102,0.6274509803921569,64,0,58,6
2011-12,2012-02-11,San Jose Sharks,2,Pacific,Western,66,2,104,0.6346153846153846,66,0,60,6
2011-12,2012-02-13,San Jose Sharks,0,Pacific,Western,66,2,106,0.6226415094339622,66,0,62,4
2011-12,2012-02-14,San Jose Sharks,2,Pacific,Western,68,2,108,0.6296296296296297,68,0,63,5
2011-12,2012-02-17,San Jose Sharks,1,Pacific,Western,69,2,110,0.6272727272727273,69,0,65,4
2011-12,2012-02-18,San Jose Sharks,0,Pacific,Western,69,2,112,0.6160714285714286,69,0,65,4
2011-12,2012-02-19,San Jose Sharks,0,Pacific,Western,69,2,114,0.6052631578947368,69,0,65,4
2011-12,2012-02-22,San Jose Sharks,0,Pacific,Western,69,2,116,0.5948275862068966,69,0,66,3
2011-12,2012-02-24,San Jose Sharks,2,Pacific,Western,71,2,118,0.6016949152542372,71,0,66,5
2011-12,2012-02-26,San Jose Sharks,0,Pacific,Western,71,2,120,0.5916666666666667,73,-2,70,1
2011-12,2012-02-26,San Jose Sharks,0,Pacific,Western,71,2,122,0.5819672131147541,73,-2,70,1
2011-12,2012-02-29,San Jose Sharks,2,Pacific,Western,73,2,124,0.5887096774193549,75,-2,70,3
2011-12,2012-03-02,San Jose Sharks,0,Pacific,Western,73,2,126,0.5793650793650794,75,-2,71,2
2011-12,2012-03-04,San Jose Sharks,0,Pacific,Western,73,2,128,0.5703125,75,-2,73,0
2011-12,2012-03-07,San Jose Sharks,1,Pacific,Western,74,2,130,0.5692307692307692,77,-3,74,0
2011-12,2012-03-09,San Jose Sharks,1,Pacific,Western,75,2,132,0.5681818181818182,79,-4,75,0
2011-12,2012-03-11,San Jose Sharks,0,Pacific,Western,75,2,134,0.5597014925373134,81,-6,76,-1
2011-12,2012-03-13,San Jose Sharks,2,Pacific,Western,77,2,136,0.5661764705882353,81,-4,78,-1
2011-12,2012-03-14,San Jose Sharks,1,Pacific,Western,78,2,138,0.5652173913043478,83,-5,79,-1
2011-12,2012-03-16,San Jose Sharks,2,Pacific,Western,80,2,140,0.5714285714285714,83,-3,81,-1
2011-12,2012-03-18,San Jose Sharks,2,Pacific,Western,82,2,142,0.5774647887323944,83,-1,82,0
2011-12,2012-03-20,San Jose Sharks,0,Pacific,Western,82,2,144,0.5694444444444444,83,-1,83,-1
2011-12,2012-03-21,San Jose Sharks,0,Pacific,Western,82,2,146,0.5616438356164384,85,-3,84,-2
2011-12,2012-03-23,San Jose Sharks,2,Pacific,Western,84,2,148,0.5675675675675675,86,-2,85,-1
2011-12,2012-03-25,San Jose Sharks,2,Pacific,Western,86,2,150,0.5733333333333334,87,-1,86,0
2011-12,2012-03-27,San Jose Sharks,2,Pacific,Western,88,2,152,0.5789473684210527,88,0,87,1
2011-12,2012-03-29,San Jose Sharks,0,Pacific,Western,88,2,154,0.5714285714285714,89,-1,88,0
2011-12,2012-03-30,San Jose Sharks,0,Pacific,Western,88,2,156,0.5641025641025641,89,-1,88,0
2011-12,2012-04-01,San Jose Sharks,2,Pacific,Western,90,2,158,0.569620253164557,91,-1,90,0
2011-12,2012-04-04,San Jose Sharks,2,Pacific,Western,92,2,160,0.575,93,-1,92,0
2011-12,2012-04-06,San Jose Sharks,2,Pacific,Western,94,2,162,0.5802469135802469,95,-1,94,0
2011-12,2012-04-08,San Jose Sharks,2,Pacific,Western,96,2,164,0.5853658536585366,97,-1,95,1
2011-12,2011-10-09,St. Louis Blues,0,Central,Western,0,2,2,0.0,4,-4,2,-2
2011-12,2011-10-10,St. Louis Blues,2,Central,Western,2,2,4,0.5,4,-2,2,0
2011-12,2011-10-14,St. Louis Blues,0,Central,Western,2,2,6,0.3333333333333333,6,-4,3,-1
2011-12,2011-10-16,St. Louis Blues,2,Central,Western,4,2,8,0.5,8,-4,5,-1
2011-12,2011-10-17,St. Louis Blues,0,Central,Western,4,2,10,0.4,8,-4,5,-1
2011-12,2011-10-19,St. Louis Blues,0,Central,Western,4,2,12,0.3333333333333333,8,-4,5,-1
2011-12,2011-10-22,St. Louis Blues,2,Central,Western,6,2,14,0.42857142857142855,10,-4,8,-2
2011-12,2011-10-22,St. Louis Blues,2,Central,Western,8,2,16,0.5,10,-2,8,0
2011-12,2011-10-27,St. Louis Blues,2,Central,Western,10,2,18,0.5555555555555556,12,-2,9,1
2011-12,2011-10-29,St. Louis Blues,0,Central,Western,10,2,20,0.5,12,-2,10,0
2011-12,2011-10-31,St. Louis Blues,0,Central,Western,10,2,22,0.45454545454545453,14,-4,11,-1
2011-12,2011-11-05,St. Louis Blues,2,Central,Western,12,2,24,0.5,19,-7,14,-2
2011-12,2011-11-06,St. Louis Blues,0,Central,Western,12,2,26,0.46153846153846156,19,-7,15,-3
2011-12,2011-11-09,St. Louis Blues,2,Central,Western,14,2,28,0.5,19,-5,16,-2
2011-12,2011-11-11,St. Louis Blues,1,Central,Western,15,2,30,0.5,21,-6,17,-2
2011-12,2011-11-13,St. Louis Blues,2,Central,Western,17,2,32,0.53125,23,-6,19,-2
2011-12,2011-11-16,St. Louis Blues,2,Central,Western,19,2,34,0.5588235294117647,25,-6,19,0
2011-12,2011-11-18,St. Louis Blues,2,Central,Western,21,2,36,0.5833333333333334,27,-6,21,0
2011-12,2011-11-20,St. Louis Blues,1,Central,Western,22,2,38,0.5789473684210527,27,-5,22,0
2011-12,2011-11-23,St. Louis Blues,0,Central,Western,22,2,40,0.55,27,-5,23,-1
2011-12,2011-11-24,St. Louis Blues,2,Central,Western,24,2,42,0.5714285714285714,27,-3,24,0
2011-12,2011-11-26,St. Louis Blues,2,Central,Western,26,2,44,0.5909090909090909,29,-3,26,0
2011-12,2011-11-27,St. Louis Blues,2,Central,Western,28,2,46,0.6086956521739131,31,-3,27,1
2011-12,2011-11-30,St. Louis Blues,2,Central,Western,30,2,48,0.625,31,-1,28,2
2011-12,2011-12-03,St. Louis Blues,1,Central,Western,31,2,50,0.62,33,-2,29,2
2011-12,2011-12-04,St. Louis Blues,0,Central,Western,31,2,52,0.5961538461538461,35,-4,29,2
2011-12,2011-12-07,St. Louis Blues,2,Central,Western,33,2,54,0.6111111111111112,36,-3,30,3
2011-12,2011-12-09,St. Louis Blues,2,Central,Western,35,2,56,0.625,38,-3,31,4
2011-12,2011-12-11,St. Louis Blues,2,Central,Western,37,2,58,0.6379310344827587,38,-1,32,5
2011-12,2011-12-16,St. Louis Blues,2,Central,Western,39,2,60,0.65,42,-3,35,4
2011-12,2011-12-18,St. Louis Blues,1,Central,Western,40,2,62,0.6451612903225806,44,-4,37,3
2011-12,2011-12-19,St. Louis Blues,2,Central,Western,42,2,64,0.65625,46,-4,37,5
2011-12,2011-12-22,St. Louis Blues,0,Central,Western,42,2,66,0.6363636363636364,48,-6,39,3
2011-12,2011-12-24,St. Louis Blues,2,Central,Western,44,2,68,0.6470588235294118,48,-4,40,4
2011-12,2011-12-27,St. Louis Blues,2,Central,Western,46,2,70,0.6571428571428571,50,-4,40,6
2011-12,2011-12-28,St. Louis Blues,0,Central,Western,46,2,72,0.6388888888888888,50,-4,40,6
2011-12,2011-12-31,St. Louis Blues,1,Central,Western,47,2,74,0.6351351351351351,52,-5,42,5
2011-12,2012-01-01,St. Louis Blues,0,Central,Western,47,2,76,0.618421052631579,52,-5,43,4
2011-12,2012-01-04,St. Louis Blues,2,Central,Western,49,2,78,0.6282051282051282,52,-3,45,4
2011-12,2012-01-06,St. Louis Blues,2,Central,Western,51,2,80,0.6375,52,-1,46,5
2011-12,2012-01-08,St. Louis Blues,2,Central,Western,53,2,82,0.6463414634146342,53,0,47,6
2011-12,2012-01-11,St. Louis Blues,2,Central,Western,55,2,84,0.6547619047619048,55,0,49,6
2011-12,2012-01-13,St. Louis Blues,1,Central,Western,56,2,86,0.6511627906976745,57,-1,50,6
2011-12,2012-01-15,St. Louis Blues,2,Central,Western,58,2,88,0.6590909090909091,58,0,51,7
2011-12,2012-01-17,St. Louis Blues,2,Central,Western,60,2,90,0.6666666666666666,60,0,51,9
2011-12,2012-01-20,St. Louis Blues,2,Central,Western,62,2,92,0.6739130434782609,63,-1,52,10
2011-12,2012-01-22,St. Louis Blues,2,Central,Western,64,2,94,0.6808510638297872,65,-1,54,10
2011-12,2012-01-24,St. Louis Blues,0,Central,Western,64,2,96,0.6666666666666666,67,-3,54,10
2011-12,2012-01-25,St. Louis Blues,1,Central,Western,65,2,98,0.6632653061224489,67,-2,55,10
2011-12,2012-02-04,St. Louis Blues,2,Central,Western,67,2,100,0.67,71,-4,57,10
2011-12,2012-02-05,St. Louis Blues,0,Central,Western,67,2,102,0.6568627450980392,72,-5,58,9
2011-12,2012-02-08,St. Louis Blues,2,Central,Western,69,2,104,0.6634615384615384,72,-3,58,11
2011-12,2012-02-10,St. Louis Blues,2,Central,Western,71,2,106,0.6698113207547169,74,-3,60,11
2011-12,2012-02-12,St. Louis Blues,2,Central,Western,73,2,108,0.6759259259259259,76,-3,62,11
2011-12,2012-02-13,St. Louis Blues,2,Central,Western,75,2,110,0.6818181818181818,78,-3,62,13
2011-12,2012-02-15,St. Louis Blues,0,Central,Western,75,2,112,0.6696428571428571,80,-5,63,12
2011-12,2012-02-17,St. Louis Blues,2,Central,Western,77,2,114,0.6754385964912281,80,-3,65,12
2011-12,2012-02-18,St. Louis Blues,2,Central,Western,79,2,116,0.6810344827586207,82,-3,65,14
2011-12,2012-02-19,St. Louis Blues,0,Central,Western,79,2,118,0.6694915254237288,84,-5,65,14
2011-12,2012-02-23,St. Louis Blues,0,Central,Western,79,2,120,0.6583333333333333,84,-5,66,13
2011-12,2012-02-24,St. Louis Blues,2,Central,Western,81,2,122,0.6639344262295082,85,-4,66,15
2011-12,2012-02-25,St. Louis Blues,2,Central,Western,83,2,124,0.6693548387096774,85,-2,68,15
2011-12,2012-02-28,St. Louis Blues,2,Central,Western,85,2,126,0.6746031746031746,85,0,70,15
2011-12,2012-03-01,St. Louis Blues,2,Central,Western,87,2,128,0.6796875,87,0,71,16
2011-12,2012-03-02,St. Louis Blues,0,Central,Western,87,2,130,0.6692307692307692,87,0,71,16
2011-12,2012-03-04,St. Louis Blues,2,Central,Western,89,2,132,0.6742424242424242,89,0,73,16
2011-12,2012-03-07,St. Louis Blues,2,Central,Western,91,2,134,0.6791044776119403,91,0,74,17
2011-12,2012-03-09,St. Louis Blues,2,Central,Western,93,2,136,0.6838235294117647,93,0,75,18
2011-12,2012-03-11,St. Louis Blues,2,Central,Western,95,2,138,0.6884057971014492,97,-2,76,19
2011-12,2012-03-11,St. Louis Blues,2,Central,Western,97,2,140,0.6928571428571428,97,0,76,21
2011-12,2012-03-14,St. Louis Blues,1,Central,Western,98,2,142,0.6901408450704225,98,0,79,19
2011-12,2012-03-15,St. Louis Blues,0,Central,Western,98,2,144,0.6805555555555556,98,0,81,17
2011-12,2012-03-17,St. Louis Blues,2,Central,Western,100,2,146,0.684931506849315,100,0,81,19
2011-12,2012-03-22,St. Louis Blues,0,Central,Western,100,2,148,0.6756756756756757,100,0,84,16
2011-12,2012-03-23,St. Louis Blues,1,Central,Western,101,2,150,0.6733333333333333,101,0,85,16
2011-12,2012-03-26,St. Louis Blues,2,Central,Western,103,2,152,0.6776315789473685,103,0,86,17
2011-12,2012-03-28,St. Louis Blues,2,Central,Western,105,2,154,0.6818181818181818,105,0,87,18
2011-12,2012-03-30,St. Louis Blues,1,Central,Western,106,2,156,0.6794871794871795,106,0,88,18
2011-12,2012-04-01,St. Louis Blues,0,Central,Western,106,2,158,0.6708860759493671,106,0,90,16
2011-12,2012-04-04,St. Louis Blues,1,Central,Western,107,2,160,0.66875,107,0,92,15
2011-12,2012-04-06,St. Louis Blues,0,Central,Western,107,2,162,0.6604938271604939,107,0,94,13
2011-12,2012-04-08,St. Louis Blues,2,Central,Western,109,2,164,0.6646341463414634,109,0,95,14
2011-12,2011-10-07,Tampa Bay Lightning,2,Southeast,Eastern,2,2,2,1.0,2,0,0,2
2011-12,2011-10-08,Tampa Bay Lightning,0,Southeast,Eastern,2,2,4,0.5,2,0,1,1
2011-12,2011-10-10,Tampa Bay Lightning,1,Southeast,Eastern,3,2,6,0.5,4,-1,2,1
2011-12,2011-10-13,Tampa Bay Lightning,0,Southeast,Eastern,3,2,8,0.375,6,-3,3,0
2011-12,2011-10-15,Tampa Bay Lightning,1,Southeast,Eastern,4,2,10,0.4,8,-4,4,0
2011-12,2011-10-17,Tampa Bay Lightning,0,Southeast,Eastern,4,2,12,0.3333333333333333,8,-4,6,-2
2011-12,2011-10-20,Tampa Bay Lightning,2,Southeast,Eastern,6,2,14,0.42857142857142855,12,-6,6,0
2011-12,2011-10-22,Tampa Bay Lightning,2,Southeast,Eastern,8,2,16,0.5,14,-6,8,0
2011-12,2011-10-25,Tampa Bay Lightning,2,Southeast,Eastern,10,2,18,0.5555555555555556,14,-4,9,1
2011-12,2011-10-28,Tampa Bay Lightning,0,Southeast,Eastern,10,2,20,0.5,14,-4,10,0
2011-12,2011-10-29,Tampa Bay Lightning,2,Southeast,Eastern,12,2,22,0.5454545454545454,14,-2,12,0
2011-12,2011-11-01,Tampa Bay Lightning,0,Southeast,Eastern,12,2,24,0.5,16,-4,12,0
2011-12,2011-11-04,Tampa Bay Lightning,2,Southeast,Eastern,14,2,26,0.5384615384615384,18,-4,14,0
2011-12,2011-11-06,Tampa Bay Lightning,2,Southeast,Eastern,16,2,28,0.5714285714285714,18,-2,15,1
2011-12,2011-11-10,Tampa Bay Lightning,2,Southeast,Eastern,18,2,30,0.6,18,0,17,1
2011-12,2011-11-13,Tampa Bay Lightning,0,Southeast,Eastern,18,2,32,0.5625,21,-3,18,0
2011-12,2011-11-15,Tampa Bay Lightning,0,Southeast,Eastern,18,2,34,0.5294117647058824,21,-3,18,0
2011-12,2011-11-18,Tampa Bay Lightning,2,Southeast,Eastern,20,2,36,0.5555555555555556,21,-1,21,-1
2011-12,2011-11-20,Tampa Bay Lightning,0,Southeast,Eastern,20,2,38,0.5263157894736842,23,-3,21,-1
2011-12,2011-11-23,Tampa Bay Lightning,0,Southeast,Eastern,20,2,40,0.5,25,-5,23,-3
2011-12,2011-11-26,Tampa Bay Lightning,2,Southeast,Eastern,22,2,42,0.5238095238095238,28,-6,25,-3
2011-12,2011-11-27,Tampa Bay Lightning,2,Southeast,Eastern,24,2,44,0.5454545454545454,28,-4,25,-1
2011-12,2011-11-29,Tampa Bay Lightning,0,Southeast,Eastern,24,2,46,0.5217391304347826,28,-4,25,-1
2011-12,2011-12-01,Tampa Bay Lightning,0,Southeast,Eastern,24,2,48,0.5,30,-6,26,-2
2011-12,2011-12-04,Tampa Bay Lightning,0,Southeast,Eastern,24,2,50,0.48,32,-8,27,-3
2011-12,2011-12-06,Tampa Bay Lightning,0,Southeast,Eastern,24,2,52,0.46153846153846156,34,-10,29,-5
2011-12,2011-12-07,Tampa Bay Lightning,0,Southeast,Eastern,24,2,54,0.4444444444444444,34,-10,29,-5
2011-12,2011-12-09,Tampa Bay Lightning,2,Southeast,Eastern,26,2,56,0.4642857142857143,36,-10,30,-4
2011-12,2011-12-11,Tampa Bay Lightning,0,Southeast,Eastern,26,2,58,0.4482758620689655,37,-11,31,-5
2011-12,2011-12-13,Tampa Bay Lightning,0,Southeast,Eastern,26,2,60,0.43333333333333335,37,-11,31,-5
2011-12,2011-12-16,Tampa Bay Lightning,2,Southeast,Eastern,28,2,62,0.45161290322580644,38,-10,33,-5
2011-12,2011-12-18,Tampa Bay Lightning,2,Southeast,Eastern,30,2,64,0.46875,42,-12,35,-5
2011-12,2011-12-22,Tampa Bay Lightning,0,Southeast,Eastern,30,2,66,0.45454545454545453,42,-12,36,-6
2011-12,2011-12-24,Tampa Bay Lightning,1,Southeast,Eastern,31,2,68,0.45588235294117646,43,-12,39,-8
2011-12,2011-12-28,Tampa Bay Lightning,2,Southeast,Eastern,33,2,70,0.4714285714285714,45,-12,39,-6
2011-12,2011-12-30,Tampa Bay Lightning,2,Southeast,Eastern,35,2,72,0.4861111111111111,45,-10,41,-6
2011-12,2011-12-31,Tampa Bay Lightning,2,Southeast,Eastern,37,2,74,0.5,45,-8,41,-4
2011-12,2012-01-04,Tampa Bay Lightning,0,Southeast,Eastern,37,2,76,0.4868421052631579,47,-10,44,-7
2011-12,2012-01-06,Tampa Bay Lightning,0,Southeast,Eastern,37,2,78,0.47435897435897434,48,-11,44,-7
2011-12,2012-01-08,Tampa Bay Lightning,0,Southeast,Eastern,37,2,80,0.4625,48,-11,46,-9
2011-12,2012-01-11,Tampa Bay Lightning,1,Southeast,Eastern,38,2,82,0.4634146341463415,50,-12,46,-8
2011-12,2012-01-13,Tampa Bay Lightning,0,Southeast,Eastern,38,2,84,0.4523809523809524,50,-12,46,-8
2011-12,2012-01-14,Tampa Bay Lightning,0,Southeast,Eastern,38,2,86,0.4418604651162791,50,-12,48,-10
2011-12,2012-01-15,Tampa Bay Lightning,0,Southeast,Eastern,38,2,88,0.4318181818181818,50,-12,50,-12
2011-12,2012-01-18,Tampa Bay Lightning,2,Southeast,Eastern,40,2,90,0.4444444444444444,51,-11,50,-10
2011-12,2012-01-21,Tampa Bay Lightning,2,Southeast,Eastern,42,2,92,0.45652173913043476,52,-10,52,-10
2011-12,2012-01-22,Tampa Bay Lightning,2,Southeast,Eastern,44,2,94,0.46808510638297873,54,-10,53,-9
2011-12,2012-01-25,Tampa Bay Lightning,2,Southeast,Eastern,46,2,96,0.4791666666666667,55,-9,55,-9
2011-12,2012-02-01,Tampa Bay Lightning,2,Southeast,Eastern,48,2,98,0.4897959183673469,56,-8,56,-8
2011-12,2012-02-03,Tampa Bay Lightning,1,Southeast,Eastern,49,2,100,0.49,57,-8,57,-8
2011-12,2012-02-05,Tampa Bay Lightning,2,Southeast,Eastern,51,2,102,0.5,59,-8,59,-8
2011-12,2012-02-08,Tampa Bay Lightning,0,Southeast,Eastern,51,2,104,0.49038461538461536,60,-9,60,-9
2011-12,2012-02-10,Tampa Bay Lightning,1,Southeast,Eastern,52,2,106,0.49056603773584906,61,-9,61,-9
2011-12,2012-02-12,Tampa Bay Lightning,2,Southeast,Eastern,54,2,108,0.5,65,-11,62,-8
2011-12,2012-02-13,Tampa Bay Lightning,0,Southeast,Eastern,54,2,110,0.4909090909090909,65,-11,62,-8
2011-12,2012-02-15,Tampa Bay Lightning,0,Southeast,Eastern,54,2,112,0.48214285714285715,65,-11,62,-8
2011-12,2012-02-17,Tampa Bay Lightning,2,Southeast,Eastern,56,2,114,0.49122807017543857,65,-9,64,-8
2011-12,2012-02-19,Tampa Bay Lightning,2,Southeast,Eastern,58,2,116,0.5,65,-7,64,-6
2011-12,2012-02-22,Tampa Bay Lightning,2,Southeast,Eastern,60,2,118,0.5084745762711864,65,-5,65,-5
2011-12,2012-02-24,Tampa Bay Lightning,0,Southeast,Eastern,60,2,120,0.5,67,-7,66,-6
2011-12,2012-02-25,Tampa Bay Lightning,0,Southeast,Eastern,60,2,122,0.4918032786885246,68,-8,66,-6
2011-12,2012-02-26,Tampa Bay Lightning,2,Southeast,Eastern,62,2,124,0.5,70,-8,68,-6
2011-12,2012-02-29,Tampa Bay Lightning,2,Southeast,Eastern,64,2,126,0.5079365079365079,72,-8,69,-5
2011-12,2012-03-03,Tampa Bay Lightning,2,Southeast,Eastern,66,2,128,0.515625,72,-6,70,-4
2011-12,2012-03-04,Tampa Bay Lightning,2,Southeast,Eastern,68,2,130,0.5230769230769231,74,-6,70,-2
2011-12,2012-03-07,Tampa Bay Lightning,0,Southeast,Eastern,68,2,132,0.5151515151515151,74,-6,72,-4
2011-12,2012-03-09,Tampa Bay Lightning,1,Southeast,Eastern,69,2,134,0.5149253731343284,74,-5,72,-3
2011-12,2012-03-11,Tampa Bay Lightning,0,Southeast,Eastern,69,2,136,0.5073529411764706,77,-8,76,-7
2011-12,2012-03-13,Tampa Bay Lightning,2,Southeast,Eastern,71,2,138,0.5144927536231884,79,-8,78,-7
2011-12,2012-03-15,Tampa Bay Lightning,0,Southeast,Eastern,71,2,140,0.5071428571428571,81,-10,78,-7
2011-12,2012-03-17,Tampa Bay Lightning,0,Southeast,Eastern,71,2,142,0.5,83,-12,78,-7
2011-12,2012-03-19,Tampa Bay Lightning,0,Southeast,Eastern,71,2,144,0.4930555555555556,83,-12,80,-9
2011-12,2012-03-22,Tampa Bay Lightning,2,Southeast,Eastern,73,2,146,0.5,85,-12,81,-8
2011-12,2012-03-24,Tampa Bay Lightning,2,Southeast,Eastern,75,2,148,0.5067567567567568,86,-11,84,-9
2011-12,2012-03-26,Tampa Bay Lightning,2,Southeast,Eastern,77,2,150,0.5133333333333333,87,-10,84,-7
2011-12,2012-03-27,Tampa Bay Lightning,0,Southeast,Eastern,77,2,152,0.506578947368421,89,-12,86,-9
2011-12,2012-03-29,Tampa Bay Lightning,0,Southeast,Eastern,77,2,154,0.5,89,-12,86,-9
2011-12,2012-03-31,Tampa Bay Lightning,2,Southeast,Eastern,79,2,156,0.5064102564102564,90,-11,88,-9
2011-12,2012-04-02,Tampa Bay Lightning,2,Southeast,Eastern,81,2,158,0.5126582278481012,91,-10,88,-7
2011-12,2012-04-04,Tampa Bay Lightning,0,Southeast,Eastern,81,2,160,0.50625,92,-11,88,-7
2011-12,2012-04-05,Tampa Bay Lightning,1,Southeast,Eastern,82,2,162,0.5061728395061729,92,-10,90,-8
2011-12,2012-04-07,Tampa Bay Lightning,2,Southeast,Eastern,84,2,164,0.5121951219512195,94,-10,92,-8
2011-12,2011-10-06,Toronto Maple Leafs,2,Northeast,Eastern,2,2,2,1.0,2,0,0,2
2011-12,2011-10-08,Toronto Maple Leafs,2,Northeast,Eastern,4,2,4,1.0,4,0,1,3
2011-12,2011-10-15,Toronto Maple Leafs,2,Northeast,Eastern,6,2,6,1.0,6,0,4,2
2011-12,2011-10-17,Toronto Maple Leafs,1,Northeast,Eastern,7,2,8,0.875,7,0,6,1
2011-12,2011-10-19,Toronto Maple Leafs,2,Northeast,Eastern,9,2,10,0.9,9,0,6,3
2011-12,2011-10-20,Toronto Maple Leafs,0,Northeast,Eastern,9,2,12,0.75,10,-1,6,3
2011-12,2011-10-22,Toronto Maple Leafs,2,Northeast,Eastern,11,2,14,0.7857142857142857,11,0,8,3
2011-12,2011-10-24,Toronto Maple Leafs,0,Northeast,Eastern,11,2,16,0.6875,11,0,8,3
2011-12,2011-10-27,Toronto Maple Leafs,2,Northeast,Eastern,13,2,18,0.7222222222222222,13,0,10,3
2011-12,2011-10-29,Toronto Maple Leafs,2,Northeast,Eastern,15,2,20,0.75,15,0,12,3
2011-12,2011-10-30,Toronto Maple Leafs,0,Northeast,Eastern,15,2,22,0.6818181818181818,15,0,12,3
2011-12,2011-11-02,Toronto Maple Leafs,2,Northeast,Eastern,17,2,24,0.7083333333333334,17,0,12,5
2011-12,2011-11-03,Toronto Maple Leafs,2,Northeast,Eastern,19,2,26,0.7307692307692307,19,0,13,6
2011-12,2011-11-05,Toronto Maple Leafs,0,Northeast,Eastern,19,2,28,0.6785714285714286,19,0,14,5
2011-12,2011-11-09,Toronto Maple Leafs,0,Northeast,Eastern,19,2,30,0.6333333333333333,19,0,16,3
2011-12,2011-11-11,Toronto Maple Leafs,2,Northeast,Eastern,21,2,32,0.65625,21,0,18,3
2011-12,2011-11-13,Toronto Maple Leafs,0,Northeast,Eastern,21,2,34,0.6176470588235294,21,0,18,3
2011-12,2011-11-16,Toronto Maple Leafs,1,Northeast,Eastern,22,2,36,0.6111111111111112,22,0,19,3
2011-12,2011-11-18,Toronto Maple Leafs,0,Northeast,Eastern,22,2,38,0.5789473684210527,22,0,21,1
2011-12,2011-11-20,Toronto Maple Leafs,2,Northeast,Eastern,24,2,40,0.6,24,0,21,3
2011-12,2011-11-20,Toronto Maple Leafs,0,Northeast,Eastern,24,2,42,0.5714285714285714,24,0,21,3
2011-12,2011-11-23,Toronto Maple Leafs,2,Northeast,Eastern,26,2,44,0.5909090909090909,26,0,23,3
2011-12,2011-11-26,Toronto Maple Leafs,2,Northeast,Eastern,28,2,46,0.6086956521739131,28,0,25,3
2011-12,2011-11-28,Toronto Maple Leafs,2,Northeast,Eastern,30,2,48,0.625,30,0,25,5
2011-12,2011-12-01,Toronto Maple Leafs,0,Northeast,Eastern,30,2,50,0.6,31,-1,26,4
2011-12,2011-12-04,Toronto Maple Leafs,0,Northeast,Eastern,30,2,52,0.5769230769230769,33,-3,27,3
2011-12,2011-12-06,Toronto Maple Leafs,2,Northeast,Eastern,32,2,54,0.5925925925925926,35,-3,29,3
2011-12,2011-12-07,Toronto Maple Leafs,1,Northeast,Eastern,33,2,56,0.5892857142857143,35,-2,29,4
2011-12,2011-12-10,Toronto Maple Leafs,0,Northeast,Eastern,33,2,58,0.5689655172413793,35,-2,31,2
2011-12,2011-12-14,Toronto Maple Leafs,2,Northeast,Eastern,35,2,60,0.5833333333333334,39,-4,33,2
2011-12,2011-12-17,Toronto Maple Leafs,0,Northeast,Eastern,35,2,62,0.5645161290322581,43,-8,35,0
2011-12,2011-12-18,Toronto Maple Leafs,0,Northeast,Eastern,35,2,64,0.546875,43,-8,35,0
2011-12,2011-12-20,Toronto Maple Leafs,1,Northeast,Eastern,36,2,66,0.5454545454545454,45,-9,35,1
2011-12,2011-12-23,Toronto Maple Leafs,2,Northeast,Eastern,38,2,68,0.5588235294117647,45,-7,37,1
2011-12,2011-12-24,Toronto Maple Leafs,2,Northeast,Eastern,40,2,70,0.5714285714285714,47,-7,39,1
2011-12,2011-12-28,Toronto Maple Leafs,0,Northeast,Eastern,40,2,72,0.5555555555555556,47,-7,39,1
2011-12,2011-12-30,Toronto Maple Leafs,1,Northeast,Eastern,41,2,74,0.5540540540540541,49,-8,41,0
2011-12,2012-01-01,Toronto Maple Leafs,0,Northeast,Eastern,41,2,76,0.5394736842105263,49,-8,43,-2
2011-12,2012-01-04,Toronto Maple Leafs,2,Northeast,Eastern,43,2,78,0.5512820512820513,49,-6,44,-1
2011-12,2012-01-06,Toronto Maple Leafs,2,Northeast,Eastern,45,2,80,0.5625,53,-8,44,1
2011-12,2012-01-08,Toronto Maple Leafs,2,Northeast,Eastern,47,2,82,0.573170731707317,53,-6,46,1
2011-12,2012-01-11,Toronto Maple Leafs,2,Northeast,Eastern,49,2,84,0.5833333333333334,55,-6,46,3
2011-12,2012-01-14,Toronto Maple Leafs,0,Northeast,Eastern,49,2,86,0.5697674418604651,57,-8,48,1
2011-12,2012-01-15,Toronto Maple Leafs,0,Northeast,Eastern,49,2,88,0.5568181818181818,57,-8,50,-1
2011-12,2012-01-18,Toronto Maple Leafs,0,Northeast,Eastern,49,2,90,0.5444444444444444,59,-10,50,-1
2011-12,2012-01-20,Toronto Maple Leafs,2,Northeast,Eastern,51,2,92,0.5543478260869565,61,-10,52,-1
2011-12,2012-01-22,Toronto Maple Leafs,0,Northeast,Eastern,51,2,94,0.5425531914893617,64,-13,53,-2
2011-12,2012-01-24,Toronto Maple Leafs,2,Northeast,Eastern,53,2,96,0.5520833333333334,64,-11,53,0
2011-12,2012-01-25,Toronto Maple Leafs,2,Northeast,Eastern,55,2,98,0.5612244897959183,64,-9,55,0
2011-12,2012-02-01,Toronto Maple Leafs,1,Northeast,Eastern,56,2,100,0.56,66,-10,56,0
2011-12,2012-02-02,Toronto Maple Leafs,2,Northeast,Eastern,58,2,102,0.5686274509803921,66,-8,57,1
2011-12,2012-02-05,Toronto Maple Leafs,2,Northeast,Eastern,60,2,104,0.5769230769230769,68,-8,59,1
2011-12,2012-02-07,Toronto Maple Leafs,2,Northeast,Eastern,62,2,106,0.5849056603773585,68,-6,59,3
2011-12,2012-02-08,Toronto Maple Leafs,0,Northeast,Eastern,62,2,108,0.5740740740740741,68,-6,60,2
2011-12,2012-02-10,Toronto Maple Leafs,0,Northeast,Eastern,62,2,110,0.5636363636363636,68,-6,61,1
2011-12,2012-02-12,Toronto Maple Leafs,0,Northeast,Eastern,62,2,112,0.5535714285714286,70,-8,62,0
2011-12,2012-02-15,Toronto Maple Leafs,0,Northeast,Eastern,62,2,114,0.543859649122807,70,-8,62,0
2011-12,2012-02-16,Toronto Maple Leafs,2,Northeast,Eastern,64,2,116,0.5517241379310345,72,-8,64,0
2011-12,2012-02-19,Toronto Maple Leafs,0,Northeast,Eastern,64,2,118,0.5423728813559322,72,-8,64,0
2011-12,2012-02-22,Toronto Maple Leafs,1,Northeast,Eastern,65,2,120,0.5416666666666666,72,-7,65,0
2011-12,2012-02-24,Toronto Maple Leafs,0,Northeast,Eastern,65,2,122,0.5327868852459017,74,-9,66,-1
2011-12,2012-02-26,Toronto Maple Leafs,0,Northeast,Eastern,65,2,124,0.5241935483870968,77,-12,68,-3
2011-12,2012-02-29,Toronto Maple Leafs,0,Northeast,Eastern,65,2,126,0.5158730158730159,77,-12,69,-4
2011-12,2012-03-01,Toronto Maple Leafs,0,Northeast,Eastern,65,2,128,0.5078125,77,-12,69,-4
2011-12,2012-03-04,Toronto Maple Leafs,2,Northeast,Eastern,67,2,130,0.5153846153846153,79,-12,70,-3
2011-12,2012-03-07,Toronto Maple Leafs,0,Northeast,Eastern,67,2,132,0.5075757575757576,81,-14,72,-5
2011-12,2012-03-08,Toronto Maple Leafs,0,Northeast,Eastern,67,2,134,0.5,81,-14,72,-5
2011-12,2012-03-11,Toronto Maple Leafs,0,Northeast,Eastern,67,2,136,0.49264705882352944,83,-16,76,-9
2011-12,2012-03-11,Toronto Maple Leafs,1,Northeast,Eastern,68,2,138,0.4927536231884058,83,-15,76,-8
2011-12,2012-03-13,Toronto Maple Leafs,0,Northeast,Eastern,68,2,140,0.4857142857142857,83,-15,78,-10
2011-12,2012-03-15,Toronto Maple Leafs,2,Northeast,Eastern,70,2,142,0.49295774647887325,83,-13,78,-8
2011-12,2012-03-17,Toronto Maple Leafs,2,Northeast,Eastern,72,2,144,0.5,85,-13,78,-6
2011-12,2012-03-19,Toronto Maple Leafs,0,Northeast,Eastern,72,2,146,0.4931506849315068,87,-15,80,-8
2011-12,2012-03-20,Toronto Maple Leafs,0,Northeast,Eastern,72,2,148,0.4864864864864865,87,-15,80,-8
2011-12,2012-03-23,Toronto Maple Leafs,2,Northeast,Eastern,74,2,150,0.49333333333333335,87,-13,82,-8
2011-12,2012-03-24,Toronto Maple Leafs,1,Northeast,Eastern,75,2,152,0.4934210526315789,87,-12,84,-9
2011-12,2012-03-27,Toronto Maple Leafs,0,Northeast,Eastern,75,2,154,0.487012987012987,93,-18,86,-11
2011-12,2012-03-29,Toronto Maple Leafs,0,Northeast,Eastern,75,2,156,0.4807692307692308,94,-19,86,-11
2011-12,2012-03-31,Toronto Maple Leafs,2,Northeast,Eastern,77,2,158,0.4873417721518987,96,-19,88,-11
2011-12,2012-04-03,Toronto Maple Leafs,1,Northeast,Eastern,78,2,160,0.4875,98,-20,88,-10
2011-12,2012-04-05,Toronto Maple Leafs,2,Northeast,Eastern,80,2,162,0.49382716049382713,100,-20,90,-10
2011-12,2012-04-07,Toronto Maple Leafs,0,Northeast,Eastern,80,2,164,0.4878048780487805,102,-22,92,-12
2011-12,2011-10-07,Vancouver Canucks,1,Northwest,Western,1,2,2,0.5,1,0,0,1
2011-12,2011-10-10,Vancouver Canucks,2,Northwest,Western,3,2,4,0.75,3,0,2,1
2011-12,2011-10-12,Vancouver Canucks,0,Northwest,Western,3,2,6,0.5,4,-1,2,1
2011-12,2011-10-14,Vancouver Canucks,0,Northwest,Western,3,2,8,0.375,6,-3,3,0
2011-12,2011-10-16,Vancouver Canucks,2,Northwest,Western,5,2,10,0.5,8,-3,5,0
2011-12,2011-10-19,Vancouver Canucks,0,Northwest,Western,5,2,12,0.4166666666666667,10,-5,5,0
2011-12,2011-10-21,Vancouver Canucks,2,Northwest,Western,7,2,14,0.5,10,-3,7,0
2011-12,2011-10-22,Vancouver Canucks,2,Northwest,Western,9,2,16,0.5625,10,-1,8,1
2011-12,2011-10-26,Vancouver Canucks,0,Northwest,Western,9,2,18,0.5,12,-3,9,0
2011-12,2011-10-27,Vancouver Canucks,0,Northwest,Western,9,2,20,0.45,12,-3,9,0
2011-12,2011-10-30,Vancouver Canucks,2,Northwest,Western,11,2,22,0.5,14,-3,11,0
2011-12,2011-11-02,Vancouver Canucks,2,Northwest,Western,13,2,24,0.5416666666666666,16,-3,12,1
2011-12,2011-11-04,Vancouver Canucks,0,Northwest,Western,13,2,26,0.5,18,-5,14,-1
2011-12,2011-11-05,Vancouver Canucks,0,Northwest,Western,13,2,28,0.4642857142857143,18,-5,14,-1
2011-12,2011-11-07,Vancouver Canucks,2,Northwest,Western,15,2,30,0.5,18,-3,15,0
2011-12,2011-11-11,Vancouver Canucks,2,Northwest,Western,17,2,32,0.53125,20,-3,17,0
2011-12,2011-11-12,Vancouver Canucks,0,Northwest,Western,17,2,34,0.5,20,-3,17,0
2011-12,2011-11-14,Vancouver Canucks,2,Northwest,Western,19,2,36,0.5277777777777778,21,-2,19,0
2011-12,2011-11-17,Vancouver Canucks,0,Northwest,Western,19,2,38,0.5,23,-4,19,0
2011-12,2011-11-21,Vancouver Canucks,2,Northwest,Western,21,2,40,0.525,27,-6,22,-1
2011-12,2011-11-24,Vancouver Canucks,2,Northwest,Western,23,2,42,0.5476190476190477,29,-6,24,-1
2011-12,2011-11-26,Vancouver Canucks,2,Northwest,Western,25,2,44,0.5681818181818182,29,-4,26,-1
2011-12,2011-11-27,Vancouver Canucks,2,Northwest,Western,27,2,46,0.5869565217391305,29,-2,27,0
2011-12,2011-11-30,Vancouver Canucks,2,Northwest,Western,29,2,48,0.6041666666666666,31,-2,28,1
2011-12,2011-12-02,Vancouver Canucks,0,Northwest,Western,29,2,50,0.58,33,-4,29,0
2011-12,2011-12-05,Vancouver Canucks,2,Northwest,Western,31,2,52,0.5961538461538461,37,-6,29,2
2011-12,2011-12-07,Vancouver Canucks,2,Northwest,Western,33,2,54,0.6111111111111112,39,-6,30,3
2011-12,2011-12-09,Vancouver Canucks,2,Northwest,Western,35,2,56,0.625,41,-6,31,4
2011-12,2011-12-11,Vancouver Canucks,2,Northwest,Western,37,2,58,0.6379310344827587,43,-6,32,5
2011-12,2011-12-14,Vancouver Canucks,1,Northwest,Western,38,2,60,0.6333333333333333,43,-5,33,5
2011-12,2011-12-16,Vancouver Canucks,0,Northwest,Western,38,2,62,0.6129032258064516,44,-6,35,3
2011-12,2011-12-18,Vancouver Canucks,2,Northwest,Western,40,2,64,0.625,45,-5,37,3
2011-12,2011-12-20,Vancouver Canucks,2,Northwest,Western,42,2,66,0.6363636363636364,45,-3,37,5
2011-12,2011-12-22,Vancouver Canucks,2,Northwest,Western,44,2,68,0.6470588235294118,45,-1,39,5
2011-12,2011-12-24,Vancouver Canucks,0,Northwest,Western,44,2,70,0.6285714285714286,45,-1,40,4
2011-12,2011-12-27,Vancouver Canucks,2,Northwest,Western,46,2,72,0.6388888888888888,46,0,40,6
2011-12,2011-12-29,Vancouver Canucks,2,Northwest,Western,48,2,74,0.6486486486486487,48,0,41,7
2011-12,2011-12-30,Vancouver Canucks,2,Northwest,Western,50,2,76,0.6578947368421053,50,0,42,8
2011-12,2012-01-01,Vancouver Canucks,0,Northwest,Western,50,2,78,0.6410256410256411,50,0,43,7
2011-12,2012-01-03,Vancouver Canucks,1,Northwest,Western,51,2,80,0.6375,51,0,45,6
2011-12,2012-01-05,Vancouver Canucks,2,Northwest,Western,53,2,82,0.6463414634146342,53,0,45,8
2011-12,2012-01-07,Vancouver Canucks,2,Northwest,Western,55,2,84,0.6547619047619048,55,0,47,8
2011-12,2012-01-10,Vancouver Canucks,0,Northwest,Western,55,2,86,0.6395348837209303,55,0,48,7
2011-12,2012-01-11,Vancouver Canucks,2,Northwest,Western,57,2,88,0.6477272727272727,57,0,49,8
2011-12,2012-01-13,Vancouver Canucks,2,Northwest,Western,59,2,90,0.6555555555555556,59,0,50,9
2011-12,2012-01-16,Vancouver Canucks,0,Northwest,Western,59,2,92,0.6413043478260869,59,0,51,8
2011-12,2012-01-18,Vancouver Canucks,1,Northwest,Western,60,2,94,0.6382978723404256,60,0,51,9
2011-12,2012-01-21,Vancouver Canucks,2,Northwest,Western,62,2,96,0.6458333333333334,62,0,52,10
2011-12,2012-01-25,Vancouver Canucks,2,Northwest,Western,64,2,98,0.6530612244897959,64,0,55,9
2011-12,2012-02-01,Vancouver Canucks,2,Northwest,Western,66,2,100,0.66,66,0,55,11
2011-12,2012-02-03,Vancouver Canucks,1,Northwest,Western,67,2,102,0.6568627450980392,67,0,57,10
2011-12,2012-02-04,Vancouver Canucks,2,Northwest,Western,69,2,104,0.6634615384615384,69,0,57,12
2011-12,2012-02-08,Vancouver Canucks,2,Northwest,Western,71,2,106,0.6698113207547169,71,0,58,13
2011-12,2012-02-10,Vancouver Canucks,2,Northwest,Western,73,2,108,0.6759259259259259,73,0,60,13
2011-12,2012-02-12,Vancouver Canucks,1,Northwest,Western,74,2,110,0.6727272727272727,74,0,62,12
2011-12,2012-02-14,Vancouver Canucks,2,Northwest,Western,76,2,112,0.6785714285714286,76,0,63,13
2011-12,2012-02-16,Vancouver Canucks,2,Northwest,Western,78,2,114,0.6842105263157895,78,0,63,15
2011-12,2012-02-19,Vancouver Canucks,2,Northwest,Western,80,2,116,0.6896551724137931,80,0,65,15
2011-12,2012-02-20,Vancouver Canucks,2,Northwest,Western,82,2,118,0.6949152542372882,82,0,65,17
2011-12,2012-02-22,Vancouver Canucks,0,Northwest,Western,82,2,120,0.6833333333333333,82,0,66,16
2011-12,2012-02-24,Vancouver Canucks,2,Northwest,Western,84,2,122,0.6885245901639344,84,0,66,18
2011-12,2012-02-25,Vancouver Canucks,2,Northwest,Western,86,2,124,0.6935483870967742,86,0,68,18
2011-12,2012-02-26,Vancouver Canucks,1,Northwest,Western,87,2,126,0.6904761904761905,87,0,70,17
2011-12,2012-02-29,Vancouver Canucks,1,Northwest,Western,88,2,128,0.6875,88,0,70,18
2011-12,2012-03-02,Vancouver Canucks,2,Northwest,Western,90,2,130,0.6923076923076923,90,0,71,19
2011-12,2012-03-04,Vancouver Canucks,0,Northwest,Western,90,2,132,0.6818181818181818,90,0,73,17
2011-12,2012-03-07,Vancouver Canucks,0,Northwest,Western,90,2,134,0.6716417910447762,90,0,74,16
2011-12,2012-03-09,Vancouver Canucks,2,Northwest,Western,92,2,136,0.6764705882352942,92,0,75,17
2011-12,2012-03-11,Vancouver Canucks,0,Northwest,Western,92,2,138,0.6666666666666666,92,0,76,16
2011-12,2012-03-15,Vancouver Canucks,0,Northwest,Western,92,2,140,0.6571428571428571,92,0,81,11
2011-12,2012-03-18,Vancouver Canucks,2,Northwest,Western,94,2,142,0.6619718309859155,94,0,82,12
2011-12,2012-03-20,Vancouver Canucks,0,Northwest,Western,94,2,144,0.6527777777777778,94,0,83,11
2011-12,2012-03-22,Vancouver Canucks,1,Northwest,Western,95,2,146,0.6506849315068494,95,0,84,11
2011-12,2012-03-23,Vancouver Canucks,2,Northwest,Western,97,2,148,0.6554054054054054,97,0,85,12
2011-12,2012-03-25,Vancouver Canucks,2,Northwest,Western,99,2,150,0.66,99,0,86,13
2011-12,2012-03-27,Vancouver Canucks,2,Northwest,Western,101,2,152,0.6644736842105263,101,0,87,14
2011-12,2012-03-29,Vancouver Canucks,2,Northwest,Western,103,2,154,0.6688311688311688,103,0,88,15
2011-12,2012-03-31,Vancouver Canucks,2,Northwest,Western,105,2,156,0.6730769230769231,105,0,89,16
2011-12,2012-04-01,Vancouver Canucks,2,Northwest,Western,107,2,158,0.6772151898734177,107,0,90,17
2011-12,2012-04-04,Vancouver Canucks,2,Northwest,Western,109,2,160,0.68125,109,0,92,17
2011-12,2012-04-06,Vancouver Canucks,0,Northwest,Western,109,2,162,0.6728395061728395,109,0,94,15
2011-12,2012-04-08,Vancouver Canucks,2,Northwest,Western,111,2,164,0.676829268292683,111,0,95,16
2011-12,2011-10-08,Washington Capitals,2,Southeast,Eastern,2,2,2,1.0,2,0,1,1
2011-12,2011-10-10,Washington Capitals,2,Southeast,Eastern,4,2,4,1.0,4,0,2,2
2011-12,2011-10-13,Washington Capitals,2,Southeast,Eastern,6,2,6,1.0,6,0,3,3
2011-12,2011-10-15,Washington Capitals,2,Southeast,Eastern,8,2,8,1.0,8,0,4,4
2011-12,2011-10-18,Washington Capitals,2,Southeast,Eastern,10,2,10,1.0,10,0,6,4
2011-12,2011-10-20,Washington Capitals,2,Southeast,Eastern,12,2,12,1.0,12,0,6,6
2011-12,2011-10-22,Washington Capitals,2,Southeast,Eastern,14,2,14,1.0,14,0,8,6
2011-12,2011-10-28,Washington Capitals,0,Southeast,Eastern,14,2,16,0.875,14,0,10,4
2011-12,2011-10-30,Washington Capitals,0,Southeast,Eastern,14,2,18,0.7777777777777778,14,0,12,2
2011-12,2011-11-01,Washington Capitals,2,Southeast,Eastern,16,2,20,0.8,16,0,12,4
2011-12,2011-11-04,Washington Capitals,2,Southeast,Eastern,18,2,22,0.8181818181818182,18,0,14,4
2011-12,2011-11-05,Washington Capitals,0,Southeast,Eastern,18,2,24,0.75,18,0,14,4
2011-12,2011-11-09,Washington Capitals,0,Southeast,Eastern,18,2,26,0.6923076923076923,18,0,16,2
2011-12,2011-11-12,Washington Capitals,2,Southeast,Eastern,20,2,28,0.7142857142857143,20,0,18,2
2011-12,2011-11-13,Washington Capitals,1,Southeast,Eastern,21,2,30,0.7,21,0,18,3
2011-12,2011-11-16,Washington Capitals,0,Southeast,Eastern,21,2,32,0.65625,21,0,19,2
2011-12,2011-11-18,Washington Capitals,0,Southeast,Eastern,21,2,34,0.6176470588235294,21,0,21,0
2011-12,2011-11-20,Washington Capitals,0,Southeast,Eastern,21,2,36,0.5833333333333334,23,-2,21,0
2011-12,2011-11-22,Washington Capitals,2,Southeast,Eastern,23,2,38,0.6052631578947368,25,-2,23,0
2011-12,2011-11-24,Washington Capitals,2,Southeast,Eastern,25,2,40,0.625,27,-2,23,2
2011-12,2011-11-25,Washington Capitals,0,Southeast,Eastern,25,2,42,0.5952380952380952,27,-2,25,0
2011-12,2011-11-27,Washington Capitals,0,Southeast,Eastern,25,2,44,0.5681818181818182,28,-3,25,0
2011-12,2011-11-30,Washington Capitals,0,Southeast,Eastern,25,2,46,0.5434782608695652,30,-5,26,-1
2011-12,2011-12-02,Washington Capitals,0,Southeast,Eastern,25,2,48,0.5208333333333334,30,-5,26,-1
2011-12,2011-12-04,Washington Capitals,2,Southeast,Eastern,27,2,50,0.54,32,-5,27,0
2011-12,2011-12-06,Washington Capitals,0,Southeast,Eastern,27,2,52,0.5192307692307693,34,-7,29,-2
2011-12,2011-12-08,Washington Capitals,2,Southeast,Eastern,29,2,54,0.5370370370370371,34,-5,29,0
2011-12,2011-12-10,Washington Capitals,2,Southeast,Eastern,31,2,56,0.5535714285714286,37,-6,31,0
2011-12,2011-12-14,Washington Capitals,0,Southeast,Eastern,31,2,58,0.5344827586206896,38,-7,33,-2
2011-12,2011-12-16,Washington Capitals,2,Southeast,Eastern,33,2,60,0.55,38,-5,33,0
2011-12,2011-12-18,Washington Capitals,0,Southeast,Eastern,33,2,62,0.532258064516129,42,-9,35,-2
2011-12,2011-12-21,Washington Capitals,2,Southeast,Eastern,35,2,64,0.546875,42,-7,36,-1
2011-12,2011-12-24,Washington Capitals,1,Southeast,Eastern,36,2,66,0.5454545454545454,43,-7,39,-3
2011-12,2011-12-27,Washington Capitals,0,Southeast,Eastern,36,2,68,0.5294117647058824,43,-7,39,-3
2011-12,2011-12-29,Washington Capitals,2,Southeast,Eastern,38,2,70,0.5428571428571428,45,-7,39,-1
2011-12,2011-12-31,Washington Capitals,2,Southeast,Eastern,40,2,72,0.5555555555555556,45,-5,41,-1
2011-12,2012-01-01,Washington Capitals,2,Southeast,Eastern,42,2,74,0.5675675675675675,47,-5,43,-1
2011-12,2012-01-04,Washington Capitals,2,Southeast,Eastern,44,2,76,0.5789473684210527,47,-3,44,0
2011-12,2012-01-08,Washington Capitals,0,Southeast,Eastern,44,2,78,0.5641025641025641,48,-4,46,-2
2011-12,2012-01-10,Washington Capitals,0,Southeast,Eastern,44,2,80,0.55,50,-6,46,-2
2011-12,2012-01-12,Washington Capitals,2,Southeast,Eastern,46,2,82,0.5609756097560976,50,-4,46,0
2011-12,2012-01-14,Washington Capitals,2,Southeast,Eastern,48,2,84,0.5714285714285714,50,-2,48,0
2011-12,2012-01-15,Washington Capitals,2,Southeast,Eastern,50,2,86,0.5813953488372093,50,0,50,0
2011-12,2012-01-18,Washington Capitals,0,Southeast,Eastern,50,2,88,0.5681818181818182,51,-1,50,0
2011-12,2012-01-19,Washington Capitals,2,Southeast,Eastern,52,2,90,0.5777777777777777,52,0,52,0
2011-12,2012-01-21,Washington Capitals,0,Southeast,Eastern,52,2,92,0.5652173913043478,52,0,52,0
2011-12,2012-01-22,Washington Capitals,1,Southeast,Eastern,53,2,94,0.5638297872340425,54,-1,53,0
2011-12,2012-01-25,Washington Capitals,2,Southeast,Eastern,55,2,96,0.5729166666666666,55,0,55,0
2011-12,2012-02-01,Washington Capitals,1,Southeast,Eastern,56,2,98,0.5714285714285714,56,0,56,0
2011-12,2012-02-02,Washington Capitals,0,Southeast,Eastern,56,2,100,0.56,57,-1,57,-1
2011-12,2012-02-04,Washington Capitals,2,Southeast,Eastern,58,2,102,0.5686274509803921,59,-1,58,0
2011-12,2012-02-05,Washington Capitals,0,Southeast,Eastern,58,2,104,0.5576923076923077,59,-1,59,-1
2011-12,2012-02-08,Washington Capitals,2,Southeast,Eastern,60,2,106,0.5660377358490566,60,0,60,0
2011-12,2012-02-10,Washington Capitals,1,Southeast,Eastern,61,2,108,0.5648148148148148,61,0,61,0
2011-12,2012-02-12,Washington Capitals,0,Southeast,Eastern,61,2,110,0.5545454545454546,65,-4,62,-1
2011-12,2012-02-14,Washington Capitals,0,Southeast,Eastern,61,2,112,0.5446428571428571,65,-4,62,-1
2011-12,2012-02-18,Washington Capitals,2,Southeast,Eastern,63,2,114,0.5526315789473685,65,-2,64,-1
2011-12,2012-02-19,Washington Capitals,0,Southeast,Eastern,63,2,116,0.5431034482758621,65,-2,64,-1
2011-12,2012-02-21,Washington Capitals,0,Southeast,Eastern,63,2,118,0.5338983050847458,65,-2,64,-1
2011-12,2012-02-23,Washington Capitals,0,Southeast,Eastern,63,2,120,0.525,65,-2,65,-2
2011-12,2012-02-25,Washington Capitals,2,Southeast,Eastern,65,2,122,0.5327868852459017,68,-3,66,-1
2011-12,2012-02-26,Washington Capitals,2,Southeast,Eastern,67,2,124,0.5403225806451613,70,-3,68,-1
2011-12,2012-02-29,Washington Capitals,2,Southeast,Eastern,69,2,126,0.5476190476190477,72,-3,69,0
2011-12,2012-03-03,Washington Capitals,0,Southeast,Eastern,69,2,128,0.5390625,72,-3,70,-1
2011-12,2012-03-05,Washington Capitals,0,Southeast,Eastern,69,2,130,0.5307692307692308,74,-5,70,-1
2011-12,2012-03-07,Washington Capitals,1,Southeast,Eastern,70,2,132,0.5303030303030303,74,-4,72,-2
2011-12,2012-03-09,Washington Capitals,2,Southeast,Eastern,72,2,134,0.5373134328358209,74,-2,72,0
2011-12,2012-03-10,Washington Capitals,2,Southeast,Eastern,74,2,136,0.5441176470588235,75,-1,74,0
2011-12,2012-03-11,Washington Capitals,2,Southeast,Eastern,76,2,138,0.5507246376811594,77,-1,76,0
2011-12,2012-03-13,Washington Capitals,2,Southeast,Eastern,78,2,140,0.5571428571428572,79,-1,78,0
2011-12,2012-03-17,Washington Capitals,0,Southeast,Eastern,78,2,142,0.5492957746478874,83,-5,78,0
2011-12,2012-03-18,Washington Capitals,0,Southeast,Eastern,78,2,144,0.5416666666666666,83,-5,78,0
2011-12,2012-03-19,Washington Capitals,2,Southeast,Eastern,80,2,146,0.547945205479452,83,-3,80,0
2011-12,2012-03-22,Washington Capitals,1,Southeast,Eastern,81,2,148,0.5472972972972973,85,-4,81,0
2011-12,2012-03-23,Washington Capitals,1,Southeast,Eastern,82,2,150,0.5466666666666666,86,-4,82,0
2011-12,2012-03-25,Washington Capitals,2,Southeast,Eastern,84,2,152,0.5526315789473685,87,-3,84,0
2011-12,2012-03-27,Washington Capitals,0,Southeast,Eastern,84,2,154,0.5454545454545454,89,-5,86,-2
2011-12,2012-03-29,Washington Capitals,2,Southeast,Eastern,86,2,156,0.5512820512820513,89,-3,86,0
2011-12,2012-03-31,Washington Capitals,2,Southeast,Eastern,88,2,158,0.5569620253164557,90,-2,88,0
2011-12,2012-04-02,Washington Capitals,0,Southeast,Eastern,88,2,160,0.55,91,-3,88,0
2011-12,2012-04-05,Washington Capitals,2,Southeast,Eastern,90,2,162,0.5555555555555556,92,-2,90,0
2011-12,2012-04-07,Washington Capitals,2,Southeast,Eastern,92,2,164,0.5609756097560976,94,-2,92,0
2011-12,2011-10-09,Winnipeg Jets,0,Southeast,Eastern,0,2,2,0.0,2,-2,2,-2
2011-12,2011-10-14,Winnipeg Jets,0,Southeast,Eastern,0,2,4,0.0,6,-6,4,-4
2011-12,2011-10-15,Winnipeg Jets,0,Southeast,Eastern,0,2,6,0.0,8,-8,4,-4
2011-12,2011-10-18,Winnipeg Jets,2,Southeast,Eastern,2,2,8,0.25,10,-8,6,-4
2011-12,2011-10-19,Winnipeg Jets,1,Southeast,Eastern,3,2,10,0.3,10,-7,6,-3
2011-12,2011-10-20,Winnipeg Jets,0,Southeast,Eastern,3,2,12,0.25,12,-9,6,-3
2011-12,2011-10-22,Winnipeg Jets,2,Southeast,Eastern,5,2,14,0.35714285714285715,14,-9,8,-3
2011-12,2011-10-25,Winnipeg Jets,0,Southeast,Eastern,5,2,16,0.3125,14,-9,9,-4
2011-12,2011-10-27,Winnipeg Jets,2,Southeast,Eastern,7,2,18,0.3888888888888889,14,-7,10,-3
2011-12,2011-10-29,Winnipeg Jets,0,Southeast,Eastern,7,2,20,0.35,14,-7,12,-5
2011-12,2011-10-31,Winnipeg Jets,2,Southeast,Eastern,9,2,22,0.4090909090909091,14,-5,12,-3
2011-12,2011-11-03,Winnipeg Jets,2,Southeast,Eastern,11,2,24,0.4583333333333333,16,-5,13,-2
2011-12,2011-11-05,Winnipeg Jets,1,Southeast,Eastern,12,2,26,0.46153846153846156,18,-6,14,-2
2011-12,2011-11-07,Winnipeg Jets,0,Southeast,Eastern,12,2,28,0.42857142857142855,18,-6,15,-3
2011-12,2011-11-09,Winnipeg Jets,1,Southeast,Eastern,13,2,30,0.43333333333333335,18,-5,16,-3
2011-12,2011-11-11,Winnipeg Jets,0,Southeast,Eastern,13,2,32,0.40625,19,-6,18,-5
2011-12,2011-11-13,Winnipeg Jets,0,Southeast,Eastern,13,2,34,0.38235294117647056,21,-8,18,-5
2011-12,2011-11-15,Winnipeg Jets,2,Southeast,Eastern,15,2,36,0.4166666666666667,21,-6,18,-3
2011-12,2011-11-18,Winnipeg Jets,2,Southeast,Eastern,17,2,38,0.4473684210526316,21,-4,21,-4
2011-12,2011-11-19,Winnipeg Jets,2,Southeast,Eastern,19,2,40,0.475,21,-2,21,-2
2011-12,2011-11-24,Winnipeg Jets,1,Southeast,Eastern,20,2,42,0.47619047619047616,27,-7,23,-3
2011-12,2011-11-26,Winnipeg Jets,2,Southeast,Eastern,22,2,44,0.5,28,-6,25,-3
2011-12,2011-11-27,Winnipeg Jets,0,Southeast,Eastern,22,2,46,0.4782608695652174,28,-6,25,-3
2011-12,2011-11-30,Winnipeg Jets,0,Southeast,Eastern,22,2,48,0.4583333333333333,30,-8,26,-4
2011-12,2011-12-02,Winnipeg Jets,2,Southeast,Eastern,24,2,50,0.48,30,-6,26,-2
2011-12,2011-12-04,Winnipeg Jets,2,Southeast,Eastern,26,2,52,0.5,32,-6,27,-1
2011-12,2011-12-07,Winnipeg Jets,2,Southeast,Eastern,28,2,54,0.5185185185185185,34,-6,29,-1
2011-12,2011-12-10,Winnipeg Jets,2,Southeast,Eastern,30,2,56,0.5357142857142857,37,-7,31,-1
2011-12,2011-12-11,Winnipeg Jets,0,Southeast,Eastern,30,2,58,0.5172413793103449,37,-7,31,-1
2011-12,2011-12-14,Winnipeg Jets,2,Southeast,Eastern,32,2,60,0.5333333333333333,38,-6,33,-1
2011-12,2011-12-16,Winnipeg Jets,0,Southeast,Eastern,32,2,62,0.5161290322580645,38,-6,33,-1
2011-12,2011-12-18,Winnipeg Jets,2,Southeast,Eastern,34,2,64,0.53125,42,-8,35,-1
2011-12,2011-12-21,Winnipeg Jets,1,Southeast,Eastern,35,2,66,0.5303030303030303,42,-7,36,-1
2011-12,2011-12-23,Winnipeg Jets,2,Southeast,Eastern,37,2,68,0.5441176470588235,43,-6,37,0
2011-12,2011-12-24,Winnipeg Jets,0,Southeast,Eastern,37,2,70,0.5285714285714286,43,-6,39,-2
2011-12,2011-12-28,Winnipeg Jets,2,Southeast,Eastern,39,2,72,0.5416666666666666,45,-6,39,0
2011-12,2011-12-30,Winnipeg Jets,2,Southeast,Eastern,41,2,74,0.5540540540540541,45,-4,41,0
2011-12,2012-01-01,Winnipeg Jets,2,Southeast,Eastern,43,2,76,0.5657894736842105,47,-4,43,0
2011-12,2012-01-05,Winnipeg Jets,0,Southeast,Eastern,43,2,78,0.5512820512820513,47,-4,44,-1
2011-12,2012-01-06,Winnipeg Jets,0,Southeast,Eastern,43,2,80,0.5375,48,-5,44,-1
2011-12,2012-01-08,Winnipeg Jets,2,Southeast,Eastern,45,2,82,0.5487804878048781,48,-3,46,-1
2011-12,2012-01-11,Winnipeg Jets,0,Southeast,Eastern,45,2,84,0.5357142857142857,50,-5,46,-1
2011-12,2012-01-13,Winnipeg Jets,0,Southeast,Eastern,45,2,86,0.5232558139534884,50,-5,46,-1
2011-12,2012-01-14,Winnipeg Jets,0,Southeast,Eastern,45,2,88,0.5113636363636364,50,-5,48,-3
2011-12,2012-01-17,Winnipeg Jets,2,Southeast,Eastern,47,2,90,0.5222222222222223,51,-4,50,-3
2011-12,2012-01-18,Winnipeg Jets,0,Southeast,Eastern,47,2,92,0.5108695652173914,51,-4,50,-3
2011-12,2012-01-20,Winnipeg Jets,2,Southeast,Eastern,49,2,94,0.5212765957446809,52,-3,52,-3
2011-12,2012-01-22,Winnipeg Jets,1,Southeast,Eastern,50,2,96,0.5208333333333334,54,-4,53,-3
2011-12,2012-01-24,Winnipeg Jets,0,Southeast,Eastern,50,2,98,0.5102040816326531,54,-4,53,-3
2011-12,2012-01-25,Winnipeg Jets,0,Southeast,Eastern,50,2,100,0.5,55,-5,55,-5
2011-12,2012-02-01,Winnipeg Jets,2,Southeast,Eastern,52,2,102,0.5098039215686274,56,-4,56,-4
2011-12,2012-02-03,Winnipeg Jets,2,Southeast,Eastern,54,2,104,0.5192307692307693,57,-3,57,-3
2011-12,2012-02-04,Winnipeg Jets,0,Southeast,Eastern,54,2,106,0.5094339622641509,59,-5,58,-4
2011-12,2012-02-05,Winnipeg Jets,0,Southeast,Eastern,54,2,108,0.5,59,-5,59,-5
2011-12,2012-02-08,Winnipeg Jets,2,Southeast,Eastern,56,2,110,0.509090909090909,60,-4,60,-4
2011-12,2012-02-10,Winnipeg Jets,2,Southeast,Eastern,58,2,112,0.5178571428571429,61,-3,61,-3
2011-12,2012-02-11,Winnipeg Jets,0,Southeast,Eastern,58,2,114,0.5087719298245614,63,-5,62,-4
2011-12,2012-02-15,Winnipeg Jets,0,Southeast,Eastern,58,2,116,0.5,65,-7,62,-4
2011-12,2012-02-17,Winnipeg Jets,2,Southeast,Eastern,60,2,118,0.5084745762711864,65,-5,64,-4
2011-12,2012-02-18,Winnipeg Jets,2,Southeast,Eastern,62,2,120,0.5166666666666667,65,-3,64,-2
2011-12,2012-02-20,Winnipeg Jets,2,Southeast,Eastern,64,2,122,0.5245901639344263,65,-1,64,0
2011-12,2012-02-22,Winnipeg Jets,1,Southeast,Eastern,65,2,124,0.5241935483870968,65,0,65,0
2011-12,2012-02-24,Winnipeg Jets,2,Southeast,Eastern,67,2,126,0.5317460317460317,67,0,66,1
2011-12,2012-02-25,Winnipeg Jets,1,Southeast,Eastern,68,2,128,0.53125,68,0,66,2
2011-12,2012-02-28,Winnipeg Jets,0,Southeast,Eastern,68,2,130,0.5230769230769231,70,-2,68,0
2011-12,2012-03-02,Winnipeg Jets,2,Southeast,Eastern,70,2,132,0.5303030303030303,72,-2,70,0
2011-12,2012-03-06,Winnipeg Jets,2,Southeast,Eastern,72,2,134,0.5373134328358209,74,-2,72,0
2011-12,2012-03-09,Winnipeg Jets,0,Southeast,Eastern,72,2,136,0.5294117647058824,74,-2,72,0
2011-12,2012-03-10,Winnipeg Jets,0,Southeast,Eastern,72,2,138,0.5217391304347826,75,-3,74,-2
2011-12,2012-03-15,Winnipeg Jets,2,Southeast,Eastern,74,2,140,0.5285714285714286,81,-7,78,-4
2011-12,2012-03-17,Winnipeg Jets,2,Southeast,Eastern,76,2,142,0.5352112676056338,83,-7,78,-2
2011-12,2012-03-19,Winnipeg Jets,0,Southeast,Eastern,76,2,144,0.5277777777777778,83,-7,80,-4
2011-12,2012-03-20,Winnipeg Jets,0,Southeast,Eastern,76,2,146,0.5205479452054794,85,-9,80,-4
2011-12,2012-03-23,Winnipeg Jets,2,Southeast,Eastern,78,2,148,0.527027027027027,86,-8,82,-4
2011-12,2012-03-24,Winnipeg Jets,0,Southeast,Eastern,78,2,150,0.52,86,-8,84,-6
2011-12,2012-03-27,Winnipeg Jets,0,Southeast,Eastern,78,2,152,0.5131578947368421,89,-11,86,-8
2011-12,2012-03-28,Winnipeg Jets,0,Southeast,Eastern,78,2,154,0.5064935064935064,89,-11,86,-8
2011-12,2012-03-30,Winnipeg Jets,2,Southeast,Eastern,80,2,156,0.5128205128205128,90,-10,86,-6
2011-12,2012-03-31,Winnipeg Jets,1,Southeast,Eastern,81,2,158,0.5126582278481012,90,-9,88,-7
2011-12,2012-04-03,Winnipeg Jets,2,Southeast,Eastern,83,2,160,0.51875,92,-9,88,-5
2011-12,2012-04-05,Winnipeg Jets,0,Southeast,Eastern,83,2,162,0.5123456790123457,92,-9,90,-7
2011-12,2012-04-07,Winnipeg Jets,1,Southeast,Eastern,84,2,164,0.5121951219512195,94,-10,92,-8
2012-13,2013-01-20,Anaheim Ducks,2,Pacific,Western,2,2,2,1.0,2,0,1,1
2012-13,2013-01-22,Anaheim Ducks,2,Pacific,Western,4,2,4,1.0,4,0,2,2
2012-13,2013-01-26,Anaheim Ducks,0,Pacific,Western,4,2,6,0.6666666666666666,8,-4,4,0
2012-13,2013-01-27,Anaheim Ducks,2,Pacific,Western,6,2,8,0.75,8,-2,4,2
2012-13,2013-01-30,Anaheim Ducks,1,Pacific,Western,7,2,10,0.7,12,-5,6,1
2012-13,2013-02-02,Anaheim Ducks,2,Pacific,Western,9,2,12,0.75,14,-5,9,0
2012-13,2013-02-03,Anaheim Ducks,2,Pacific,Western,11,2,14,0.7857142857142857,15,-4,9,2
2012-13,2013-02-05,Anaheim Ducks,2,Pacific,Western,13,2,16,0.8125,15,-2,9,4
2012-13,2013-02-07,Anaheim Ducks,2,Pacific,Western,15,2,18,0.8333333333333334,15,0,11,4
2012-13,2013-02-09,Anaheim Ducks,0,Pacific,Western,15,2,20,0.75,16,-1,12,3
2012-13,2013-02-10,Anaheim Ducks,2,Pacific,Western,17,2,22,0.7727272727272727,17,0,13,4
2012-13,2013-02-13,Anaheim Ducks,2,Pacific,Western,19,2,24,0.7916666666666666,19,0,14,5
2012-13,2013-02-16,Anaheim Ducks,2,Pacific,Western,21,2,26,0.8076923076923077,21,0,16,5
2012-13,2013-02-17,Anaheim Ducks,2,Pacific,Western,23,2,28,0.8214285714285714,23,0,16,7
2012-13,2013-02-19,Anaheim Ducks,2,Pacific,Western,25,2,30,0.8333333333333334,25,0,17,8
2012-13,2013-02-25,Anaheim Ducks,2,Pacific,Western,27,2,32,0.84375,27,0,19,8
2012-13,2013-02-26,Anaheim Ducks,0,Pacific,Western,27,2,34,0.7941176470588235,27,0,20,7
2012-13,2013-02-28,Anaheim Ducks,2,Pacific,Western,29,2,36,0.8055555555555556,29,0,21,8
2012-13,2013-03-02,Anaheim Ducks,2,Pacific,Western,31,2,38,0.8157894736842105,31,0,22,9
2012-13,2013-03-03,Anaheim Ducks,1,Pacific,Western,32,2,40,0.8,32,0,23,9
2012-13,2013-03-05,Anaheim Ducks,1,Pacific,Western,33,2,42,0.7857142857142857,33,0,24,9
2012-13,2013-03-07,Anaheim Ducks,2,Pacific,Western,35,2,44,0.7954545454545454,35,0,24,11
2012-13,2013-03-09,Anaheim Ducks,2,Pacific,Western,37,2,46,0.8043478260869565,37,0,26,11
2012-13,2013-03-11,Anaheim Ducks,2,Pacific,Western,39,2,48,0.8125,39,0,28,11
2012-13,2013-03-13,Anaheim Ducks,2,Pacific,Western,41,2,50,0.82,41,0,28,13
2012-13,2013-03-15,Anaheim Ducks,2,Pacific,Western,43,2,52,0.8269230769230769,43,0,29,14
2012-13,2013-03-17,Anaheim Ducks,1,Pacific,Western,44,2,54,0.8148148148148148,44,0,30,14
2012-13,2013-03-19,Anaheim Ducks,2,Pacific,Western,46,2,56,0.8214285714285714,46,0,30,16
2012-13,2013-03-21,Anaheim Ducks,2,Pacific,Western,48,2,58,0.8275862068965517,48,0,32,16
2012-13,2013-03-23,Anaheim Ducks,0,Pacific,Western,48,2,60,0.8,48,0,32,16
2012-13,2013-03-25,Anaheim Ducks,0,Pacific,Western,48,2,62,0.7741935483870968,48,0,33,15
2012-13,2013-03-26,Anaheim Ducks,0,Pacific,Western,48,2,64,0.75,48,0,34,14
2012-13,2013-03-28,Anaheim Ducks,0,Pacific,Western,48,2,66,0.7272727272727273,48,0,36,12
2012-13,2013-03-30,Anaheim Ducks,2,Pacific,Western,50,2,68,0.7352941176470589,50,0,36,14
2012-13,2013-03-31,Anaheim Ducks,1,Pacific,Western,51,2,70,0.7285714285714285,51,0,37,14
2012-13,2013-04-02,Anaheim Ducks,2,Pacific,Western,53,2,72,0.7361111111111112,53,0,38,15
2012-13,2013-04-04,Anaheim Ducks,2,Pacific,Western,55,2,74,0.7432432432432432,55,0,39,16
2012-13,2013-04-06,Anaheim Ducks,0,Pacific,Western,55,2,76,0.7236842105263158,55,0,42,13
2012-13,2013-04-08,Anaheim Ducks,2,Pacific,Western,57,2,78,0.7307692307692307,57,0,43,14
2012-13,2013-04-09,Anaheim Ducks,2,Pacific,Western,59,2,80,0.7375,59,0,43,16
2012-13,2013-04-11,Anaheim Ducks,0,Pacific,Western,59,2,82,0.7195121951219512,59,0,44,15
2012-13,2013-04-14,Anaheim Ducks,0,Pacific,Western,59,2,84,0.7023809523809523,59,0,47,12
2012-13,2013-04-18,Anaheim Ducks,1,Pacific,Western,60,2,86,0.6976744186046512,60,0,49,11
2012-13,2013-04-20,Anaheim Ducks,0,Pacific,Western,60,2,88,0.6818181818181818,60,0,49,11
2012-13,2013-04-22,Anaheim Ducks,2,Pacific,Western,62,2,90,0.6888888888888889,62,0,51,11
2012-13,2013-04-23,Anaheim Ducks,2,Pacific,Western,64,2,92,0.6956521739130435,64,0,51,13
2012-13,2013-04-26,Anaheim Ducks,2,Pacific,Western,66,2,94,0.7021276595744681,66,0,53,13
2012-13,2013-04-28,Anaheim Ducks,0,Pacific,Western,66,2,96,0.6875,66,0,55,11
2012-13,2013-01-20,Boston Bruins,2,Northeast,Eastern,2,2,2,1.0,2,0,2,0
2012-13,2013-01-21,Boston Bruins,2,Northeast,Eastern,4,2,4,1.0,4,0,2,2
2012-13,2013-01-24,Boston Bruins,1,Northeast,Eastern,5,2,6,0.8333333333333334,5,0,3,2
2012-13,2013-01-26,Boston Bruins,2,Northeast,Eastern,7,2,8,0.875,7,0,4,3
2012-13,2013-01-29,Boston Bruins,2,Northeast,Eastern,9,2,10,0.9,9,0,5,4
2012-13,2013-01-30,Boston Bruins,2,Northeast,Eastern,11,2,12,0.9166666666666666,11,0,6,5
2012-13,2013-02-01,Boston Bruins,0,Northeast,Eastern,11,2,14,0.7857142857142857,11,0,8,3
2012-13,2013-02-03,Boston Bruins,2,Northeast,Eastern,13,2,16,0.8125,13,0,8,5
2012-13,2013-02-07,Boston Bruins,2,Northeast,Eastern,15,2,18,0.8333333333333334,15,0,9,6
2012-13,2013-02-11,Boston Bruins,2,Northeast,Eastern,17,2,20,0.85,17,0,12,5
2012-13,2013-02-13,Boston Bruins,1,Northeast,Eastern,18,2,22,0.8181818181818182,18,0,14,4
2012-13,2013-02-16,Boston Bruins,0,Northeast,Eastern,18,2,24,0.75,18,0,15,3
2012-13,2013-02-17,Boston Bruins,2,Northeast,Eastern,20,2,26,0.7692307692307693,20,0,16,4
2012-13,2013-02-22,Boston Bruins,2,Northeast,Eastern,22,2,28,0.7857142857142857,24,-2,17,5
2012-13,2013-02-24,Boston Bruins,2,Northeast,Eastern,24,2,30,0.8,26,-2,19,5
2012-13,2013-02-27,Boston Bruins,2,Northeast,Eastern,26,2,32,0.8125,27,-1,19,7
2012-13,2013-03-01,Boston Bruins,2,Northeast,Eastern,28,2,34,0.8235294117647058,29,-1,21,7
2012-13,2013-03-02,Boston Bruins,2,Northeast,Eastern,30,2,36,0.8333333333333334,30,0,21,9
2012-13,2013-03-04,Boston Bruins,0,Northeast,Eastern,30,2,38,0.7894736842105263,32,-2,23,7
2012-13,2013-03-06,Boston Bruins,1,Northeast,Eastern,31,2,40,0.775,32,-1,24,7
2012-13,2013-03-08,Boston Bruins,2,Northeast,Eastern,33,2,42,0.7857142857142857,34,-1,26,7
2012-13,2013-03-09,Boston Bruins,2,Northeast,Eastern,35,2,44,0.7954545454545454,35,0,26,9
2012-13,2013-03-11,Boston Bruins,2,Northeast,Eastern,37,2,46,0.8043478260869565,38,-1,28,9
2012-13,2013-03-12,Boston Bruins,0,Northeast,Eastern,37,2,48,0.7708333333333334,38,-1,28,9
2012-13,2013-03-14,Boston Bruins,2,Northeast,Eastern,39,2,50,0.78,40,-1,28,11
2012-13,2013-03-16,Boston Bruins,2,Northeast,Eastern,41,2,52,0.7884615384615384,42,-1,31,10
2012-13,2013-03-17,Boston Bruins,0,Northeast,Eastern,41,2,54,0.7592592592592593,42,-1,31,10
2012-13,2013-03-20,Boston Bruins,0,Northeast,Eastern,41,2,56,0.7321428571428571,43,-2,32,9
2012-13,2013-03-21,Boston Bruins,2,Northeast,Eastern,43,2,58,0.7413793103448276,45,-2,32,11
2012-13,2013-03-23,Boston Bruins,0,Northeast,Eastern,43,2,60,0.7166666666666667,45,-2,32,11
2012-13,2013-03-25,Boston Bruins,2,Northeast,Eastern,45,2,62,0.7258064516129032,45,0,33,12
2012-13,2013-03-27,Boston Bruins,1,Northeast,Eastern,46,2,64,0.71875,47,-1,35,11
2012-13,2013-03-30,Boston Bruins,0,Northeast,Eastern,46,2,66,0.696969696969697,49,-3,35,11
2012-13,2013-03-31,Boston Bruins,2,Northeast,Eastern,48,2,68,0.7058823529411765,49,-1,35,13
2012-13,2013-04-02,Boston Bruins,2,Northeast,Eastern,50,2,70,0.7142857142857143,51,-1,38,12
2012-13,2013-04-04,Boston Bruins,2,Northeast,Eastern,52,2,72,0.7222222222222222,53,-1,39,13
2012-13,2013-04-06,Boston Bruins,0,Northeast,Eastern,52,2,74,0.7027027027027027,55,-3,40,12
2012-13,2013-04-08,Boston Bruins,2,Northeast,Eastern,54,2,76,0.7105263157894737,55,-1,42,12
2012-13,2013-04-10,Boston Bruins,2,Northeast,Eastern,56,2,78,0.717948717948718,56,0,44,12
2012-13,2013-04-11,Boston Bruins,0,Northeast,Eastern,56,2,80,0.7,57,-1,44,12
2012-13,2013-04-13,Boston Bruins,0,Northeast,Eastern,56,2,82,0.6829268292682927,57,-1,46,10
2012-13,2013-04-17,Boston Bruins,1,Northeast,Eastern,57,2,84,0.6785714285714286,57,0,46,11
2012-13,2013-04-20,Boston Bruins,0,Northeast,Eastern,57,2,86,0.6627906976744186,59,-2,50,7
2012-13,2013-04-21,Boston Bruins,2,Northeast,Eastern,59,2,88,0.6704545454545454,59,0,52,7
2012-13,2013-04-23,Boston Bruins,0,Northeast,Eastern,59,2,90,0.6555555555555556,59,0,52,7
2012-13,2013-04-25,Boston Bruins,2,Northeast,Eastern,61,2,92,0.6630434782608695,61,0,54,7
2012-13,2013-04-27,Boston Bruins,1,Northeast,Eastern,62,2,94,0.6595744680851063,63,-1,54,8
2012-13,2013-04-28,Boston Bruins,0,Northeast,Eastern,62,2,96,0.6458333333333334,63,-1,55,7
2012-13,2013-01-20,Buffalo Sabres,2,Northeast,Eastern,2,2,2,1.0,2,0,2,0
2012-13,2013-01-22,Buffalo Sabres,2,Northeast,Eastern,4,2,4,1.0,4,0,2,2
2012-13,2013-01-25,Buffalo Sabres,0,Northeast,Eastern,4,2,6,0.6666666666666666,6,-2,4,0
2012-13,2013-01-26,Buffalo Sabres,0,Northeast,Eastern,4,2,8,0.5,7,-3,4,0
2012-13,2013-01-27,Buffalo Sabres,0,Northeast,Eastern,4,2,10,0.4,7,-3,4,0
2012-13,2013-01-30,Buffalo Sabres,1,Northeast,Eastern,5,2,12,0.4166666666666667,11,-6,6,-1
2012-13,2013-02-01,Buffalo Sabres,2,Northeast,Eastern,7,2,14,0.5,11,-4,8,-1
2012-13,2013-02-02,Buffalo Sabres,0,Northeast,Eastern,7,2,16,0.4375,11,-4,8,-1
2012-13,2013-02-03,Buffalo Sabres,0,Northeast,Eastern,7,2,18,0.3888888888888889,13,-6,8,-1
2012-13,2013-02-06,Buffalo Sabres,0,Northeast,Eastern,7,2,20,0.35,13,-6,9,-2
2012-13,2013-02-08,Buffalo Sabres,2,Northeast,Eastern,9,2,22,0.4090909090909091,15,-6,10,-1
2012-13,2013-02-10,Buffalo Sabres,2,Northeast,Eastern,11,2,24,0.4583333333333333,15,-4,11,0
2012-13,2013-02-11,Buffalo Sabres,0,Northeast,Eastern,11,2,26,0.4230769230769231,17,-6,12,-1
2012-13,2013-02-13,Buffalo Sabres,0,Northeast,Eastern,11,2,28,0.39285714285714285,18,-7,14,-3
2012-13,2013-02-16,Buffalo Sabres,2,Northeast,Eastern,13,2,30,0.43333333333333335,18,-5,15,-2
2012-13,2013-02-17,Buffalo Sabres,0,Northeast,Eastern,13,2,32,0.40625,20,-7,16,-3
2012-13,2013-02-20,Buffalo Sabres,0,Northeast,Eastern,13,2,34,0.38235294117647056,23,-10,17,-4
2012-13,2013-02-22,Buffalo Sabres,0,Northeast,Eastern,13,2,36,0.3611111111111111,24,-11,17,-4
2012-13,2013-02-24,Buffalo Sabres,0,Northeast,Eastern,13,2,38,0.34210526315789475,26,-13,19,-6
2012-13,2013-02-27,Buffalo Sabres,2,Northeast,Eastern,15,2,40,0.375,27,-12,19,-4
2012-13,2013-03-01,Buffalo Sabres,2,Northeast,Eastern,17,2,42,0.40476190476190477,29,-12,21,-4
2012-13,2013-03-02,Buffalo Sabres,2,Northeast,Eastern,19,2,44,0.4318181818181818,30,-11,21,-2
2012-13,2013-03-04,Buffalo Sabres,1,Northeast,Eastern,20,2,46,0.43478260869565216,32,-12,23,-3
2012-13,2013-03-06,Buffalo Sabres,0,Northeast,Eastern,20,2,48,0.4166666666666667,32,-12,24,-4
2012-13,2013-03-08,Buffalo Sabres,1,Northeast,Eastern,21,2,50,0.42,34,-13,26,-5
2012-13,2013-03-10,Buffalo Sabres,0,Northeast,Eastern,21,2,52,0.40384615384615385,36,-15,28,-7
2012-13,2013-03-12,Buffalo Sabres,2,Northeast,Eastern,23,2,54,0.42592592592592593,38,-15,28,-5
2012-13,2013-03-16,Buffalo Sabres,1,Northeast,Eastern,24,2,56,0.42857142857142855,42,-18,31,-7
2012-13,2013-03-17,Buffalo Sabres,0,Northeast,Eastern,24,2,58,0.41379310344827586,42,-18,31,-7
2012-13,2013-03-19,Buffalo Sabres,2,Northeast,Eastern,26,2,60,0.43333333333333335,43,-17,32,-6
2012-13,2013-03-21,Buffalo Sabres,2,Northeast,Eastern,28,2,62,0.45161290322580644,45,-17,32,-4
2012-13,2013-03-23,Buffalo Sabres,2,Northeast,Eastern,30,2,64,0.46875,45,-15,32,-2
2012-13,2013-03-26,Buffalo Sabres,0,Northeast,Eastern,30,2,66,0.45454545454545453,45,-15,35,-5
2012-13,2013-03-28,Buffalo Sabres,1,Northeast,Eastern,31,2,68,0.45588235294117646,47,-16,35,-4
2012-13,2013-03-30,Buffalo Sabres,1,Northeast,Eastern,32,2,70,0.45714285714285713,49,-17,35,-3
2012-13,2013-03-31,Buffalo Sabres,0,Northeast,Eastern,32,2,72,0.4444444444444444,49,-17,35,-3
2012-13,2013-04-02,Buffalo Sabres,2,Northeast,Eastern,34,2,74,0.4594594594594595,51,-17,38,-4
2012-13,2013-04-05,Buffalo Sabres,2,Northeast,Eastern,36,2,76,0.47368421052631576,53,-17,39,-3
2012-13,2013-04-07,Buffalo Sabres,2,Northeast,Eastern,38,2,78,0.48717948717948717,55,-17,42,-4
2012-13,2013-04-10,Buffalo Sabres,0,Northeast,Eastern,38,2,80,0.475,56,-18,44,-6
2012-13,2013-04-11,Buffalo Sabres,0,Northeast,Eastern,38,2,82,0.4634146341463415,57,-19,44,-6
2012-13,2013-04-13,Buffalo Sabres,2,Northeast,Eastern,40,2,84,0.47619047619047616,57,-17,46,-6
2012-13,2013-04-14,Buffalo Sabres,2,Northeast,Eastern,42,2,86,0.4883720930232558,57,-15,46,-4
2012-13,2013-04-17,Buffalo Sabres,2,Northeast,Eastern,44,2,88,0.5,57,-13,46,-2
2012-13,2013-04-19,Buffalo Sabres,0,Northeast,Eastern,44,2,90,0.4888888888888889,59,-15,50,-6
2012-13,2013-04-22,Buffalo Sabres,0,Northeast,Eastern,44,2,92,0.4782608695652174,59,-15,52,-8
2012-13,2013-04-23,Buffalo Sabres,2,Northeast,Eastern,46,2,94,0.48936170212765956,59,-13,52,-6
2012-13,2013-04-26,Buffalo Sabres,2,Northeast,Eastern,48,2,96,0.5,61,-13,54,-6
2012-13,2013-01-20,Calgary Flames,0,Northwest,Western,0,2,2,0.0,2,-2,1,-1
2012-13,2013-01-22,Calgary Flames,0,Northwest,Western,0,2,4,0.0,4,-4,2,-2
2012-13,2013-01-24,Calgary Flames,1,Northwest,Western,1,2,6,0.16666666666666666,4,-3,3,-2
2012-13,2013-01-27,Calgary Flames,2,Northwest,Western,3,2,8,0.375,5,-2,4,-1
2012-13,2013-02-01,Calgary Flames,0,Northwest,Western,3,2,10,0.3,9,-6,7,-4
2012-13,2013-02-03,Calgary Flames,1,Northwest,Western,4,2,12,0.3333333333333333,10,-6,9,-5
2012-13,2013-02-06,Calgary Flames,2,Northwest,Western,6,2,14,0.42857142857142855,12,-6,10,-4
2012-13,2013-02-08,Calgary Flames,2,Northwest,Western,8,2,16,0.5,14,-6,11,-3
2012-13,2013-02-10,Calgary Flames,0,Northwest,Western,8,2,18,0.4444444444444444,16,-8,13,-5
2012-13,2013-02-12,Calgary Flames,1,Northwest,Western,9,2,20,0.45,16,-7,13,-4
2012-13,2013-02-14,Calgary Flames,2,Northwest,Western,11,2,22,0.5,18,-7,15,-4
2012-13,2013-02-16,Calgary Flames,0,Northwest,Western,11,2,24,0.4583333333333333,18,-7,16,-5
2012-13,2013-02-17,Calgary Flames,2,Northwest,Western,13,2,26,0.5,18,-5,16,-3
2012-13,2013-02-19,Calgary Flames,0,Northwest,Western,13,2,28,0.4642857142857143,19,-6,17,-4
2012-13,2013-02-21,Calgary Flames,0,Northwest,Western,13,2,30,0.43333333333333335,20,-7,17,-4
2012-13,2013-02-24,Calgary Flames,2,Northwest,Western,15,2,32,0.46875,24,-9,19,-4
2012-13,2013-02-25,Calgary Flames,2,Northwest,Western,17,2,34,0.5,24,-7,19,-2
2012-13,2013-02-27,Calgary Flames,1,Northwest,Western,18,2,36,0.5,24,-6,21,-3
2012-13,2013-03-01,Calgary Flames,0,Northwest,Western,18,2,38,0.47368421052631576,24,-6,22,-4
2012-13,2013-03-04,Calgary Flames,2,Northwest,Western,20,2,40,0.5,26,-6,24,-4
2012-13,2013-03-07,Calgary Flames,2,Northwest,Western,22,2,42,0.5238095238095238,27,-5,24,-2
2012-13,2013-03-09,Calgary Flames,0,Northwest,Western,22,2,44,0.5,28,-6,26,-4
2012-13,2013-03-10,Calgary Flames,0,Northwest,Western,22,2,46,0.4782608695652174,28,-6,27,-5
2012-13,2013-03-12,Calgary Flames,0,Northwest,Western,22,2,48,0.4583333333333333,30,-8,28,-6
2012-13,2013-03-14,Calgary Flames,2,Northwest,Western,24,2,50,0.48,30,-6,28,-4
2012-13,2013-03-16,Calgary Flames,2,Northwest,Western,26,2,52,0.5,32,-6,30,-4
2012-13,2013-03-19,Calgary Flames,0,Northwest,Western,26,2,54,0.48148148148148145,34,-8,30,-4
2012-13,2013-03-22,Calgary Flames,0,Northwest,Western,26,2,56,0.4642857142857143,36,-10,32,-6
2012-13,2013-03-22,Calgary Flames,0,Northwest,Western,26,2,58,0.4482758620689655,36,-10,32,-6
2012-13,2013-03-25,Calgary Flames,2,Northwest,Western,28,2,60,0.4666666666666667,40,-12,33,-5
2012-13,2013-03-27,Calgary Flames,0,Northwest,Western,28,2,62,0.45161290322580644,42,-14,34,-6
2012-13,2013-03-28,Calgary Flames,2,Northwest,Western,30,2,64,0.46875,42,-12,36,-6
2012-13,2013-03-30,Calgary Flames,0,Northwest,Western,30,2,66,0.45454545454545453,44,-14,36,-6
2012-13,2013-04-02,Calgary Flames,0,Northwest,Western,30,2,68,0.4411764705882353,44,-14,38,-8
2012-13,2013-04-04,Calgary Flames,0,Northwest,Western,30,2,70,0.42857142857142855,44,-14,39,-9
2012-13,2013-04-06,Calgary Flames,0,Northwest,Western,30,2,72,0.4166666666666667,46,-16,42,-12
2012-13,2013-04-07,Calgary Flames,0,Northwest,Western,30,2,74,0.40540540540540543,48,-18,43,-13
2012-13,2013-04-09,Calgary Flames,2,Northwest,Western,32,2,76,0.42105263157894735,50,-18,43,-11
2012-13,2013-04-11,Calgary Flames,0,Northwest,Western,32,2,78,0.41025641025641024,52,-20,44,-12
2012-13,2013-04-13,Calgary Flames,2,Northwest,Western,34,2,80,0.425,52,-18,45,-11
2012-13,2013-04-14,Calgary Flames,2,Northwest,Western,36,2,82,0.43902439024390244,52,-16,47,-11
2012-13,2013-04-16,Calgary Flames,0,Northwest,Western,36,2,84,0.42857142857142855,54,-18,47,-11
2012-13,2013-04-18,Calgary Flames,2,Northwest,Western,38,2,86,0.4418604651162791,55,-17,49,-11
2012-13,2013-04-20,Calgary Flames,2,Northwest,Western,40,2,88,0.45454545454545453,55,-15,49,-9
2012-13,2013-04-21,Calgary Flames,2,Northwest,Western,42,2,90,0.4666666666666667,57,-15,49,-7
2012-13,2013-04-24,Calgary Flames,0,Northwest,Western,42,2,92,0.45652173913043476,59,-17,52,-10
2012-13,2013-04-26,Calgary Flames,0,Northwest,Western,42,2,94,0.44680851063829785,59,-17,53,-11
2012-13,2013-04-27,Calgary Flames,0,Northwest,Western,42,2,96,0.4375,59,-17,55,-13
2012-13,2013-01-20,Carolina Hurricanes,0,Southeast,Eastern,0,2,2,0.0,2,-2,2,-2
2012-13,2013-01-23,Carolina Hurricanes,0,Southeast,Eastern,0,2,4,0.0,4,-4,2,-2
2012-13,2013-01-25,Carolina Hurricanes,2,Southeast,Eastern,2,2,6,0.3333333333333333,4,-2,4,-2
2012-13,2013-01-26,Carolina Hurricanes,2,Southeast,Eastern,4,2,8,0.5,6,-2,4,0
2012-13,2013-01-29,Carolina Hurricanes,0,Southeast,Eastern,4,2,10,0.4,8,-4,5,-1
2012-13,2013-02-02,Carolina Hurricanes,2,Southeast,Eastern,6,2,12,0.5,12,-6,8,-2
2012-13,2013-02-03,Carolina Hurricanes,0,Southeast,Eastern,6,2,14,0.42857142857142855,12,-6,8,-2
2012-13,2013-02-05,Carolina Hurricanes,2,Southeast,Eastern,8,2,16,0.5,12,-4,8,0
2012-13,2013-02-08,Carolina Hurricanes,2,Southeast,Eastern,10,2,18,0.5555555555555556,12,-2,10,0
2012-13,2013-02-09,Carolina Hurricanes,1,Southeast,Eastern,11,2,20,0.55,12,-1,11,0
2012-13,2013-02-12,Carolina Hurricanes,2,Southeast,Eastern,13,2,22,0.5909090909090909,13,0,12,1
2012-13,2013-02-13,Carolina Hurricanes,2,Southeast,Eastern,15,2,24,0.625,15,0,14,1
2012-13,2013-02-15,Carolina Hurricanes,2,Southeast,Eastern,17,2,26,0.6538461538461539,17,0,15,2
2012-13,2013-02-19,Carolina Hurricanes,0,Southeast,Eastern,17,2,28,0.6071428571428571,17,0,17,0
2012-13,2013-02-22,Carolina Hurricanes,0,Southeast,Eastern,17,2,30,0.5666666666666667,17,0,17,0
2012-13,2013-02-24,Carolina Hurricanes,0,Southeast,Eastern,17,2,32,0.53125,19,-2,19,-2
2012-13,2013-02-25,Carolina Hurricanes,2,Southeast,Eastern,19,2,34,0.5588235294117647,19,0,19,0
2012-13,2013-02-27,Carolina Hurricanes,0,Southeast,Eastern,19,2,36,0.5277777777777778,19,0,19,0
2012-13,2013-03-01,Carolina Hurricanes,2,Southeast,Eastern,21,2,38,0.5526315789473685,21,0,21,0
2012-13,2013-03-03,Carolina Hurricanes,2,Southeast,Eastern,23,2,40,0.575,25,-2,23,0
2012-13,2013-03-03,Carolina Hurricanes,2,Southeast,Eastern,25,2,42,0.5952380952380952,25,0,23,2
2012-13,2013-03-06,Carolina Hurricanes,2,Southeast,Eastern,27,2,44,0.6136363636363636,27,0,24,3
2012-13,2013-03-08,Carolina Hurricanes,0,Southeast,Eastern,27,2,46,0.5869565217391305,27,0,26,1
2012-13,2013-03-10,Carolina Hurricanes,2,Southeast,Eastern,29,2,48,0.6041666666666666,29,0,28,1
2012-13,2013-03-12,Carolina Hurricanes,2,Southeast,Eastern,31,2,50,0.62,31,0,28,3
2012-13,2013-03-14,Carolina Hurricanes,0,Southeast,Eastern,31,2,52,0.5961538461538461,31,0,28,3
2012-13,2013-03-16,Carolina Hurricanes,0,Southeast,Eastern,31,2,54,0.5740740740740741,32,-1,31,0
2012-13,2013-03-18,Carolina Hurricanes,1,Southeast,Eastern,32,2,56,0.5714285714285714,32,0,32,0
2012-13,2013-03-19,Carolina Hurricanes,0,Southeast,Eastern,32,2,58,0.5517241379310345,32,0,32,0
2012-13,2013-03-21,Carolina Hurricanes,0,Southeast,Eastern,32,2,60,0.5333333333333333,34,-2,32,0
2012-13,2013-03-26,Carolina Hurricanes,0,Southeast,Eastern,32,2,62,0.5161290322580645,38,-6,35,-3
2012-13,2013-03-28,Carolina Hurricanes,0,Southeast,Eastern,32,2,64,0.5,38,-6,35,-3
2012-13,2013-03-30,Carolina Hurricanes,2,Southeast,Eastern,34,2,66,0.5151515151515151,38,-4,35,-1
2012-13,2013-04-01,Carolina Hurricanes,0,Southeast,Eastern,34,2,68,0.5,38,-4,37,-3
2012-13,2013-04-02,Carolina Hurricanes,0,Southeast,Eastern,34,2,70,0.4857142857142857,38,-4,38,-4
2012-13,2013-04-04,Carolina Hurricanes,0,Southeast,Eastern,34,2,72,0.4722222222222222,38,-4,39,-5
2012-13,2013-04-06,Carolina Hurricanes,0,Southeast,Eastern,34,2,74,0.4594594594594595,40,-6,40,-6
2012-13,2013-04-08,Carolina Hurricanes,0,Southeast,Eastern,34,2,76,0.4473684210526316,42,-8,42,-8
2012-13,2013-04-09,Carolina Hurricanes,0,Southeast,Eastern,34,2,78,0.4358974358974359,44,-10,42,-8
2012-13,2013-04-11,Carolina Hurricanes,0,Southeast,Eastern,34,2,80,0.425,46,-12,44,-10
2012-13,2013-04-13,Carolina Hurricanes,2,Southeast,Eastern,36,2,82,0.43902439024390244,48,-12,46,-10
2012-13,2013-04-16,Carolina Hurricanes,0,Southeast,Eastern,36,2,84,0.42857142857142855,50,-14,46,-10
2012-13,2013-04-19,Carolina Hurricanes,1,Southeast,Eastern,37,2,86,0.43023255813953487,50,-13,50,-13
2012-13,2013-04-20,Carolina Hurricanes,0,Southeast,Eastern,37,2,88,0.42045454545454547,52,-15,50,-13
2012-13,2013-04-21,Carolina Hurricanes,2,Southeast,Eastern,39,2,90,0.43333333333333335,52,-13,52,-13
2012-13,2013-04-23,Carolina Hurricanes,2,Southeast,Eastern,41,2,92,0.44565217391304346,54,-13,52,-11
2012-13,2013-04-25,Carolina Hurricanes,1,Southeast,Eastern,42,2,94,0.44680851063829785,55,-13,54,-12
2012-13,2013-04-27,Carolina Hurricanes,0,Southeast,Eastern,42,2,96,0.4375,57,-15,54,-12
2012-13,2013-01-19,Chicago Blackhawks,2,Central,Western,2,2,2,1.0,2,0,0,2
2012-13,2013-01-21,Chicago Blackhawks,2,Central,Western,4,2,4,1.0,4,0,2,2
2012-13,2013-01-23,Chicago Blackhawks,2,Central,Western,6,2,6,1.0,6,0,3,3
2012-13,2013-01-25,Chicago Blackhawks,2,Central,Western,8,2,8,1.0,8,0,4,4
2012-13,2013-01-27,Chicago Blackhawks,2,Central,Western,10,2,10,1.0,10,0,4,6
2012-13,2013-01-28,Chicago Blackhawks,2,Central,Western,12,2,12,1.0,12,0,5,7
2012-13,2013-01-31,Chicago Blackhawks,1,Central,Western,13,2,14,0.9285714285714286,13,0,7,6
2012-13,2013-02-02,Chicago Blackhawks,1,Central,Western,14,2,16,0.875,14,0,9,5
2012-13,2013-02-03,Chicago Blackhawks,2,Central,Western,16,2,18,0.8888888888888888,16,0,9,7
2012-13,2013-02-06,Chicago Blackhawks,2,Central,Western,18,2,20,0.9,18,0,10,8
2012-13,2013-02-08,Chicago Blackhawks,2,Central,Western,20,2,22,0.9090909090909091,20,0,11,9
2012-13,2013-02-11,Chicago Blackhawks,2,Central,Western,22,2,24,0.9166666666666666,22,0,13,9
2012-13,2013-02-13,Chicago Blackhawks,1,Central,Western,23,2,26,0.8846153846153846,23,0,14,9
2012-13,2013-02-16,Chicago Blackhawks,2,Central,Western,25,2,28,0.8928571428571429,25,0,16,9
2012-13,2013-02-17,Chicago Blackhawks,2,Central,Western,27,2,30,0.9,27,0,16,11
2012-13,2013-02-20,Chicago Blackhawks,2,Central,Western,29,2,32,0.90625,29,0,17,12
2012-13,2013-02-23,Chicago Blackhawks,2,Central,Western,31,2,34,0.9117647058823529,31,0,18,13
2012-13,2013-02-25,Chicago Blackhawks,2,Central,Western,33,2,36,0.9166666666666666,33,0,19,14
2012-13,2013-02-26,Chicago Blackhawks,2,Central,Western,35,2,38,0.9210526315789473,35,0,20,15
2012-13,2013-03-01,Chicago Blackhawks,2,Central,Western,37,2,40,0.925,37,0,22,15
2012-13,2013-03-02,Chicago Blackhawks,2,Central,Western,39,2,42,0.9285714285714286,39,0,22,17
2012-13,2013-03-03,Chicago Blackhawks,2,Central,Western,41,2,44,0.9318181818181818,41,0,23,18
2012-13,2013-03-06,Chicago Blackhawks,2,Central,Western,43,2,46,0.9347826086956522,43,0,24,19
2012-13,2013-03-07,Chicago Blackhawks,2,Central,Western,45,2,48,0.9375,45,0,24,21
2012-13,2013-03-09,Chicago Blackhawks,0,Central,Western,45,2,50,0.9,45,0,26,19
2012-13,2013-03-10,Chicago Blackhawks,0,Central,Western,45,2,52,0.8653846153846154,45,0,27,18
2012-13,2013-03-14,Chicago Blackhawks,2,Central,Western,47,2,54,0.8703703703703703,47,0,28,19
2012-13,2013-03-17,Chicago Blackhawks,2,Central,Western,49,2,56,0.875,49,0,30,19
2012-13,2013-03-19,Chicago Blackhawks,2,Central,Western,51,2,58,0.8793103448275862,51,0,30,21
2012-13,2013-03-21,Chicago Blackhawks,0,Central,Western,51,2,60,0.85,51,0,32,19
2012-13,2013-03-26,Chicago Blackhawks,0,Central,Western,51,2,62,0.8225806451612904,51,0,34,17
2012-13,2013-03-27,Chicago Blackhawks,2,Central,Western,53,2,64,0.828125,53,0,34,19
2012-13,2013-03-30,Chicago Blackhawks,0,Central,Western,53,2,66,0.803030303030303,53,0,36,17
2012-13,2013-03-31,Chicago Blackhawks,2,Central,Western,55,2,68,0.8088235294117647,55,0,37,18
2012-13,2013-04-02,Chicago Blackhawks,2,Central,Western,57,2,70,0.8142857142857143,57,0,38,19
2012-13,2013-04-05,Chicago Blackhawks,1,Central,Western,58,2,72,0.8055555555555556,58,0,40,18
2012-13,2013-04-06,Chicago Blackhawks,2,Central,Western,60,2,74,0.8108108108108109,60,0,42,18
2012-13,2013-04-07,Chicago Blackhawks,2,Central,Western,62,2,76,0.8157894736842105,62,0,43,19
2012-13,2013-04-10,Chicago Blackhawks,2,Central,Western,64,2,78,0.8205128205128205,64,0,43,21
2012-13,2013-04-13,Chicago Blackhawks,2,Central,Western,66,2,80,0.825,66,0,45,21
2012-13,2013-04-14,Chicago Blackhawks,2,Central,Western,68,2,82,0.8292682926829268,68,0,47,21
2012-13,2013-04-16,Chicago Blackhawks,2,Central,Western,70,2,84,0.8333333333333334,70,0,47,23
2012-13,2013-04-20,Chicago Blackhawks,2,Central,Western,72,2,86,0.8372093023255814,72,0,49,23
2012-13,2013-04-21,Chicago Blackhawks,1,Central,Western,73,2,88,0.8295454545454546,73,0,49,24
2012-13,2013-04-23,Chicago Blackhawks,0,Central,Western,73,2,90,0.8111111111111111,73,0,51,22
2012-13,2013-04-25,Chicago Blackhawks,2,Central,Western,75,2,92,0.8152173913043478,75,0,53,22
2012-13,2013-04-27,Chicago Blackhawks,2,Central,Western,77,2,94,0.8191489361702128,77,0,55,22
2012-13,2013-04-28,Chicago Blackhawks,0,Central,Western,77,2,96,0.8020833333333334,77,0,55,22
2012-13,2013-01-20,Colorado Avalanche,0,Northwest,Western,0,2,2,0.0,2,-2,1,-1
2012-13,2013-01-22,Colorado Avalanche,2,Northwest,Western,2,2,4,0.5,4,-2,2,0
2012-13,2013-01-25,Colorado Avalanche,2,Northwest,Western,4,2,6,0.6666666666666666,4,0,4,0
2012-13,2013-01-26,Colorado Avalanche,0,Northwest,Western,4,2,8,0.5,5,-1,4,0
2012-13,2013-01-29,Colorado Avalanche,0,Northwest,Western,4,2,10,0.4,6,-2,5,-1
2012-13,2013-01-31,Colorado Avalanche,0,Northwest,Western,4,2,12,0.3333333333333333,9,-5,7,-3
2012-13,2013-02-01,Colorado Avalanche,2,Northwest,Western,6,2,14,0.42857142857142855,9,-3,7,-1
2012-13,2013-02-02,Colorado Avalanche,2,Northwest,Western,8,2,16,0.5,10,-2,9,-1
2012-13,2013-02-05,Colorado Avalanche,0,Northwest,Western,8,2,18,0.4444444444444444,12,-4,9,-1
2012-13,2013-02-07,Colorado Avalanche,0,Northwest,Western,8,2,20,0.4,12,-4,11,-3
2012-13,2013-02-12,Colorado Avalanche,1,Northwest,Western,9,2,22,0.4090909090909091,16,-7,13,-4
2012-13,2013-02-15,Colorado Avalanche,2,Northwest,Western,11,2,24,0.4583333333333333,18,-7,15,-4
2012-13,2013-02-17,Colorado Avalanche,0,Northwest,Western,11,2,26,0.4230769230769231,18,-7,16,-5
2012-13,2013-02-18,Colorado Avalanche,2,Northwest,Western,13,2,28,0.4642857142857143,19,-6,16,-3
2012-13,2013-02-21,Colorado Avalanche,2,Northwest,Western,15,2,30,0.5,20,-5,17,-2
2012-13,2013-02-23,Colorado Avalanche,0,Northwest,Western,15,2,32,0.46875,24,-9,18,-3
2012-13,2013-02-25,Colorado Avalanche,1,Northwest,Western,16,2,34,0.47058823529411764,24,-8,19,-3
2012-13,2013-02-27,Colorado Avalanche,1,Northwest,Western,17,2,36,0.4722222222222222,24,-7,21,-4
2012-13,2013-03-01,Colorado Avalanche,2,Northwest,Western,19,2,38,0.5,24,-5,22,-3
2012-13,2013-03-03,Colorado Avalanche,1,Northwest,Western,20,2,40,0.5,26,-6,23,-3
2012-13,2013-03-06,Colorado Avalanche,0,Northwest,Western,20,2,42,0.47619047619047616,27,-7,24,-4
2012-13,2013-03-07,Colorado Avalanche,0,Northwest,Western,20,2,44,0.45454545454545453,27,-7,24,-4
2012-13,2013-03-09,Colorado Avalanche,2,Northwest,Western,22,2,46,0.4782608695652174,28,-6,26,-4
2012-13,2013-03-11,Colorado Avalanche,2,Northwest,Western,24,2,48,0.5,28,-4,28,-4
2012-13,2013-03-13,Colorado Avalanche,0,Northwest,Western,24,2,50,0.48,30,-6,28,-4
2012-13,2013-03-15,Colorado Avalanche,0,Northwest,Western,24,2,52,0.46153846153846156,32,-8,29,-5
2012-13,2013-03-16,Colorado Avalanche,0,Northwest,Western,24,2,54,0.4444444444444444,32,-8,30,-6
2012-13,2013-03-19,Colorado Avalanche,0,Northwest,Western,24,2,56,0.42857142857142855,34,-10,30,-6
2012-13,2013-03-21,Colorado Avalanche,2,Northwest,Western,26,2,58,0.4482758620689655,36,-10,32,-6
2012-13,2013-03-24,Colorado Avalanche,0,Northwest,Western,26,2,60,0.43333333333333335,38,-12,33,-7
2012-13,2013-03-25,Colorado Avalanche,0,Northwest,Western,26,2,62,0.41935483870967744,40,-14,33,-7
2012-13,2013-03-28,Colorado Avalanche,0,Northwest,Western,26,2,64,0.40625,42,-16,36,-10
2012-13,2013-03-29,Colorado Avalanche,0,Northwest,Western,26,2,66,0.3939393939393939,44,-18,36,-10
2012-13,2013-03-30,Colorado Avalanche,2,Northwest,Western,28,2,68,0.4117647058823529,44,-16,36,-8
2012-13,2013-04-01,Colorado Avalanche,0,Northwest,Western,28,2,70,0.4,44,-16,37,-9
2012-13,2013-04-03,Colorado Avalanche,0,Northwest,Western,28,2,72,0.3888888888888889,44,-16,38,-10
2012-13,2013-04-06,Colorado Avalanche,1,Northwest,Western,29,2,74,0.3918918918918919,46,-17,42,-13
2012-13,2013-04-07,Colorado Avalanche,0,Northwest,Western,29,2,76,0.3815789473684211,48,-19,43,-14
2012-13,2013-04-09,Colorado Avalanche,0,Northwest,Western,29,2,78,0.3717948717948718,50,-21,43,-14
2012-13,2013-04-11,Colorado Avalanche,2,Northwest,Western,31,2,80,0.3875,52,-21,44,-13
2012-13,2013-04-12,Colorado Avalanche,1,Northwest,Western,32,2,82,0.3902439024390244,52,-20,44,-12
2012-13,2013-04-13,Colorado Avalanche,2,Northwest,Western,34,2,84,0.40476190476190477,52,-18,45,-11
2012-13,2013-04-16,Colorado Avalanche,1,Northwest,Western,35,2,86,0.4069767441860465,54,-19,47,-12
2012-13,2013-04-20,Colorado Avalanche,0,Northwest,Western,35,2,88,0.3977272727272727,55,-20,49,-14
2012-13,2013-04-22,Colorado Avalanche,2,Northwest,Western,37,2,90,0.4111111111111111,57,-20,51,-14
2012-13,2013-04-24,Colorado Avalanche,0,Northwest,Western,37,2,92,0.40217391304347827,59,-22,52,-15
2012-13,2013-04-27,Colorado Avalanche,2,Northwest,Western,39,2,94,0.4148936170212766,59,-20,55,-16
2012-13,2013-04-27,Colorado Avalanche,0,Northwest,Western,39,2,96,0.40625,59,-20,55,-16
2012-13,2013-01-20,Columbus Blue Jackets,2,Central,Western,2,2,2,1.0,2,0,1,1
2012-13,2013-01-22,Columbus Blue Jackets,1,Central,Western,3,2,4,0.75,4,-1,2,1
2012-13,2013-01-24,Columbus Blue Jackets,0,Central,Western,3,2,6,0.5,6,-3,3,0
2012-13,2013-01-25,Columbus Blue Jackets,0,Central,Western,3,2,8,0.375,8,-5,4,-1
2012-13,2013-01-27,Columbus Blue Jackets,0,Central,Western,3,2,10,0.3,10,-7,4,-1
2012-13,2013-01-29,Columbus Blue Jackets,2,Central,Western,5,2,12,0.4166666666666667,12,-7,5,0
2012-13,2013-01-30,Columbus Blue Jackets,0,Central,Western,5,2,14,0.35714285714285715,12,-7,6,-1
2012-13,2013-02-01,Columbus Blue Jackets,0,Central,Western,5,2,16,0.3125,13,-8,7,-2
2012-13,2013-02-03,Columbus Blue Jackets,2,Central,Western,7,2,18,0.3888888888888889,16,-9,9,-2
2012-13,2013-02-06,Columbus Blue Jackets,0,Central,Western,7,2,20,0.35,18,-11,10,-3
2012-13,2013-02-08,Columbus Blue Jackets,1,Central,Western,8,2,22,0.36363636363636365,20,-12,11,-3
2012-13,2013-02-10,Columbus Blue Jackets,0,Central,Western,8,2,24,0.3333333333333333,20,-12,13,-5
2012-13,2013-02-12,Columbus Blue Jackets,2,Central,Western,10,2,26,0.38461538461538464,22,-12,13,-3
2012-13,2013-02-16,Columbus Blue Jackets,0,Central,Western,10,2,28,0.35714285714285715,25,-15,16,-6
2012-13,2013-02-17,Columbus Blue Jackets,0,Central,Western,10,2,30,0.3333333333333333,27,-17,16,-6
2012-13,2013-02-19,Columbus Blue Jackets,0,Central,Western,10,2,32,0.3125,27,-17,17,-7
2012-13,2013-02-22,Columbus Blue Jackets,2,Central,Western,12,2,34,0.35294117647058826,29,-17,18,-6
2012-13,2013-02-24,Columbus Blue Jackets,0,Central,Western,12,2,36,0.3333333333333333,31,-19,19,-7
2012-13,2013-02-25,Columbus Blue Jackets,0,Central,Western,12,2,38,0.3157894736842105,33,-21,19,-7
2012-13,2013-02-27,Columbus Blue Jackets,1,Central,Western,13,2,40,0.325,35,-22,21,-8
2012-13,2013-03-02,Columbus Blue Jackets,1,Central,Western,14,2,42,0.3333333333333333,39,-25,22,-8
2012-13,2013-03-03,Columbus Blue Jackets,2,Central,Western,16,2,44,0.36363636363636365,41,-25,23,-7
2012-13,2013-03-06,Columbus Blue Jackets,2,Central,Western,18,2,46,0.391304347826087,43,-25,24,-6
2012-13,2013-03-08,Columbus Blue Jackets,2,Central,Western,20,2,48,0.4166666666666667,45,-25,26,-6
2012-13,2013-03-09,Columbus Blue Jackets,2,Central,Western,22,2,50,0.44,45,-23,26,-4
2012-13,2013-03-10,Columbus Blue Jackets,2,Central,Western,24,2,52,0.46153846153846156,45,-21,27,-3
2012-13,2013-03-12,Columbus Blue Jackets,1,Central,Western,25,2,54,0.46296296296296297,45,-20,28,-3
2012-13,2013-03-14,Columbus Blue Jackets,1,Central,Western,26,2,56,0.4642857142857143,47,-21,28,-2
2012-13,2013-03-16,Columbus Blue Jackets,2,Central,Western,28,2,58,0.4827586206896552,47,-19,30,-2
2012-13,2013-03-19,Columbus Blue Jackets,2,Central,Western,30,2,60,0.5,51,-21,30,0
2012-13,2013-03-22,Columbus Blue Jackets,2,Central,Western,32,2,62,0.5161290322580645,51,-19,32,0
2012-13,2013-03-24,Columbus Blue Jackets,0,Central,Western,32,2,64,0.5,51,-19,33,-1
2012-13,2013-03-27,Columbus Blue Jackets,1,Central,Western,33,2,66,0.5,53,-20,34,-1
2012-13,2013-03-29,Columbus Blue Jackets,0,Central,Western,33,2,68,0.4852941176470588,53,-20,36,-3
2012-13,2013-03-30,Columbus Blue Jackets,2,Central,Western,35,2,70,0.5,53,-18,36,-1
2012-13,2013-03-31,Columbus Blue Jackets,2,Central,Western,37,2,72,0.5138888888888888,55,-18,37,0
2012-13,2013-04-05,Columbus Blue Jackets,2,Central,Western,39,2,74,0.527027027027027,58,-19,40,-1
2012-13,2013-04-06,Columbus Blue Jackets,0,Central,Western,39,2,76,0.5131578947368421,60,-21,42,-3
2012-13,2013-04-07,Columbus Blue Jackets,0,Central,Western,39,2,78,0.5,62,-23,43,-4
2012-13,2013-04-09,Columbus Blue Jackets,2,Central,Western,41,2,80,0.5125,62,-21,43,-2
2012-13,2013-04-12,Columbus Blue Jackets,2,Central,Western,43,2,82,0.524390243902439,64,-21,44,-1
2012-13,2013-04-14,Columbus Blue Jackets,2,Central,Western,45,2,84,0.5357142857142857,68,-23,47,-2
2012-13,2013-04-16,Columbus Blue Jackets,2,Central,Western,47,2,86,0.5465116279069767,70,-23,47,0
2012-13,2013-04-18,Columbus Blue Jackets,2,Central,Western,49,2,88,0.5568181818181818,70,-21,49,0
2012-13,2013-04-19,Columbus Blue Jackets,0,Central,Western,49,2,90,0.5444444444444444,70,-21,49,0
2012-13,2013-04-22,Columbus Blue Jackets,2,Central,Western,51,2,92,0.5543478260869565,73,-22,51,0
2012-13,2013-04-26,Columbus Blue Jackets,2,Central,Western,53,2,94,0.5638297872340425,75,-22,53,0
2012-13,2013-04-27,Columbus Blue Jackets,2,Central,Western,55,2,96,0.5729166666666666,77,-22,55,0
2012-13,2013-01-20,Dallas Stars,2,Pacific,Western,2,2,2,1.0,2,0,1,1
2012-13,2013-01-21,Dallas Stars,0,Pacific,Western,2,2,4,0.5,2,0,2,0
2012-13,2013-01-23,Dallas Stars,2,Pacific,Western,4,2,6,0.6666666666666666,4,0,3,1
2012-13,2013-01-25,Dallas Stars,1,Pacific,Western,5,2,8,0.625,6,-1,4,1
2012-13,2013-01-27,Dallas Stars,0,Pacific,Western,5,2,10,0.5,8,-3,4,1
2012-13,2013-01-29,Dallas Stars,0,Pacific,Western,5,2,12,0.4166666666666667,10,-5,5,0
2012-13,2013-01-30,Dallas Stars,0,Pacific,Western,5,2,14,0.35714285714285715,12,-7,6,-1
2012-13,2013-02-02,Dallas Stars,2,Pacific,Western,7,2,16,0.4375,14,-7,9,-2
2012-13,2013-02-03,Dallas Stars,0,Pacific,Western,7,2,18,0.3888888888888889,15,-8,9,-2
2012-13,2013-02-05,Dallas Stars,2,Pacific,Western,9,2,20,0.45,15,-6,9,0
2012-13,2013-02-07,Dallas Stars,2,Pacific,Western,11,2,22,0.5,15,-4,11,0
2012-13,2013-02-09,Dallas Stars,2,Pacific,Western,13,2,24,0.5416666666666666,16,-3,12,1
2012-13,2013-02-13,Dallas Stars,2,Pacific,Western,15,2,26,0.5769230769230769,19,-4,14,1
2012-13,2013-02-14,Dallas Stars,0,Pacific,Western,15,2,28,0.5357142857142857,19,-4,15,0
2012-13,2013-02-16,Dallas Stars,2,Pacific,Western,17,2,30,0.5666666666666667,21,-4,16,1
2012-13,2013-02-17,Dallas Stars,0,Pacific,Western,17,2,32,0.53125,23,-6,16,1
2012-13,2013-02-22,Dallas Stars,0,Pacific,Western,17,2,34,0.5,25,-8,18,-1
2012-13,2013-02-24,Dallas Stars,2,Pacific,Western,19,2,36,0.5277777777777778,25,-6,19,0
2012-13,2013-02-26,Dallas Stars,1,Pacific,Western,20,2,38,0.5263157894736842,27,-7,20,0
2012-13,2013-02-27,Dallas Stars,2,Pacific,Western,22,2,40,0.55,27,-5,21,1
2012-13,2013-03-01,Dallas Stars,0,Pacific,Western,22,2,42,0.5238095238095238,29,-7,22,0
2012-13,2013-03-03,Dallas Stars,2,Pacific,Western,24,2,44,0.5454545454545454,32,-8,23,1
2012-13,2013-03-08,Dallas Stars,2,Pacific,Western,26,2,46,0.5652173913043478,35,-9,26,0
2012-13,2013-03-10,Dallas Stars,0,Pacific,Western,26,2,48,0.5416666666666666,37,-11,27,-1
2012-13,2013-03-13,Dallas Stars,0,Pacific,Western,26,2,50,0.52,41,-15,28,-2
2012-13,2013-03-15,Dallas Stars,1,Pacific,Western,27,2,52,0.5192307692307693,43,-16,29,-2
2012-13,2013-03-17,Dallas Stars,0,Pacific,Western,27,2,54,0.5,44,-17,30,-3
2012-13,2013-03-19,Dallas Stars,2,Pacific,Western,29,2,56,0.5178571428571429,46,-17,30,-1
2012-13,2013-03-21,Dallas Stars,0,Pacific,Western,29,2,58,0.5,48,-19,32,-3
2012-13,2013-03-22,Dallas Stars,2,Pacific,Western,31,2,60,0.5166666666666667,48,-17,32,-1
2012-13,2013-03-24,Dallas Stars,2,Pacific,Western,33,2,62,0.532258064516129,48,-15,33,0
2012-13,2013-03-26,Dallas Stars,0,Pacific,Western,33,2,64,0.515625,48,-15,34,-1
2012-13,2013-03-30,Dallas Stars,2,Pacific,Western,35,2,66,0.5303030303030303,50,-15,36,-1
2012-13,2013-03-31,Dallas Stars,0,Pacific,Western,35,2,68,0.5147058823529411,51,-16,37,-2
2012-13,2013-04-02,Dallas Stars,0,Pacific,Western,35,2,70,0.5,53,-18,38,-3
2012-13,2013-04-04,Dallas Stars,0,Pacific,Western,35,2,72,0.4861111111111111,55,-20,39,-4
2012-13,2013-04-06,Dallas Stars,2,Pacific,Western,37,2,74,0.5,55,-18,42,-5
2012-13,2013-04-07,Dallas Stars,2,Pacific,Western,39,2,76,0.5131578947368421,55,-16,43,-4
2012-13,2013-04-10,Dallas Stars,2,Pacific,Western,41,2,78,0.5256410256410257,59,-18,43,-2
2012-13,2013-04-13,Dallas Stars,2,Pacific,Western,43,2,80,0.5375,59,-16,45,-2
2012-13,2013-04-14,Dallas Stars,2,Pacific,Western,45,2,82,0.5487804878048781,59,-14,47,-2
2012-13,2013-04-16,Dallas Stars,0,Pacific,Western,45,2,84,0.5357142857142857,59,-14,47,-2
2012-13,2013-04-19,Dallas Stars,2,Pacific,Western,47,2,86,0.5465116279069767,60,-13,49,-2
2012-13,2013-04-20,Dallas Stars,0,Pacific,Western,47,2,88,0.5340909090909091,60,-13,49,-2
2012-13,2013-04-22,Dallas Stars,1,Pacific,Western,48,2,90,0.5333333333333333,62,-14,51,-3
2012-13,2013-04-24,Dallas Stars,0,Pacific,Western,48,2,92,0.5217391304347826,64,-16,52,-4
2012-13,2013-04-26,Dallas Stars,0,Pacific,Western,48,2,94,0.5106382978723404,66,-18,53,-5
2012-13,2013-04-27,Dallas Stars,0,Pacific,Western,48,2,96,0.5,66,-18,55,-7
2012-13,2013-01-20,Detroit Red Wings,0,Central,Western,0,2,2,0.0,2,-2,1,-1
2012-13,2013-01-22,Detroit Red Wings,2,Central,Western,2,2,4,0.5,4,-2,2,0
2012-13,2013-01-23,Detroit Red Wings,0,Central,Western,2,2,6,0.3333333333333333,6,-4,3,-1
2012-13,2013-01-26,Detroit Red Wings,2,Central,Western,4,2,8,0.5,8,-4,4,0
2012-13,2013-01-28,Detroit Red Wings,1,Central,Western,5,2,10,0.5,12,-7,5,0
2012-13,2013-01-30,Detroit Red Wings,2,Central,Western,7,2,12,0.5833333333333334,12,-5,6,1
2012-13,2013-02-02,Detroit Red Wings,2,Central,Western,9,2,14,0.6428571428571429,14,-5,9,0
2012-13,2013-02-03,Detroit Red Wings,0,Central,Western,9,2,16,0.5625,16,-7,9,0
2012-13,2013-02-06,Detroit Red Wings,0,Central,Western,9,2,18,0.5,18,-9,10,-1
2012-13,2013-02-08,Detroit Red Wings,2,Central,Western,11,2,20,0.55,20,-9,11,0
2012-13,2013-02-09,Detroit Red Wings,2,Central,Western,13,2,22,0.5909090909090909,20,-7,12,1
2012-13,2013-02-10,Detroit Red Wings,2,Central,Western,15,2,24,0.625,20,-5,13,2
2012-13,2013-02-14,Detroit Red Wings,1,Central,Western,16,2,26,0.6153846153846154,23,-7,15,1
2012-13,2013-02-16,Detroit Red Wings,0,Central,Western,16,2,28,0.5714285714285714,25,-9,16,0
2012-13,2013-02-17,Detroit Red Wings,0,Central,Western,16,2,30,0.5333333333333333,27,-11,16,0
2012-13,2013-02-20,Detroit Red Wings,1,Central,Western,17,2,32,0.53125,29,-12,17,0
2012-13,2013-02-22,Detroit Red Wings,0,Central,Western,17,2,34,0.5,29,-12,18,-1
2012-13,2013-02-24,Detroit Red Wings,2,Central,Western,19,2,36,0.5277777777777778,31,-12,19,0
2012-13,2013-02-24,Detroit Red Wings,2,Central,Western,21,2,38,0.5526315789473685,31,-10,19,2
2012-13,2013-02-28,Detroit Red Wings,0,Central,Western,21,2,40,0.525,35,-14,21,0
2012-13,2013-03-01,Detroit Red Wings,2,Central,Western,23,2,42,0.5476190476190477,37,-14,22,1
2012-13,2013-03-03,Detroit Red Wings,1,Central,Western,24,2,44,0.5454545454545454,41,-17,23,1
2012-13,2013-03-06,Detroit Red Wings,2,Central,Western,26,2,46,0.5652173913043478,43,-17,24,2
2012-13,2013-03-08,Detroit Red Wings,2,Central,Western,28,2,48,0.5833333333333334,45,-17,26,2
2012-13,2013-03-09,Detroit Red Wings,0,Central,Western,28,2,50,0.56,45,-17,26,2
2012-13,2013-03-10,Detroit Red Wings,1,Central,Western,29,2,52,0.5576923076923077,45,-16,27,2
2012-13,2013-03-14,Detroit Red Wings,0,Central,Western,29,2,54,0.5370370370370371,47,-18,28,1
2012-13,2013-03-16,Detroit Red Wings,2,Central,Western,31,2,56,0.5535714285714286,47,-16,30,1
2012-13,2013-03-17,Detroit Red Wings,2,Central,Western,33,2,58,0.5689655172413793,49,-16,30,3
2012-13,2013-03-20,Detroit Red Wings,0,Central,Western,33,2,60,0.55,51,-18,30,3
2012-13,2013-03-23,Detroit Red Wings,2,Central,Western,35,2,62,0.5645161290322581,51,-16,32,3
2012-13,2013-03-25,Detroit Red Wings,2,Central,Western,37,2,64,0.578125,51,-14,33,4
2012-13,2013-03-26,Detroit Red Wings,2,Central,Western,39,2,66,0.5909090909090909,51,-12,34,5
2012-13,2013-03-29,Detroit Red Wings,0,Central,Western,39,2,68,0.5735294117647058,53,-14,36,3
2012-13,2013-03-31,Detroit Red Wings,0,Central,Western,39,2,70,0.5571428571428572,55,-16,37,2
2012-13,2013-04-01,Detroit Red Wings,2,Central,Western,41,2,72,0.5694444444444444,55,-14,37,4
2012-13,2013-04-05,Detroit Red Wings,0,Central,Western,41,2,74,0.5540540540540541,58,-17,40,1
2012-13,2013-04-06,Detroit Red Wings,2,Central,Western,43,2,76,0.5657894736842105,60,-17,42,1
2012-13,2013-04-07,Detroit Red Wings,0,Central,Western,43,2,78,0.5512820512820513,62,-19,43,0
2012-13,2013-04-11,Detroit Red Wings,1,Central,Western,44,2,80,0.55,64,-20,44,0
2012-13,2013-04-13,Detroit Red Wings,1,Central,Western,45,2,82,0.5487804878048781,66,-21,45,0
2012-13,2013-04-14,Detroit Red Wings,2,Central,Western,47,2,84,0.5595238095238095,68,-21,47,0
2012-13,2013-04-18,Detroit Red Wings,0,Central,Western,47,2,86,0.5465116279069767,70,-23,49,-2
2012-13,2013-04-21,Detroit Red Wings,1,Central,Western,48,2,88,0.5454545454545454,73,-25,49,-1
2012-13,2013-04-22,Detroit Red Wings,2,Central,Western,50,2,90,0.5555555555555556,73,-23,51,-1
2012-13,2013-04-24,Detroit Red Wings,2,Central,Western,52,2,92,0.5652173913043478,73,-21,52,0
2012-13,2013-04-25,Detroit Red Wings,2,Central,Western,54,2,94,0.574468085106383,75,-21,53,1
2012-13,2013-04-27,Detroit Red Wings,2,Central,Western,56,2,96,0.5833333333333334,77,-21,55,1
2012-13,2013-01-21,Edmonton Oilers,2,Northwest,Western,2,2,2,1.0,4,-2,2,0
2012-13,2013-01-23,Edmonton Oilers,0,Northwest,Western,2,2,4,0.5,4,-2,3,-1
2012-13,2013-01-25,Edmonton Oilers,2,Northwest,Western,4,2,6,0.6666666666666666,4,0,4,0
2012-13,2013-01-27,Edmonton Oilers,0,Northwest,Western,4,2,8,0.5,5,-1,4,0
2012-13,2013-01-29,Edmonton Oilers,2,Northwest,Western,6,2,10,0.6,6,0,5,1
2012-13,2013-01-31,Edmonton Oilers,2,Northwest,Western,8,2,12,0.6666666666666666,9,-1,7,1
2012-13,2013-02-01,Edmonton Oilers,1,Northwest,Western,9,2,14,0.6428571428571429,9,0,7,2
2012-13,2013-02-02,Edmonton Oilers,0,Northwest,Western,9,2,16,0.5625,10,-1,9,0
2012-13,2013-02-05,Edmonton Oilers,1,Northwest,Western,10,2,18,0.5555555555555556,12,-2,9,1
2012-13,2013-02-07,Edmonton Oilers,1,Northwest,Western,11,2,20,0.55,12,-1,11,0
2012-13,2013-02-09,Edmonton Oilers,0,Northwest,Western,11,2,22,0.5,14,-3,12,-1
2012-13,2013-02-10,Edmonton Oilers,2,Northwest,Western,13,2,24,0.5416666666666666,16,-3,13,0
2012-13,2013-02-13,Edmonton Oilers,0,Northwest,Western,13,2,26,0.5,18,-5,14,-1
2012-13,2013-02-17,Edmonton Oilers,2,Northwest,Western,15,2,28,0.5357142857142857,18,-3,16,-1
2012-13,2013-02-20,Edmonton Oilers,0,Northwest,Western,15,2,30,0.5,20,-5,17,-2
2012-13,2013-02-22,Edmonton Oilers,0,Northwest,Western,15,2,32,0.46875,22,-7,18,-3
2012-13,2013-02-23,Edmonton Oilers,2,Northwest,Western,17,2,34,0.5,24,-7,18,-1
2012-13,2013-02-26,Edmonton Oilers,1,Northwest,Western,18,2,36,0.5,24,-6,20,-2
2012-13,2013-03-01,Edmonton Oilers,2,Northwest,Western,20,2,38,0.5263157894736842,24,-4,22,-2
2012-13,2013-03-02,Edmonton Oilers,0,Northwest,Western,20,2,40,0.5,24,-4,22,-2
2012-13,2013-03-04,Edmonton Oilers,0,Northwest,Western,20,2,42,0.47619047619047616,26,-6,24,-4
2012-13,2013-03-06,Edmonton Oilers,1,Northwest,Western,21,2,44,0.4772727272727273,27,-6,24,-3
2012-13,2013-03-08,Edmonton Oilers,0,Northwest,Western,21,2,46,0.45652173913043476,28,-7,26,-5
2012-13,2013-03-09,Edmonton Oilers,0,Northwest,Western,21,2,48,0.4375,28,-7,26,-5
2012-13,2013-03-10,Edmonton Oilers,2,Northwest,Western,23,2,50,0.46,28,-5,27,-4
2012-13,2013-03-13,Edmonton Oilers,2,Northwest,Western,25,2,52,0.4807692307692308,30,-5,28,-3
2012-13,2013-03-16,Edmonton Oilers,1,Northwest,Western,26,2,54,0.48148148148148145,32,-6,30,-4
2012-13,2013-03-18,Edmonton Oilers,2,Northwest,Western,28,2,56,0.5,32,-4,30,-2
2012-13,2013-03-21,Edmonton Oilers,1,Northwest,Western,29,2,58,0.5,36,-7,32,-3
2012-13,2013-03-24,Edmonton Oilers,0,Northwest,Western,29,2,60,0.48333333333333334,38,-9,33,-4
2012-13,2013-03-26,Edmonton Oilers,0,Northwest,Western,29,2,62,0.46774193548387094,40,-11,34,-5
2012-13,2013-03-27,Edmonton Oilers,2,Northwest,Western,31,2,64,0.484375,42,-11,34,-3
2012-13,2013-03-29,Edmonton Oilers,2,Northwest,Western,33,2,66,0.5,44,-11,36,-3
2012-13,2013-03-31,Edmonton Oilers,2,Northwest,Western,35,2,68,0.5147058823529411,44,-9,37,-2
2012-13,2013-04-02,Edmonton Oilers,2,Northwest,Western,37,2,70,0.5285714285714286,44,-7,38,-1
2012-13,2013-04-04,Edmonton Oilers,2,Northwest,Western,39,2,72,0.5416666666666666,44,-5,39,0
2012-13,2013-04-05,Edmonton Oilers,0,Northwest,Western,39,2,74,0.527027027027027,46,-7,40,-1
2012-13,2013-04-06,Edmonton Oilers,0,Northwest,Western,39,2,76,0.5131578947368421,46,-7,42,-3
2012-13,2013-04-09,Edmonton Oilers,0,Northwest,Western,39,2,78,0.5,50,-11,43,-4
2012-13,2013-04-11,Edmonton Oilers,0,Northwest,Western,39,2,80,0.4875,52,-13,44,-5
2012-13,2013-04-14,Edmonton Oilers,0,Northwest,Western,39,2,82,0.47560975609756095,52,-13,47,-8
2012-13,2013-04-17,Edmonton Oilers,0,Northwest,Western,39,2,84,0.4642857142857143,55,-16,47,-8
2012-13,2013-04-20,Edmonton Oilers,2,Northwest,Western,41,2,86,0.47674418604651164,55,-14,49,-8
2012-13,2013-04-22,Edmonton Oilers,0,Northwest,Western,41,2,88,0.4659090909090909,57,-16,51,-10
2012-13,2013-04-23,Edmonton Oilers,0,Northwest,Western,41,2,90,0.45555555555555555,59,-18,51,-10
2012-13,2013-04-25,Edmonton Oilers,0,Northwest,Western,41,2,92,0.44565217391304346,59,-18,53,-12
2012-13,2013-04-27,Edmonton Oilers,2,Northwest,Western,43,2,94,0.4574468085106383,59,-16,55,-12
2012-13,2013-04-28,Edmonton Oilers,2,Northwest,Western,45,2,96,0.46875,59,-14,55,-10
2012-13,2013-01-20,Florida Panthers,2,Southeast,Eastern,2,2,2,1.0,2,0,2,0
2012-13,2013-01-22,Florida Panthers,0,Southeast,Eastern,2,2,4,0.5,2,0,2,0
2012-13,2013-01-23,Florida Panthers,0,Southeast,Eastern,2,2,6,0.3333333333333333,4,-2,2,0
2012-13,2013-01-25,Florida Panthers,0,Southeast,Eastern,2,2,8,0.25,4,-2,4,-2
2012-13,2013-01-27,Florida Panthers,0,Southeast,Eastern,2,2,10,0.2,8,-6,4,-2
2012-13,2013-01-30,Florida Panthers,0,Southeast,Eastern,2,2,12,0.16666666666666666,10,-8,6,-4
2012-13,2013-02-01,Florida Panthers,2,Southeast,Eastern,4,2,14,0.2857142857142857,10,-6,8,-4
2012-13,2013-02-03,Florida Panthers,2,Southeast,Eastern,6,2,16,0.375,12,-6,8,-2
2012-13,2013-02-06,Florida Panthers,1,Southeast,Eastern,7,2,18,0.3888888888888889,12,-5,9,-2
2012-13,2013-02-08,Florida Panthers,2,Southeast,Eastern,9,2,20,0.45,12,-3,10,-1
2012-13,2013-02-10,Florida Panthers,0,Southeast,Eastern,9,2,22,0.4090909090909091,12,-3,11,-2
2012-13,2013-02-13,Florida Panthers,1,Southeast,Eastern,10,2,24,0.4166666666666667,15,-5,14,-4
2012-13,2013-02-15,Florida Panthers,1,Southeast,Eastern,11,2,26,0.4230769230769231,17,-6,15,-4
2012-13,2013-02-16,Florida Panthers,1,Southeast,Eastern,12,2,28,0.42857142857142855,17,-5,15,-3
2012-13,2013-02-19,Florida Panthers,0,Southeast,Eastern,12,2,30,0.4,17,-5,17,-5
2012-13,2013-02-22,Florida Panthers,2,Southeast,Eastern,14,2,32,0.4375,17,-3,17,-3
2012-13,2013-02-23,Florida Panthers,0,Southeast,Eastern,14,2,34,0.4117647058823529,17,-3,18,-4
2012-13,2013-02-24,Florida Panthers,0,Southeast,Eastern,14,2,36,0.3888888888888889,19,-5,19,-5
2012-13,2013-02-27,Florida Panthers,2,Southeast,Eastern,16,2,38,0.42105263157894735,19,-3,19,-3
2012-13,2013-03-01,Florida Panthers,1,Southeast,Eastern,17,2,40,0.425,21,-4,21,-4
2012-13,2013-03-03,Florida Panthers,0,Southeast,Eastern,17,2,42,0.40476190476190477,25,-8,23,-6
2012-13,2013-03-03,Florida Panthers,0,Southeast,Eastern,17,2,44,0.38636363636363635,25,-8,23,-6
2012-13,2013-03-06,Florida Panthers,2,Southeast,Eastern,19,2,46,0.41304347826086957,27,-8,24,-5
2012-13,2013-03-08,Florida Panthers,0,Southeast,Eastern,19,2,48,0.3958333333333333,27,-8,26,-7
2012-13,2013-03-09,Florida Panthers,1,Southeast,Eastern,20,2,50,0.4,27,-7,26,-6
2012-13,2013-03-10,Florida Panthers,0,Southeast,Eastern,20,2,52,0.38461538461538464,29,-9,28,-8
2012-13,2013-03-12,Florida Panthers,0,Southeast,Eastern,20,2,54,0.37037037037037035,31,-11,28,-8
2012-13,2013-03-14,Florida Panthers,0,Southeast,Eastern,20,2,56,0.35714285714285715,31,-11,28,-8
2012-13,2013-03-16,Florida Panthers,0,Southeast,Eastern,20,2,58,0.3448275862068966,32,-12,31,-11
2012-13,2013-03-19,Florida Panthers,2,Southeast,Eastern,22,2,60,0.36666666666666664,32,-10,32,-10
2012-13,2013-03-21,Florida Panthers,2,Southeast,Eastern,24,2,62,0.3870967741935484,34,-10,32,-8
2012-13,2013-03-23,Florida Panthers,0,Southeast,Eastern,24,2,64,0.375,34,-10,32,-8
2012-13,2013-03-24,Florida Panthers,0,Southeast,Eastern,24,2,66,0.36363636363636365,34,-10,33,-9
2012-13,2013-03-26,Florida Panthers,0,Southeast,Eastern,24,2,68,0.35294117647058826,38,-14,35,-11
2012-13,2013-03-28,Florida Panthers,2,Southeast,Eastern,26,2,70,0.37142857142857144,38,-12,35,-9
2012-13,2013-03-30,Florida Panthers,2,Southeast,Eastern,28,2,72,0.3888888888888889,38,-10,35,-7
2012-13,2013-04-02,Florida Panthers,2,Southeast,Eastern,30,2,74,0.40540540540540543,38,-8,38,-8
2012-13,2013-04-06,Florida Panthers,0,Southeast,Eastern,30,2,76,0.39473684210526316,40,-10,40,-10
2012-13,2013-04-07,Florida Panthers,2,Southeast,Eastern,32,2,78,0.41025641025641024,42,-10,42,-10
2012-13,2013-04-12,Florida Panthers,0,Southeast,Eastern,32,2,80,0.4,46,-14,44,-12
2012-13,2013-04-13,Florida Panthers,0,Southeast,Eastern,32,2,82,0.3902439024390244,48,-16,46,-14
2012-13,2013-04-16,Florida Panthers,0,Southeast,Eastern,32,2,84,0.38095238095238093,50,-18,46,-14
2012-13,2013-04-18,Florida Panthers,0,Southeast,Eastern,32,2,86,0.37209302325581395,50,-18,48,-16
2012-13,2013-04-20,Florida Panthers,0,Southeast,Eastern,32,2,88,0.36363636363636365,52,-20,50,-18
2012-13,2013-04-21,Florida Panthers,0,Southeast,Eastern,32,2,90,0.35555555555555557,52,-20,52,-20
2012-13,2013-04-23,Florida Panthers,2,Southeast,Eastern,34,2,92,0.3695652173913043,54,-20,52,-18
2012-13,2013-04-25,Florida Panthers,0,Southeast,Eastern,34,2,94,0.3617021276595745,55,-21,54,-20
2012-13,2013-04-27,Florida Panthers,2,Southeast,Eastern,36,2,96,0.375,57,-21,54,-18
2012-13,2013-01-19,Los Angeles Kings,0,Pacific,Western,0,2,2,0.0,0,0,0,0
2012-13,2013-01-22,Los Angeles Kings,0,Pacific,Western,0,2,4,0.0,4,-4,2,-2
2012-13,2013-01-25,Los Angeles Kings,1,Pacific,Western,1,2,6,0.16666666666666666,6,-5,4,-3
2012-13,2013-01-27,Los Angeles Kings,2,Pacific,Western,3,2,8,0.375,8,-5,4,-1
2012-13,2013-01-29,Los Angeles Kings,2,Pacific,Western,5,2,10,0.5,10,-5,5,0
2012-13,2013-02-01,Los Angeles Kings,1,Pacific,Western,6,2,12,0.5,14,-8,7,-1
2012-13,2013-02-03,Los Angeles Kings,0,Pacific,Western,6,2,14,0.42857142857142855,15,-9,9,-3
2012-13,2013-02-06,Los Angeles Kings,2,Pacific,Western,8,2,16,0.5,15,-7,10,-2
2012-13,2013-02-08,Los Angeles Kings,0,Pacific,Western,8,2,18,0.4444444444444444,15,-7,11,-3
2012-13,2013-02-10,Los Angeles Kings,0,Pacific,Western,8,2,20,0.4,17,-9,13,-5
2012-13,2013-02-12,Los Angeles Kings,2,Pacific,Western,10,2,22,0.45454545454545453,17,-7,13,-3
2012-13,2013-02-16,Los Angeles Kings,2,Pacific,Western,12,2,24,0.5,21,-9,16,-4
2012-13,2013-02-17,Los Angeles Kings,0,Pacific,Western,12,2,26,0.46153846153846156,23,-11,16,-4
2012-13,2013-02-20,Los Angeles Kings,2,Pacific,Western,14,2,28,0.5,25,-11,17,-3
2012-13,2013-02-21,Los Angeles Kings,2,Pacific,Western,16,2,30,0.5333333333333333,25,-9,17,-1
2012-13,2013-02-23,Los Angeles Kings,2,Pacific,Western,18,2,32,0.5625,25,-7,18,0
2012-13,2013-02-26,Los Angeles Kings,2,Pacific,Western,20,2,34,0.5882352941176471,27,-7,20,0
2012-13,2013-02-28,Los Angeles Kings,2,Pacific,Western,22,2,36,0.6111111111111112,29,-7,21,1
2012-13,2013-03-03,Los Angeles Kings,0,Pacific,Western,22,2,38,0.5789473684210527,32,-10,23,-1
2012-13,2013-03-05,Los Angeles Kings,2,Pacific,Western,24,2,40,0.6,33,-9,24,0
2012-13,2013-03-06,Los Angeles Kings,2,Pacific,Western,26,2,42,0.6190476190476191,33,-7,24,2
2012-13,2013-03-08,Los Angeles Kings,0,Pacific,Western,26,2,44,0.5909090909090909,35,-9,26,0
2012-13,2013-03-10,Los Angeles Kings,2,Pacific,Western,28,2,46,0.6086956521739131,37,-9,27,1
2012-13,2013-03-12,Los Angeles Kings,2,Pacific,Western,30,2,48,0.625,39,-9,28,2
2012-13,2013-03-13,Los Angeles Kings,0,Pacific,Western,30,2,50,0.6,41,-11,28,2
2012-13,2013-03-15,Los Angeles Kings,0,Pacific,Western,30,2,52,0.5769230769230769,43,-13,29,1
2012-13,2013-03-17,Los Angeles Kings,2,Pacific,Western,32,2,54,0.5925925925925926,44,-12,30,2
2012-13,2013-03-19,Los Angeles Kings,2,Pacific,Western,34,2,56,0.6071428571428571,46,-12,30,4
2012-13,2013-03-20,Los Angeles Kings,2,Pacific,Western,36,2,58,0.6206896551724138,46,-10,30,6
2012-13,2013-03-22,Los Angeles Kings,0,Pacific,Western,36,2,60,0.6,48,-12,32,4
2012-13,2013-03-23,Los Angeles Kings,0,Pacific,Western,36,2,62,0.5806451612903226,48,-12,32,4
2012-13,2013-03-26,Los Angeles Kings,2,Pacific,Western,38,2,64,0.59375,48,-10,34,4
2012-13,2013-03-29,Los Angeles Kings,2,Pacific,Western,40,2,66,0.6060606060606061,48,-8,36,4
2012-13,2013-03-31,Los Angeles Kings,2,Pacific,Western,42,2,68,0.6176470588235294,51,-9,37,5
2012-13,2013-03-31,Los Angeles Kings,1,Pacific,Western,43,2,70,0.6142857142857143,51,-8,37,6
2012-13,2013-04-03,Los Angeles Kings,0,Pacific,Western,43,2,72,0.5972222222222222,53,-10,38,5
2012-13,2013-04-05,Los Angeles Kings,2,Pacific,Western,45,2,74,0.6081081081081081,55,-10,40,5
2012-13,2013-04-06,Los Angeles Kings,2,Pacific,Western,47,2,76,0.618421052631579,55,-8,42,5
2012-13,2013-04-08,Los Angeles Kings,1,Pacific,Western,48,2,78,0.6153846153846154,57,-9,43,5
2012-13,2013-04-10,Los Angeles Kings,0,Pacific,Western,48,2,80,0.6,59,-11,43,5
2012-13,2013-04-12,Los Angeles Kings,2,Pacific,Western,50,2,82,0.6097560975609756,59,-9,44,6
2012-13,2013-04-14,Los Angeles Kings,2,Pacific,Western,52,2,84,0.6190476190476191,59,-7,47,5
2012-13,2013-04-17,Los Angeles Kings,1,Pacific,Western,53,2,86,0.6162790697674418,59,-6,47,6
2012-13,2013-04-19,Los Angeles Kings,2,Pacific,Western,55,2,88,0.625,60,-5,49,6
2012-13,2013-04-22,Los Angeles Kings,2,Pacific,Western,57,2,90,0.6333333333333333,62,-5,51,6
2012-13,2013-04-24,Los Angeles Kings,0,Pacific,Western,57,2,92,0.6195652173913043,64,-7,52,5
2012-13,2013-04-24,Los Angeles Kings,0,Pacific,Western,57,2,94,0.6063829787234043,64,-7,52,5
2012-13,2013-04-28,Los Angeles Kings,2,Pacific,Western,59,2,96,0.6145833333333334,66,-7,55,4
2012-13,2013-01-20,Minnesota Wild,2,Northwest,Western,2,2,2,1.0,2,0,1,1
2012-13,2013-01-21,Minnesota Wild,2,Northwest,Western,4,2,4,1.0,4,0,2,2
2012-13,2013-01-23,Minnesota Wild,0,Northwest,Western,4,2,6,0.6666666666666666,4,0,3,1
2012-13,2013-01-26,Minnesota Wild,0,Northwest,Western,4,2,8,0.5,5,-1,4,0
2012-13,2013-01-28,Minnesota Wild,1,Northwest,Western,5,2,10,0.5,5,0,5,0
2012-13,2013-01-30,Minnesota Wild,2,Northwest,Western,7,2,12,0.5833333333333334,7,0,6,1
2012-13,2013-01-31,Minnesota Wild,2,Northwest,Western,9,2,14,0.6428571428571429,9,0,7,2
2012-13,2013-02-02,Minnesota Wild,0,Northwest,Western,9,2,16,0.5625,10,-1,9,0
2012-13,2013-02-05,Minnesota Wild,0,Northwest,Western,9,2,18,0.5,12,-3,9,0
2012-13,2013-02-08,Minnesota Wild,0,Northwest,Western,9,2,20,0.45,14,-5,11,-2
2012-13,2013-02-10,Minnesota Wild,2,Northwest,Western,11,2,22,0.5,16,-5,13,-2
2012-13,2013-02-12,Minnesota Wild,2,Northwest,Western,13,2,24,0.5416666666666666,16,-3,13,0
2012-13,2013-02-13,Minnesota Wild,0,Northwest,Western,13,2,26,0.5,18,-5,14,-1
2012-13,2013-02-15,Minnesota Wild,1,Northwest,Western,14,2,28,0.5,18,-4,15,-1
2012-13,2013-02-17,Minnesota Wild,2,Northwest,Western,16,2,30,0.5333333333333333,18,-2,16,0
2012-13,2013-02-22,Minnesota Wild,2,Northwest,Western,18,2,32,0.5625,22,-4,18,0
2012-13,2013-02-24,Minnesota Wild,0,Northwest,Western,18,2,34,0.5294117647058824,24,-6,19,-1
2012-13,2013-02-27,Minnesota Wild,2,Northwest,Western,20,2,36,0.5555555555555556,24,-4,21,-1
2012-13,2013-03-01,Minnesota Wild,2,Northwest,Western,22,2,38,0.5789473684210527,24,-2,22,0
2012-13,2013-03-02,Minnesota Wild,0,Northwest,Western,22,2,40,0.55,24,-2,22,0
2012-13,2013-03-04,Minnesota Wild,2,Northwest,Western,24,2,42,0.5714285714285714,26,-2,24,0
2012-13,2013-03-06,Minnesota Wild,0,Northwest,Western,24,2,44,0.5454545454545454,27,-3,24,0
2012-13,2013-03-10,Minnesota Wild,2,Northwest,Western,26,2,46,0.5652173913043478,28,-2,27,-1
2012-13,2013-03-11,Minnesota Wild,2,Northwest,Western,28,2,48,0.5833333333333334,28,0,28,0
2012-13,2013-03-13,Minnesota Wild,0,Northwest,Western,28,2,50,0.56,30,-2,28,0
2012-13,2013-03-15,Minnesota Wild,2,Northwest,Western,30,2,52,0.5769230769230769,32,-2,29,1
2012-13,2013-03-16,Minnesota Wild,2,Northwest,Western,32,2,54,0.5925925925925926,32,0,30,2
2012-13,2013-03-19,Minnesota Wild,2,Northwest,Western,34,2,56,0.6071428571428571,34,0,30,4
2012-13,2013-03-20,Minnesota Wild,2,Northwest,Western,36,2,58,0.6206896551724138,36,0,30,6
2012-13,2013-03-23,Minnesota Wild,2,Northwest,Western,38,2,60,0.6333333333333333,38,0,32,6
2012-13,2013-03-26,Minnesota Wild,2,Northwest,Western,40,2,62,0.6451612903225806,40,0,34,6
2012-13,2013-03-28,Minnesota Wild,2,Northwest,Western,42,2,64,0.65625,42,0,36,6
2012-13,2013-03-30,Minnesota Wild,0,Northwest,Western,42,2,66,0.6363636363636364,44,-2,36,6
2012-13,2013-03-31,Minnesota Wild,2,Northwest,Western,44,2,68,0.6470588235294118,44,0,37,7
2012-13,2013-04-02,Minnesota Wild,0,Northwest,Western,44,2,70,0.6285714285714286,44,0,38,6
2012-13,2013-04-04,Minnesota Wild,0,Northwest,Western,44,2,72,0.6111111111111112,44,0,39,5
2012-13,2013-04-05,Minnesota Wild,0,Northwest,Western,44,2,74,0.5945945945945946,46,-2,40,4
2012-13,2013-04-07,Minnesota Wild,2,Northwest,Western,46,2,76,0.6052631578947368,48,-2,43,3
2012-13,2013-04-10,Minnesota Wild,0,Northwest,Western,46,2,78,0.5897435897435898,50,-4,43,3
2012-13,2013-04-12,Minnesota Wild,0,Northwest,Western,46,2,80,0.575,52,-6,44,2
2012-13,2013-04-14,Minnesota Wild,1,Northwest,Western,47,2,82,0.573170731707317,52,-5,47,0
2012-13,2013-04-16,Minnesota Wild,2,Northwest,Western,49,2,84,0.5833333333333334,54,-5,47,2
2012-13,2013-04-17,Minnesota Wild,2,Northwest,Western,51,2,86,0.5930232558139535,55,-4,47,4
2012-13,2013-04-19,Minnesota Wild,0,Northwest,Western,51,2,88,0.5795454545454546,55,-4,49,2
2012-13,2013-04-21,Minnesota Wild,0,Northwest,Western,51,2,90,0.5666666666666667,57,-6,49,2
2012-13,2013-04-24,Minnesota Wild,2,Northwest,Western,53,2,92,0.5760869565217391,59,-6,52,1
2012-13,2013-04-27,Minnesota Wild,0,Northwest,Western,53,2,94,0.5638297872340425,59,-6,55,-2
2012-13,2013-04-27,Minnesota Wild,2,Northwest,Western,55,2,96,0.5729166666666666,59,-4,55,0
2012-13,2013-01-20,Montréal Canadiens,0,Northeast,Eastern,0,2,2,0.0,2,-2,2,-2
2012-13,2013-01-23,Montréal Canadiens,2,Northeast,Eastern,2,2,4,0.5,4,-2,2,0
2012-13,2013-01-25,Montréal Canadiens,2,Northeast,Eastern,4,2,6,0.6666666666666666,6,-2,4,0
2012-13,2013-01-27,Montréal Canadiens,2,Northeast,Eastern,6,2,8,0.75,7,-1,4,2
2012-13,2013-01-30,Montréal Canadiens,2,Northeast,Eastern,8,2,10,0.8,11,-3,6,2
2012-13,2013-01-31,Montréal Canadiens,0,Northeast,Eastern,8,2,12,0.6666666666666666,11,-3,6,2
2012-13,2013-02-02,Montréal Canadiens,2,Northeast,Eastern,10,2,14,0.7142857142857143,11,-1,8,2
2012-13,2013-02-03,Montréal Canadiens,2,Northeast,Eastern,12,2,16,0.75,13,-1,8,4
2012-13,2013-02-07,Montréal Canadiens,0,Northeast,Eastern,12,2,18,0.6666666666666666,15,-3,9,3
2012-13,2013-02-08,Montréal Canadiens,1,Northeast,Eastern,13,2,20,0.65,15,-2,10,3
2012-13,2013-02-10,Montréal Canadiens,0,Northeast,Eastern,13,2,22,0.5909090909090909,15,-2,11,2
2012-13,2013-02-13,Montréal Canadiens,2,Northeast,Eastern,15,2,24,0.625,18,-3,14,1
2012-13,2013-02-15,Montréal Canadiens,2,Northeast,Eastern,17,2,26,0.6538461538461539,18,-1,15,2
2012-13,2013-02-17,Montréal Canadiens,2,Northeast,Eastern,19,2,28,0.6785714285714286,20,-1,16,3
2012-13,2013-02-19,Montréal Canadiens,2,Northeast,Eastern,21,2,30,0.7,21,0,17,4
2012-13,2013-02-20,Montréal Canadiens,2,Northeast,Eastern,23,2,32,0.71875,23,0,17,6
2012-13,2013-02-22,Montréal Canadiens,1,Northeast,Eastern,24,2,34,0.7058823529411765,24,0,17,7
2012-13,2013-02-24,Montréal Canadiens,2,Northeast,Eastern,26,2,36,0.7222222222222222,26,0,19,7
2012-13,2013-02-26,Montréal Canadiens,1,Northeast,Eastern,27,2,38,0.7105263157894737,27,0,19,8
2012-13,2013-02-28,Montréal Canadiens,2,Northeast,Eastern,29,2,40,0.725,29,0,19,10
2012-13,2013-03-03,Montréal Canadiens,1,Northeast,Eastern,30,2,42,0.7142857142857143,30,0,23,7
2012-13,2013-03-04,Montréal Canadiens,2,Northeast,Eastern,32,2,44,0.7272727272727273,32,0,23,9
2012-13,2013-03-06,Montréal Canadiens,0,Northeast,Eastern,32,2,46,0.6956521739130435,32,0,24,8
2012-13,2013-03-08,Montréal Canadiens,2,Northeast,Eastern,34,2,48,0.7083333333333334,34,0,26,8
2012-13,2013-03-10,Montréal Canadiens,2,Northeast,Eastern,36,2,50,0.72,36,0,28,8
2012-13,2013-03-10,Montréal Canadiens,2,Northeast,Eastern,38,2,52,0.7307692307692307,36,2,28,10
2012-13,2013-03-13,Montréal Canadiens,2,Northeast,Eastern,40,2,54,0.7407407407407407,40,0,28,12
2012-13,2013-03-16,Montréal Canadiens,2,Northeast,Eastern,42,2,56,0.75,42,0,31,11
2012-13,2013-03-19,Montréal Canadiens,1,Northeast,Eastern,43,2,58,0.7413793103448276,43,0,32,11
2012-13,2013-03-21,Montréal Canadiens,2,Northeast,Eastern,45,2,60,0.75,45,0,32,13
2012-13,2013-03-23,Montréal Canadiens,0,Northeast,Eastern,45,2,62,0.7258064516129032,45,0,32,13
2012-13,2013-03-26,Montréal Canadiens,0,Northeast,Eastern,45,2,64,0.703125,45,0,35,10
2012-13,2013-03-27,Montréal Canadiens,2,Northeast,Eastern,47,2,66,0.7121212121212122,47,0,35,12
2012-13,2013-03-30,Montréal Canadiens,2,Northeast,Eastern,49,2,68,0.7205882352941176,49,0,35,14
2012-13,2013-04-01,Montréal Canadiens,2,Northeast,Eastern,51,2,70,0.7285714285714285,51,0,37,14
2012-13,2013-04-03,Montréal Canadiens,0,Northeast,Eastern,51,2,72,0.7083333333333334,51,0,39,12
2012-13,2013-04-04,Montréal Canadiens,2,Northeast,Eastern,53,2,74,0.7162162162162162,53,0,39,14
2012-13,2013-04-06,Montréal Canadiens,2,Northeast,Eastern,55,2,76,0.7236842105263158,55,0,40,15
2012-13,2013-04-09,Montréal Canadiens,0,Northeast,Eastern,55,2,78,0.7051282051282052,55,0,42,13
2012-13,2013-04-11,Montréal Canadiens,2,Northeast,Eastern,57,2,80,0.7125,57,0,44,13
2012-13,2013-04-13,Montréal Canadiens,0,Northeast,Eastern,57,2,82,0.6951219512195121,57,0,46,11
2012-13,2013-04-15,Montréal Canadiens,0,Northeast,Eastern,57,2,84,0.6785714285714286,57,0,46,11
2012-13,2013-04-17,Montréal Canadiens,0,Northeast,Eastern,57,2,86,0.6627906976744186,57,0,46,11
2012-13,2013-04-18,Montréal Canadiens,2,Northeast,Eastern,59,2,88,0.6704545454545454,59,0,48,11
2012-13,2013-04-20,Montréal Canadiens,0,Northeast,Eastern,59,2,90,0.6555555555555556,59,0,50,9
2012-13,2013-04-23,Montréal Canadiens,0,Northeast,Eastern,59,2,92,0.6413043478260869,59,0,52,7
2012-13,2013-04-26,Montréal Canadiens,2,Northeast,Eastern,61,2,94,0.648936170212766,61,0,54,7
2012-13,2013-04-27,Montréal Canadiens,2,Northeast,Eastern,63,2,96,0.65625,63,0,54,9
2012-13,2013-01-20,Nashville Predators,1,Central,Western,1,2,2,0.5,2,-1,1,0
2012-13,2013-01-21,Nashville Predators,1,Central,Western,2,2,4,0.5,4,-2,2,0
2012-13,2013-01-23,Nashville Predators,2,Central,Western,4,2,6,0.6666666666666666,6,-2,3,1
2012-13,2013-01-25,Nashville Predators,0,Central,Western,4,2,8,0.5,8,-4,4,0
2012-13,2013-01-27,Nashville Predators,1,Central,Western,5,2,10,0.5,10,-5,4,1
2012-13,2013-01-29,Nashville Predators,0,Central,Western,5,2,12,0.4166666666666667,12,-7,5,0
2012-13,2013-02-01,Nashville Predators,2,Central,Western,7,2,14,0.5,13,-6,7,0
2012-13,2013-02-03,Nashville Predators,2,Central,Western,9,2,16,0.5625,16,-7,9,0
2012-13,2013-02-06,Nashville Predators,2,Central,Western,11,2,18,0.6111111111111112,18,-7,10,1
2012-13,2013-02-08,Nashville Predators,2,Central,Western,13,2,20,0.65,20,-7,11,2
2012-13,2013-02-10,Nashville Predators,1,Central,Western,14,2,22,0.6363636363636364,20,-6,13,1
2012-13,2013-02-11,Nashville Predators,0,Central,Western,14,2,24,0.5833333333333334,22,-8,13,1
2012-13,2013-02-13,Nashville Predators,2,Central,Western,16,2,26,0.6153846153846154,23,-7,14,2
2012-13,2013-02-15,Nashville Predators,2,Central,Western,18,2,28,0.6428571428571429,23,-5,15,3
2012-13,2013-02-17,Nashville Predators,1,Central,Western,19,2,30,0.6333333333333333,27,-8,16,3
2012-13,2013-02-18,Nashville Predators,0,Central,Western,19,2,32,0.59375,27,-8,16,3
2012-13,2013-02-20,Nashville Predators,2,Central,Western,21,2,34,0.6176470588235294,29,-8,17,4
2012-13,2013-02-23,Nashville Predators,0,Central,Western,21,2,36,0.5833333333333334,31,-10,18,3
2012-13,2013-02-24,Nashville Predators,0,Central,Western,21,2,38,0.5526315789473685,31,-10,19,2
2012-13,2013-02-26,Nashville Predators,2,Central,Western,23,2,40,0.575,35,-12,20,3
2012-13,2013-02-28,Nashville Predators,0,Central,Western,23,2,42,0.5476190476190477,35,-12,21,2
2012-13,2013-03-03,Nashville Predators,0,Central,Western,23,2,44,0.5227272727272727,41,-18,23,0
2012-13,2013-03-05,Nashville Predators,0,Central,Western,23,2,46,0.5,41,-18,24,-1
2012-13,2013-03-09,Nashville Predators,2,Central,Western,25,2,48,0.5208333333333334,45,-20,26,-1
2012-13,2013-03-10,Nashville Predators,1,Central,Western,26,2,50,0.52,45,-19,27,-1
2012-13,2013-03-13,Nashville Predators,2,Central,Western,28,2,52,0.5384615384615384,45,-17,28,0
2012-13,2013-03-15,Nashville Predators,0,Central,Western,28,2,54,0.5185185185185185,47,-19,29,-1
2012-13,2013-03-16,Nashville Predators,0,Central,Western,28,2,56,0.5,47,-19,30,-2
2012-13,2013-03-18,Nashville Predators,0,Central,Western,28,2,58,0.4827586206896552,49,-21,30,-2
2012-13,2013-03-19,Nashville Predators,0,Central,Western,28,2,60,0.4666666666666667,51,-23,30,-2
2012-13,2013-03-22,Nashville Predators,2,Central,Western,30,2,62,0.4838709677419355,51,-21,32,-2
2012-13,2013-03-24,Nashville Predators,2,Central,Western,32,2,64,0.5,51,-19,33,-1
2012-13,2013-03-26,Nashville Predators,2,Central,Western,34,2,66,0.5151515151515151,51,-17,34,0
2012-13,2013-03-29,Nashville Predators,0,Central,Western,34,2,68,0.5,53,-19,36,-2
2012-13,2013-03-30,Nashville Predators,1,Central,Western,35,2,70,0.5,53,-18,36,-1
2012-13,2013-04-02,Nashville Predators,1,Central,Western,36,2,72,0.5,57,-21,38,-2
2012-13,2013-04-03,Nashville Predators,2,Central,Western,38,2,74,0.5135135135135135,57,-19,38,0
2012-13,2013-04-05,Nashville Predators,0,Central,Western,38,2,76,0.5,58,-20,40,-2
2012-13,2013-04-06,Nashville Predators,0,Central,Western,38,2,78,0.48717948717948717,60,-22,42,-4
2012-13,2013-04-07,Nashville Predators,0,Central,Western,38,2,80,0.475,62,-24,43,-5
2012-13,2013-04-10,Nashville Predators,0,Central,Western,38,2,82,0.4634146341463415,64,-26,43,-5
2012-13,2013-04-13,Nashville Predators,0,Central,Western,38,2,84,0.4523809523809524,66,-28,45,-7
2012-13,2013-04-14,Nashville Predators,0,Central,Western,38,2,86,0.4418604651162791,68,-30,47,-9
2012-13,2013-04-16,Nashville Predators,0,Central,Western,38,2,88,0.4318181818181818,70,-32,47,-9
2012-13,2013-04-20,Nashville Predators,1,Central,Western,39,2,90,0.43333333333333335,72,-33,49,-10
2012-13,2013-04-24,Nashville Predators,2,Central,Western,41,2,92,0.44565217391304346,73,-32,52,-11
2012-13,2013-04-25,Nashville Predators,0,Central,Western,41,2,94,0.43617021276595747,75,-34,53,-12
2012-13,2013-04-27,Nashville Predators,0,Central,Western,41,2,96,0.4270833333333333,77,-36,55,-14
2012-13,2013-01-20,New Jersey Devils,2,Atlantic,Eastern,2,2,2,1.0,2,0,2,0
2012-13,2013-01-23,New Jersey Devils,2,Atlantic,Eastern,4,2,4,1.0,4,0,2,2
2012-13,2013-01-26,New Jersey Devils,2,Atlantic,Eastern,6,2,6,1.0,6,0,4,2
2012-13,2013-01-27,New Jersey Devils,1,Atlantic,Eastern,7,2,8,0.875,7,0,4,3
2012-13,2013-01-30,New Jersey Devils,1,Atlantic,Eastern,8,2,10,0.8,8,0,6,2
2012-13,2013-02-01,New Jersey Devils,1,Atlantic,Eastern,9,2,12,0.75,9,0,8,1
2012-13,2013-02-02,New Jersey Devils,0,Atlantic,Eastern,9,2,14,0.6428571428571429,10,-1,8,1
2012-13,2013-02-03,New Jersey Devils,2,Atlantic,Eastern,11,2,16,0.6875,12,-1,8,3
2012-13,2013-02-06,New Jersey Devils,2,Atlantic,Eastern,13,2,18,0.7222222222222222,14,-1,9,4
2012-13,2013-02-08,New Jersey Devils,2,Atlantic,Eastern,15,2,20,0.75,16,-1,10,5
2012-13,2013-02-09,New Jersey Devils,2,Atlantic,Eastern,17,2,22,0.7727272727272727,17,0,11,6
2012-13,2013-02-11,New Jersey Devils,2,Atlantic,Eastern,19,2,24,0.7916666666666666,19,0,12,7
2012-13,2013-02-13,New Jersey Devils,0,Atlantic,Eastern,19,2,26,0.7307692307692307,19,0,14,5
2012-13,2013-02-16,New Jersey Devils,2,Atlantic,Eastern,21,2,28,0.75,21,0,15,6
2012-13,2013-02-17,New Jersey Devils,0,Atlantic,Eastern,21,2,30,0.7,22,-1,16,5
2012-13,2013-02-18,New Jersey Devils,1,Atlantic,Eastern,22,2,32,0.6875,22,0,17,5
2012-13,2013-02-22,New Jersey Devils,2,Atlantic,Eastern,24,2,34,0.7058823529411765,24,0,17,7
2012-13,2013-02-23,New Jersey Devils,0,Atlantic,Eastern,24,2,36,0.6666666666666666,24,0,18,6
2012-13,2013-02-24,New Jersey Devils,0,Atlantic,Eastern,24,2,38,0.631578947368421,24,0,19,5
2012-13,2013-03-01,New Jersey Devils,0,Atlantic,Eastern,24,2,40,0.6,26,-2,21,3
2012-13,2013-03-02,New Jersey Devils,1,Atlantic,Eastern,25,2,42,0.5952380952380952,26,-1,21,4
2012-13,2013-03-05,New Jersey Devils,0,Atlantic,Eastern,25,2,44,0.5681818181818182,30,-5,23,2
2012-13,2013-03-06,New Jersey Devils,0,Atlantic,Eastern,25,2,46,0.5434782608695652,30,-5,24,1
2012-13,2013-03-08,New Jersey Devils,2,Atlantic,Eastern,27,2,48,0.5625,32,-5,26,1
2012-13,2013-03-10,New Jersey Devils,2,Atlantic,Eastern,29,2,50,0.58,36,-7,28,1
2012-13,2013-03-10,New Jersey Devils,0,Atlantic,Eastern,29,2,52,0.5576923076923077,36,-7,28,1
2012-13,2013-03-13,New Jersey Devils,2,Atlantic,Eastern,31,2,54,0.5740740740740741,38,-7,28,3
2012-13,2013-03-15,New Jersey Devils,1,Atlantic,Eastern,32,2,56,0.5714285714285714,40,-8,30,2
2012-13,2013-03-16,New Jersey Devils,0,Atlantic,Eastern,32,2,58,0.5517241379310345,42,-10,31,1
2012-13,2013-03-19,New Jersey Devils,0,Atlantic,Eastern,32,2,60,0.5333333333333333,46,-14,32,0
2012-13,2013-03-21,New Jersey Devils,2,Atlantic,Eastern,34,2,62,0.5483870967741935,46,-12,32,2
2012-13,2013-03-23,New Jersey Devils,2,Atlantic,Eastern,36,2,64,0.5625,48,-12,32,4
2012-13,2013-03-25,New Jersey Devils,1,Atlantic,Eastern,37,2,66,0.5606060606060606,50,-13,33,4
2012-13,2013-03-29,New Jersey Devils,1,Atlantic,Eastern,38,2,68,0.5588235294117647,54,-16,35,3
2012-13,2013-03-30,New Jersey Devils,1,Atlantic,Eastern,39,2,70,0.5571428571428572,56,-17,35,4
2012-13,2013-04-01,New Jersey Devils,0,Atlantic,Eastern,39,2,72,0.5416666666666666,56,-17,37,2
2012-13,2013-04-04,New Jersey Devils,0,Atlantic,Eastern,39,2,74,0.527027027027027,56,-17,39,0
2012-13,2013-04-06,New Jersey Devils,0,Atlantic,Eastern,39,2,76,0.5131578947368421,58,-19,40,-1
2012-13,2013-04-07,New Jersey Devils,1,Atlantic,Eastern,40,2,78,0.5128205128205128,58,-18,42,-2
2012-13,2013-04-10,New Jersey Devils,0,Atlantic,Eastern,40,2,80,0.5,60,-20,44,-4
2012-13,2013-04-12,New Jersey Devils,0,Atlantic,Eastern,40,2,82,0.4878048780487805,62,-22,44,-4
2012-13,2013-04-15,New Jersey Devils,0,Atlantic,Eastern,40,2,84,0.47619047619047616,64,-24,46,-6
2012-13,2013-04-18,New Jersey Devils,2,Atlantic,Eastern,42,2,86,0.4883720930232558,66,-24,48,-6
2012-13,2013-04-20,New Jersey Devils,2,Atlantic,Eastern,44,2,88,0.5,68,-24,50,-6
2012-13,2013-04-21,New Jersey Devils,0,Atlantic,Eastern,44,2,90,0.4888888888888889,68,-24,52,-8
2012-13,2013-04-23,New Jersey Devils,2,Atlantic,Eastern,46,2,92,0.5,70,-24,52,-6
2012-13,2013-04-25,New Jersey Devils,2,Atlantic,Eastern,48,2,94,0.5106382978723404,70,-22,54,-6
2012-13,2013-04-27,New Jersey Devils,0,Atlantic,Eastern,48,2,96,0.5,72,-24,54,-6
2012-13,2013-01-20,New York Islanders,0,Atlantic,Eastern,0,2,2,0.0,2,-2,2,-2
2012-13,2013-01-21,New York Islanders,2,Atlantic,Eastern,2,2,4,0.5,4,-2,2,0
2012-13,2013-01-25,New York Islanders,2,Atlantic,Eastern,4,2,6,0.6666666666666666,4,0,4,0
2012-13,2013-01-26,New York Islanders,0,Atlantic,Eastern,4,2,8,0.5,6,-2,4,0
2012-13,2013-01-28,New York Islanders,1,Atlantic,Eastern,5,2,10,0.5,7,-2,5,0
2012-13,2013-01-30,New York Islanders,2,Atlantic,Eastern,7,2,12,0.5833333333333334,8,-1,6,1
2012-13,2013-02-01,New York Islanders,2,Atlantic,Eastern,9,2,14,0.6428571428571429,9,0,8,1
2012-13,2013-02-03,New York Islanders,0,Atlantic,Eastern,9,2,16,0.5625,12,-3,8,1
2012-13,2013-02-06,New York Islanders,0,Atlantic,Eastern,9,2,18,0.5,14,-5,9,0
2012-13,2013-02-08,New York Islanders,0,Atlantic,Eastern,9,2,20,0.45,16,-7,10,-1
2012-13,2013-02-10,New York Islanders,0,Atlantic,Eastern,9,2,22,0.4090909090909091,17,-8,11,-2
2012-13,2013-02-12,New York Islanders,0,Atlantic,Eastern,9,2,24,0.375,19,-10,12,-3
2012-13,2013-02-15,New York Islanders,2,Atlantic,Eastern,11,2,26,0.4230769230769231,19,-8,15,-4
2012-13,2013-02-17,New York Islanders,2,Atlantic,Eastern,13,2,28,0.4642857142857143,22,-9,16,-3
2012-13,2013-02-18,New York Islanders,0,Atlantic,Eastern,13,2,30,0.43333333333333335,22,-9,17,-4
2012-13,2013-02-20,New York Islanders,0,Atlantic,Eastern,13,2,32,0.40625,22,-9,17,-4
2012-13,2013-02-22,New York Islanders,2,Atlantic,Eastern,15,2,34,0.4411764705882353,24,-9,17,-2
2012-13,2013-02-24,New York Islanders,2,Atlantic,Eastern,17,2,36,0.4722222222222222,24,-7,19,-2
2012-13,2013-02-25,New York Islanders,0,Atlantic,Eastern,17,2,38,0.4473684210526316,26,-9,19,-2
2012-13,2013-02-27,New York Islanders,0,Atlantic,Eastern,17,2,40,0.425,26,-9,19,-2
2012-13,2013-03-01,New York Islanders,1,Atlantic,Eastern,18,2,42,0.42857142857142855,26,-8,21,-3
2012-13,2013-03-03,New York Islanders,2,Atlantic,Eastern,20,2,44,0.45454545454545453,28,-8,23,-3
2012-13,2013-03-06,New York Islanders,2,Atlantic,Eastern,22,2,46,0.4782608695652174,30,-8,24,-2
2012-13,2013-03-08,New York Islanders,1,Atlantic,Eastern,23,2,48,0.4791666666666667,32,-9,26,-3
2012-13,2013-03-09,New York Islanders,2,Atlantic,Eastern,25,2,50,0.5,32,-7,26,-1
2012-13,2013-03-10,New York Islanders,0,Atlantic,Eastern,25,2,52,0.4807692307692308,36,-11,28,-3
2012-13,2013-03-14,New York Islanders,2,Atlantic,Eastern,27,2,54,0.5,40,-13,28,-1
2012-13,2013-03-16,New York Islanders,2,Atlantic,Eastern,29,2,56,0.5178571428571429,42,-13,31,-2
2012-13,2013-03-19,New York Islanders,0,Atlantic,Eastern,29,2,58,0.5,46,-17,32,-3
2012-13,2013-03-21,New York Islanders,0,Atlantic,Eastern,29,2,60,0.48333333333333334,46,-17,32,-3
2012-13,2013-03-22,New York Islanders,0,Atlantic,Eastern,29,2,62,0.46774193548387094,48,-19,32,-3
2012-13,2013-03-24,New York Islanders,2,Atlantic,Eastern,31,2,64,0.484375,50,-19,33,-2
2012-13,2013-03-26,New York Islanders,2,Atlantic,Eastern,33,2,66,0.5,52,-19,35,-2
2012-13,2013-03-28,New York Islanders,2,Atlantic,Eastern,35,2,68,0.5147058823529411,54,-19,35,0
2012-13,2013-03-30,New York Islanders,0,Atlantic,Eastern,35,2,70,0.5,56,-21,35,0
2012-13,2013-04-01,New York Islanders,2,Atlantic,Eastern,37,2,72,0.5138888888888888,56,-19,37,0
2012-13,2013-04-02,New York Islanders,2,Atlantic,Eastern,39,2,74,0.527027027027027,56,-17,38,1
2012-13,2013-04-04,New York Islanders,1,Atlantic,Eastern,40,2,76,0.5263157894736842,56,-16,39,1
2012-13,2013-04-06,New York Islanders,2,Atlantic,Eastern,42,2,78,0.5384615384615384,58,-16,40,2
2012-13,2013-04-09,New York Islanders,2,Atlantic,Eastern,44,2,80,0.55,60,-16,42,2
2012-13,2013-04-11,New York Islanders,2,Atlantic,Eastern,46,2,82,0.5609756097560976,62,-16,44,2
2012-13,2013-04-13,New York Islanders,1,Atlantic,Eastern,47,2,84,0.5595238095238095,64,-17,46,1
2012-13,2013-04-16,New York Islanders,2,Atlantic,Eastern,49,2,86,0.5697674418604651,64,-15,46,3
2012-13,2013-04-18,New York Islanders,2,Atlantic,Eastern,51,2,88,0.5795454545454546,66,-15,48,3
2012-13,2013-04-20,New York Islanders,2,Atlantic,Eastern,53,2,90,0.5888888888888889,68,-15,50,3
2012-13,2013-04-23,New York Islanders,1,Atlantic,Eastern,54,2,92,0.5869565217391305,70,-16,52,2
2012-13,2013-04-25,New York Islanders,0,Atlantic,Eastern,54,2,94,0.574468085106383,70,-16,54,0
2012-13,2013-04-26,New York Islanders,1,Atlantic,Eastern,55,2,96,0.5729166666666666,70,-15,54,1
2012-13,2013-01-20,New York Rangers,0,Atlantic,Eastern,0,2,2,0.0,2,-2,2,-2
2012-13,2013-01-21,New York Rangers,0,Atlantic,Eastern,0,2,4,0.0,4,-4,2,-2
2012-13,2013-01-24,New York Rangers,2,Atlantic,Eastern,2,2,6,0.3333333333333333,4,-2,3,-1
2012-13,2013-01-25,New York Rangers,0,Atlantic,Eastern,2,2,8,0.25,4,-2,4,-2
2012-13,2013-01-27,New York Rangers,2,Atlantic,Eastern,4,2,10,0.4,7,-3,4,0
2012-13,2013-01-30,New York Rangers,2,Atlantic,Eastern,6,2,12,0.5,8,-2,6,0
2012-13,2013-02-01,New York Rangers,0,Atlantic,Eastern,6,2,14,0.42857142857142855,9,-3,8,-2
2012-13,2013-02-03,New York Rangers,2,Atlantic,Eastern,8,2,16,0.5,12,-4,8,0
2012-13,2013-02-06,New York Rangers,0,Atlantic,Eastern,8,2,18,0.4444444444444444,14,-6,9,-1
2012-13,2013-02-08,New York Rangers,2,Atlantic,Eastern,10,2,20,0.5,16,-6,10,0
2012-13,2013-02-11,New York Rangers,2,Atlantic,Eastern,12,2,22,0.5454545454545454,19,-7,12,0
2012-13,2013-02-13,New York Rangers,2,Atlantic,Eastern,14,2,24,0.5833333333333334,19,-5,14,0
2012-13,2013-02-15,New York Rangers,1,Atlantic,Eastern,15,2,26,0.5769230769230769,19,-4,15,0
2012-13,2013-02-17,New York Rangers,2,Atlantic,Eastern,17,2,28,0.6071428571428571,22,-5,16,1
2012-13,2013-02-20,New York Rangers,0,Atlantic,Eastern,17,2,30,0.5666666666666667,22,-5,17,0
2012-13,2013-02-22,New York Rangers,1,Atlantic,Eastern,18,2,32,0.5625,24,-6,17,1
2012-13,2013-02-24,New York Rangers,0,Atlantic,Eastern,18,2,34,0.5294117647058824,24,-6,19,-1
2012-13,2013-02-27,New York Rangers,0,Atlantic,Eastern,18,2,36,0.5,26,-8,19,-1
2012-13,2013-03-01,New York Rangers,2,Atlantic,Eastern,20,2,38,0.5263157894736842,26,-6,21,-1
2012-13,2013-03-04,New York Rangers,2,Atlantic,Eastern,22,2,40,0.55,28,-6,23,-1
2012-13,2013-03-06,New York Rangers,2,Atlantic,Eastern,24,2,42,0.5714285714285714,30,-6,24,0
2012-13,2013-03-08,New York Rangers,2,Atlantic,Eastern,26,2,44,0.5909090909090909,32,-6,26,0
2012-13,2013-03-09,New York Rangers,0,Atlantic,Eastern,26,2,46,0.5652173913043478,32,-6,26,0
2012-13,2013-03-10,New York Rangers,2,Atlantic,Eastern,28,2,48,0.5833333333333334,36,-8,28,0
2012-13,2013-03-12,New York Rangers,0,Atlantic,Eastern,28,2,50,0.56,38,-10,28,0
2012-13,2013-03-15,New York Rangers,0,Atlantic,Eastern,28,2,52,0.5384615384615384,40,-12,30,-2
2012-13,2013-03-16,New York Rangers,0,Atlantic,Eastern,28,2,54,0.5185185185185185,42,-14,31,-3
2012-13,2013-03-18,New York Rangers,2,Atlantic,Eastern,30,2,56,0.5357142857142857,44,-14,32,-2
2012-13,2013-03-19,New York Rangers,2,Atlantic,Eastern,32,2,58,0.5517241379310345,46,-14,32,0
2012-13,2013-03-21,New York Rangers,0,Atlantic,Eastern,32,2,60,0.5333333333333333,46,-14,32,0
2012-13,2013-03-24,New York Rangers,1,Atlantic,Eastern,33,2,62,0.532258064516129,50,-17,33,0
2012-13,2013-03-26,New York Rangers,2,Atlantic,Eastern,35,2,64,0.546875,52,-17,35,0
2012-13,2013-03-28,New York Rangers,0,Atlantic,Eastern,35,2,66,0.5303030303030303,54,-19,35,0
2012-13,2013-03-30,New York Rangers,0,Atlantic,Eastern,35,2,68,0.5147058823529411,56,-21,35,0
2012-13,2013-04-01,New York Rangers,2,Atlantic,Eastern,37,2,70,0.5285714285714286,56,-19,37,0
2012-13,2013-04-03,New York Rangers,2,Atlantic,Eastern,39,2,72,0.5416666666666666,56,-17,39,0
2012-13,2013-04-05,New York Rangers,1,Atlantic,Eastern,40,2,74,0.5405405405405406,58,-18,39,1
2012-13,2013-04-06,New York Rangers,2,Atlantic,Eastern,42,2,76,0.5526315789473685,58,-16,40,2
2012-13,2013-04-08,New York Rangers,0,Atlantic,Eastern,42,2,78,0.5384615384615384,58,-16,42,0
2012-13,2013-04-10,New York Rangers,2,Atlantic,Eastern,44,2,80,0.55,60,-16,44,0
2012-13,2013-04-13,New York Rangers,2,Atlantic,Eastern,46,2,82,0.5609756097560976,64,-18,46,0
2012-13,2013-04-16,New York Rangers,0,Atlantic,Eastern,46,2,84,0.5476190476190477,64,-18,46,0
2012-13,2013-04-18,New York Rangers,2,Atlantic,Eastern,48,2,86,0.5581395348837209,66,-18,48,0
2012-13,2013-04-19,New York Rangers,2,Atlantic,Eastern,50,2,88,0.5681818181818182,66,-16,50,0
2012-13,2013-04-21,New York Rangers,2,Atlantic,Eastern,52,2,90,0.5777777777777777,68,-16,52,0
2012-13,2013-04-23,New York Rangers,0,Atlantic,Eastern,52,2,92,0.5652173913043478,70,-18,52,0
2012-13,2013-04-25,New York Rangers,2,Atlantic,Eastern,54,2,94,0.574468085106383,70,-16,54,0
2012-13,2013-04-27,New York Rangers,2,Atlantic,Eastern,56,2,96,0.5833333333333334,72,-16,54,2
2012-13,2013-01-19,Ottawa Senators,2,Northeast,Eastern,2,2,2,1.0,2,0,0,2
2012-13,2013-01-22,Ottawa Senators,2,Northeast,Eastern,4,2,4,1.0,4,0,2,2
2012-13,2013-01-25,Ottawa Senators,2,Northeast,Eastern,6,2,6,1.0,6,0,4,2
2012-13,2013-01-26,Ottawa Senators,0,Northeast,Eastern,6,2,8,0.75,7,-1,4,2
2012-13,2013-01-27,Ottawa Senators,1,Northeast,Eastern,7,2,10,0.7,7,0,4,3
2012-13,2013-01-30,Ottawa Senators,2,Northeast,Eastern,9,2,12,0.75,11,-2,6,3
2012-13,2013-01-31,Ottawa Senators,2,Northeast,Eastern,11,2,14,0.7857142857142857,11,0,6,5
2012-13,2013-02-02,Ottawa Senators,0,Northeast,Eastern,11,2,16,0.6875,11,0,8,3
2012-13,2013-02-03,Ottawa Senators,0,Northeast,Eastern,11,2,18,0.6111111111111112,13,-2,8,3
2012-13,2013-02-06,Ottawa Senators,2,Northeast,Eastern,13,2,20,0.65,13,0,9,4
2012-13,2013-02-08,Ottawa Senators,1,Northeast,Eastern,14,2,22,0.6363636363636364,15,-1,10,4
2012-13,2013-02-09,Ottawa Senators,0,Northeast,Eastern,14,2,24,0.5833333333333334,15,-1,11,3
2012-13,2013-02-13,Ottawa Senators,2,Northeast,Eastern,16,2,26,0.6153846153846154,18,-2,14,2
2012-13,2013-02-14,Ottawa Senators,0,Northeast,Eastern,16,2,28,0.5714285714285714,18,-2,14,2
2012-13,2013-02-17,Ottawa Senators,0,Northeast,Eastern,16,2,30,0.5333333333333333,20,-4,16,0
2012-13,2013-02-18,Ottawa Senators,2,Northeast,Eastern,18,2,32,0.5625,20,-2,17,1
2012-13,2013-02-20,Ottawa Senators,2,Northeast,Eastern,20,2,34,0.5882352941176471,23,-3,17,3
2012-13,2013-02-22,Ottawa Senators,2,Northeast,Eastern,22,2,36,0.6111111111111112,24,-2,17,5
2012-13,2013-02-24,Ottawa Senators,2,Northeast,Eastern,24,2,38,0.631578947368421,26,-2,19,5
2012-13,2013-02-26,Ottawa Senators,2,Northeast,Eastern,26,2,40,0.65,27,-1,19,7
2012-13,2013-03-01,Ottawa Senators,1,Northeast,Eastern,27,2,42,0.6428571428571429,29,-2,21,6
2012-13,2013-03-02,Ottawa Senators,0,Northeast,Eastern,27,2,44,0.6136363636363636,30,-3,21,6
2012-13,2013-03-03,Ottawa Senators,1,Northeast,Eastern,28,2,46,0.6086956521739131,30,-2,23,5
2012-13,2013-03-07,Ottawa Senators,0,Northeast,Eastern,28,2,48,0.5833333333333334,32,-4,24,4
2012-13,2013-03-09,Ottawa Senators,2,Northeast,Eastern,30,2,50,0.6,35,-5,26,4
2012-13,2013-03-11,Ottawa Senators,1,Northeast,Eastern,31,2,52,0.5961538461538461,38,-7,28,3
2012-13,2013-03-13,Ottawa Senators,1,Northeast,Eastern,32,2,54,0.5925925925925926,40,-8,28,4
2012-13,2013-03-16,Ottawa Senators,2,Northeast,Eastern,34,2,56,0.6071428571428571,42,-8,31,3
2012-13,2013-03-17,Ottawa Senators,2,Northeast,Eastern,36,2,58,0.6206896551724138,42,-6,31,5
2012-13,2013-03-19,Ottawa Senators,2,Northeast,Eastern,38,2,60,0.6333333333333333,43,-5,32,6
2012-13,2013-03-21,Ottawa Senators,0,Northeast,Eastern,38,2,62,0.6129032258064516,45,-7,32,6
2012-13,2013-03-23,Ottawa Senators,2,Northeast,Eastern,40,2,64,0.625,45,-5,32,8
2012-13,2013-03-25,Ottawa Senators,2,Northeast,Eastern,42,2,66,0.6363636363636364,45,-3,33,9
2012-13,2013-03-28,Ottawa Senators,2,Northeast,Eastern,44,2,68,0.6470588235294118,47,-3,35,9
2012-13,2013-03-30,Ottawa Senators,0,Northeast,Eastern,44,2,70,0.6285714285714286,49,-5,35,9
2012-13,2013-04-02,Ottawa Senators,0,Northeast,Eastern,44,2,72,0.6111111111111112,51,-7,38,6
2012-13,2013-04-05,Ottawa Senators,0,Northeast,Eastern,44,2,74,0.5945945945945946,53,-9,39,5
2012-13,2013-04-07,Ottawa Senators,0,Northeast,Eastern,44,2,76,0.5789473684210527,55,-11,42,2
2012-13,2013-04-09,Ottawa Senators,0,Northeast,Eastern,44,2,78,0.5641025641025641,55,-11,42,2
2012-13,2013-04-11,Ottawa Senators,2,Northeast,Eastern,46,2,80,0.575,57,-11,44,2
2012-13,2013-04-12,Ottawa Senators,2,Northeast,Eastern,48,2,82,0.5853658536585366,57,-9,44,4
2012-13,2013-04-16,Ottawa Senators,2,Northeast,Eastern,50,2,84,0.5952380952380952,57,-7,46,4
2012-13,2013-04-18,Ottawa Senators,2,Northeast,Eastern,52,2,86,0.6046511627906976,59,-7,48,4
2012-13,2013-04-20,Ottawa Senators,0,Northeast,Eastern,52,2,88,0.5909090909090909,59,-7,50,2
2012-13,2013-04-22,Ottawa Senators,0,Northeast,Eastern,52,2,90,0.5777777777777777,59,-7,52,0
2012-13,2013-04-25,Ottawa Senators,2,Northeast,Eastern,54,2,92,0.5869565217391305,61,-7,54,0
2012-13,2013-04-27,Ottawa Senators,0,Northeast,Eastern,54,2,94,0.574468085106383,63,-9,54,0
2012-13,2013-04-28,Ottawa Senators,2,Northeast,Eastern,56,2,96,0.5833333333333334,63,-7,55,1
2012-13,2013-01-19,Philadelphia Flyers,0,Atlantic,Eastern,0,2,2,0.0,2,-2,0,0
2012-13,2013-01-20,Philadelphia Flyers,0,Atlantic,Eastern,0,2,4,0.0,2,-2,2,-2
2012-13,2013-01-23,Philadelphia Flyers,0,Atlantic,Eastern,0,2,6,0.0,4,-4,2,-2
2012-13,2013-01-25,Philadelphia Flyers,2,Atlantic,Eastern,2,2,8,0.25,4,-2,4,-2
2012-13,2013-01-27,Philadelphia Flyers,2,Atlantic,Eastern,4,2,10,0.4,7,-3,4,0
2012-13,2013-01-27,Philadelphia Flyers,0,Atlantic,Eastern,4,2,12,0.3333333333333333,7,-3,4,0
2012-13,2013-01-30,Philadelphia Flyers,0,Atlantic,Eastern,4,2,14,0.2857142857142857,8,-4,6,-2
2012-13,2013-02-02,Philadelphia Flyers,0,Atlantic,Eastern,4,2,16,0.25,10,-6,8,-4
2012-13,2013-02-03,Philadelphia Flyers,2,Atlantic,Eastern,6,2,18,0.3333333333333333,12,-6,8,-2
2012-13,2013-02-06,Philadelphia Flyers,2,Atlantic,Eastern,8,2,20,0.4,14,-6,9,-1
2012-13,2013-02-08,Philadelphia Flyers,1,Atlantic,Eastern,9,2,22,0.4090909090909091,16,-7,10,-1
2012-13,2013-02-09,Philadelphia Flyers,2,Atlantic,Eastern,11,2,24,0.4583333333333333,17,-6,11,0
2012-13,2013-02-12,Philadelphia Flyers,0,Atlantic,Eastern,11,2,26,0.4230769230769231,19,-8,12,-1
2012-13,2013-02-13,Philadelphia Flyers,2,Atlantic,Eastern,13,2,28,0.4642857142857143,19,-6,14,-1
2012-13,2013-02-16,Philadelphia Flyers,0,Atlantic,Eastern,13,2,30,0.43333333333333335,21,-8,15,-2
2012-13,2013-02-17,Philadelphia Flyers,0,Atlantic,Eastern,13,2,32,0.40625,22,-9,16,-3
2012-13,2013-02-18,Philadelphia Flyers,2,Atlantic,Eastern,15,2,34,0.4411764705882353,22,-7,17,-2
2012-13,2013-02-21,Philadelphia Flyers,2,Atlantic,Eastern,17,2,36,0.4722222222222222,22,-5,17,0
2012-13,2013-02-22,Philadelphia Flyers,0,Atlantic,Eastern,17,2,38,0.4473684210526316,24,-7,17,0
2012-13,2013-02-23,Philadelphia Flyers,2,Atlantic,Eastern,19,2,40,0.475,24,-5,18,1
2012-13,2013-02-26,Philadelphia Flyers,0,Atlantic,Eastern,19,2,42,0.4523809523809524,26,-7,19,0
2012-13,2013-02-28,Philadelphia Flyers,2,Atlantic,Eastern,21,2,44,0.4772727272727273,26,-5,19,2
2012-13,2013-03-02,Philadelphia Flyers,2,Atlantic,Eastern,23,2,46,0.5,26,-3,21,2
2012-13,2013-03-06,Philadelphia Flyers,0,Atlantic,Eastern,23,2,48,0.4791666666666667,30,-7,24,-1
2012-13,2013-03-08,Philadelphia Flyers,0,Atlantic,Eastern,23,2,50,0.46,32,-9,26,-3
2012-13,2013-03-09,Philadelphia Flyers,0,Atlantic,Eastern,23,2,52,0.4423076923076923,32,-9,26,-3
2012-13,2013-03-10,Philadelphia Flyers,2,Atlantic,Eastern,25,2,54,0.46296296296296297,36,-11,28,-3
2012-13,2013-03-13,Philadelphia Flyers,0,Atlantic,Eastern,25,2,56,0.44642857142857145,38,-13,28,-3
2012-13,2013-03-15,Philadelphia Flyers,2,Atlantic,Eastern,27,2,58,0.46551724137931033,40,-13,30,-3
2012-13,2013-03-18,Philadelphia Flyers,0,Atlantic,Eastern,27,2,60,0.45,44,-17,32,-5
2012-13,2013-03-24,Philadelphia Flyers,1,Atlantic,Eastern,28,2,62,0.45161290322580644,50,-22,33,-5
2012-13,2013-03-26,Philadelphia Flyers,0,Atlantic,Eastern,28,2,64,0.4375,52,-24,35,-7
2012-13,2013-03-28,Philadelphia Flyers,1,Atlantic,Eastern,29,2,66,0.4393939393939394,54,-25,35,-6
2012-13,2013-03-30,Philadelphia Flyers,2,Atlantic,Eastern,31,2,68,0.45588235294117646,56,-25,35,-4
2012-13,2013-03-31,Philadelphia Flyers,2,Atlantic,Eastern,33,2,70,0.4714285714285714,56,-23,35,-2
2012-13,2013-04-03,Philadelphia Flyers,2,Atlantic,Eastern,35,2,72,0.4861111111111111,56,-21,39,-4
2012-13,2013-04-04,Philadelphia Flyers,2,Atlantic,Eastern,37,2,74,0.5,56,-19,39,-2
2012-13,2013-04-06,Philadelphia Flyers,0,Atlantic,Eastern,37,2,76,0.4868421052631579,58,-21,40,-3
2012-13,2013-04-09,Philadelphia Flyers,0,Atlantic,Eastern,37,2,78,0.47435897435897434,60,-23,42,-5
2012-13,2013-04-11,Philadelphia Flyers,0,Atlantic,Eastern,37,2,80,0.4625,62,-25,44,-7
2012-13,2013-04-13,Philadelphia Flyers,0,Atlantic,Eastern,37,2,82,0.45121951219512196,64,-27,46,-9
2012-13,2013-04-15,Philadelphia Flyers,2,Atlantic,Eastern,39,2,84,0.4642857142857143,64,-25,46,-7
2012-13,2013-04-16,Philadelphia Flyers,2,Atlantic,Eastern,41,2,86,0.47674418604651164,64,-23,46,-5
2012-13,2013-04-18,Philadelphia Flyers,0,Atlantic,Eastern,41,2,88,0.4659090909090909,66,-25,48,-7
2012-13,2013-04-20,Philadelphia Flyers,2,Atlantic,Eastern,43,2,90,0.4777777777777778,68,-25,50,-7
2012-13,2013-04-23,Philadelphia Flyers,2,Atlantic,Eastern,45,2,92,0.4891304347826087,70,-25,52,-7
2012-13,2013-04-25,Philadelphia Flyers,2,Atlantic,Eastern,47,2,94,0.5,70,-23,54,-7
2012-13,2013-04-27,Philadelphia Flyers,2,Atlantic,Eastern,49,2,96,0.5104166666666666,72,-23,54,-5
2012-13,2013-01-20,Phoenix Coyotes,0,Pacific,Western,0,2,2,0.0,2,-2,1,-1
2012-13,2013-01-21,Phoenix Coyotes,0,Pacific,Western,0,2,4,0.0,2,-2,2,-2
2012-13,2013-01-24,Phoenix Coyotes,2,Pacific,Western,2,2,6,0.3333333333333333,4,-2,3,-1
2012-13,2013-01-25,Phoenix Coyotes,0,Pacific,Western,2,2,8,0.25,6,-4,4,-2
2012-13,2013-01-27,Phoenix Coyotes,0,Pacific,Western,2,2,10,0.2,8,-6,4,-2
2012-13,2013-01-29,Phoenix Coyotes,2,Pacific,Western,4,2,12,0.3333333333333333,10,-6,5,-1
2012-13,2013-01-31,Phoenix Coyotes,1,Pacific,Western,5,2,14,0.35714285714285715,12,-7,7,-2
2012-13,2013-02-02,Phoenix Coyotes,1,Pacific,Western,6,2,16,0.375,14,-8,9,-3
2012-13,2013-02-03,Phoenix Coyotes,2,Pacific,Western,8,2,18,0.4444444444444444,15,-7,9,-1
2012-13,2013-02-05,Phoenix Coyotes,2,Pacific,Western,10,2,20,0.5,15,-5,9,1
2012-13,2013-02-08,Phoenix Coyotes,0,Pacific,Western,10,2,22,0.45454545454545453,15,-5,11,-1
2012-13,2013-02-09,Phoenix Coyotes,2,Pacific,Western,12,2,24,0.5,16,-4,12,0
2012-13,2013-02-12,Phoenix Coyotes,2,Pacific,Western,14,2,26,0.5384615384615384,17,-3,13,1
2012-13,2013-02-15,Phoenix Coyotes,0,Pacific,Western,14,2,28,0.5,19,-5,15,-1
2012-13,2013-02-17,Phoenix Coyotes,2,Pacific,Western,16,2,30,0.5333333333333333,23,-7,16,0
2012-13,2013-02-19,Phoenix Coyotes,2,Pacific,Western,18,2,32,0.5625,25,-7,17,1
2012-13,2013-02-23,Phoenix Coyotes,1,Pacific,Western,19,2,34,0.5588235294117647,25,-6,18,1
2012-13,2013-02-25,Phoenix Coyotes,0,Pacific,Western,19,2,36,0.5277777777777778,27,-8,19,0
2012-13,2013-02-27,Phoenix Coyotes,2,Pacific,Western,21,2,38,0.5526315789473685,27,-6,21,0
2012-13,2013-03-01,Phoenix Coyotes,0,Pacific,Western,21,2,40,0.525,29,-8,22,-1
2012-13,2013-03-03,Phoenix Coyotes,2,Pacific,Western,23,2,42,0.5476190476190477,32,-9,23,0
2012-13,2013-03-05,Phoenix Coyotes,2,Pacific,Western,25,2,44,0.5681818181818182,33,-8,24,1
2012-13,2013-03-07,Phoenix Coyotes,0,Pacific,Western,25,2,46,0.5434782608695652,35,-10,24,1
2012-13,2013-03-08,Phoenix Coyotes,0,Pacific,Western,25,2,48,0.5208333333333334,35,-10,26,-1
2012-13,2013-03-10,Phoenix Coyotes,2,Pacific,Western,27,2,50,0.54,37,-10,27,0
2012-13,2013-03-13,Phoenix Coyotes,2,Pacific,Western,29,2,52,0.5576923076923077,41,-12,28,1
2012-13,2013-03-15,Phoenix Coyotes,0,Pacific,Western,29,2,54,0.5370370370370371,43,-14,29,0
2012-13,2013-03-16,Phoenix Coyotes,1,Pacific,Western,30,2,56,0.5357142857142857,43,-13,30,0
2012-13,2013-03-19,Phoenix Coyotes,0,Pacific,Western,30,2,58,0.5172413793103449,46,-16,30,0
2012-13,2013-03-20,Phoenix Coyotes,0,Pacific,Western,30,2,60,0.5,46,-16,30,0
2012-13,2013-03-22,Phoenix Coyotes,0,Pacific,Western,30,2,62,0.4838709677419355,48,-18,32,-2
2012-13,2013-03-26,Phoenix Coyotes,0,Pacific,Western,30,2,64,0.46875,48,-18,34,-4
2012-13,2013-03-28,Phoenix Coyotes,1,Pacific,Western,31,2,66,0.4696969696969697,48,-17,36,-5
2012-13,2013-03-29,Phoenix Coyotes,2,Pacific,Western,33,2,68,0.4852941176470588,48,-15,36,-3
2012-13,2013-03-31,Phoenix Coyotes,1,Pacific,Western,34,2,70,0.4857142857142857,51,-17,37,-3
2012-13,2013-04-03,Phoenix Coyotes,2,Pacific,Western,36,2,72,0.5,53,-17,38,-2
2012-13,2013-04-05,Phoenix Coyotes,2,Pacific,Western,38,2,74,0.5135135135135135,55,-17,40,-2
2012-13,2013-04-07,Phoenix Coyotes,2,Pacific,Western,40,2,76,0.5263157894736842,55,-15,43,-3
2012-13,2013-04-09,Phoenix Coyotes,0,Pacific,Western,40,2,78,0.5128205128205128,59,-19,43,-3
2012-13,2013-04-11,Phoenix Coyotes,2,Pacific,Western,42,2,80,0.525,59,-17,44,-2
2012-13,2013-04-13,Phoenix Coyotes,1,Pacific,Western,43,2,82,0.524390243902439,59,-16,45,-2
2012-13,2013-04-16,Phoenix Coyotes,0,Pacific,Western,43,2,84,0.5119047619047619,59,-16,47,-4
2012-13,2013-04-19,Phoenix Coyotes,1,Pacific,Western,44,2,86,0.5116279069767442,60,-16,49,-5
2012-13,2013-04-21,Phoenix Coyotes,2,Pacific,Western,46,2,88,0.5227272727272727,60,-14,49,-3
2012-13,2013-04-22,Phoenix Coyotes,0,Pacific,Western,46,2,90,0.5111111111111111,62,-16,51,-5
2012-13,2013-04-25,Phoenix Coyotes,2,Pacific,Western,48,2,92,0.5217391304347826,64,-16,53,-5
2012-13,2013-04-27,Phoenix Coyotes,1,Pacific,Western,49,2,94,0.5212765957446809,66,-17,55,-6
2012-13,2013-04-28,Phoenix Coyotes,2,Pacific,Western,51,2,96,0.53125,66,-15,55,-4
2012-13,2013-01-19,Pittsburgh Penguins,2,Atlantic,Eastern,2,2,2,1.0,2,0,0,2
2012-13,2013-01-21,Pittsburgh Penguins,2,Atlantic,Eastern,4,2,4,1.0,4,0,2,2
2012-13,2013-01-24,Pittsburgh Penguins,0,Atlantic,Eastern,4,2,6,0.6666666666666666,4,0,3,1
2012-13,2013-01-26,Pittsburgh Penguins,0,Atlantic,Eastern,4,2,8,0.5,6,-2,4,0
2012-13,2013-01-27,Pittsburgh Penguins,2,Atlantic,Eastern,6,2,10,0.6,7,-1,4,2
2012-13,2013-01-30,Pittsburgh Penguins,0,Atlantic,Eastern,6,2,12,0.5,8,-2,6,0
2012-13,2013-02-01,Pittsburgh Penguins,2,Atlantic,Eastern,8,2,14,0.5714285714285714,9,-1,8,0
2012-13,2013-02-02,Pittsburgh Penguins,2,Atlantic,Eastern,10,2,16,0.625,10,0,8,2
2012-13,2013-02-03,Pittsburgh Penguins,2,Atlantic,Eastern,12,2,18,0.6666666666666666,12,0,8,4
2012-13,2013-02-06,Pittsburgh Penguins,2,Atlantic,Eastern,14,2,20,0.7,14,0,9,5
2012-13,2013-02-08,Pittsburgh Penguins,2,Atlantic,Eastern,16,2,22,0.7272727272727273,16,0,10,6
2012-13,2013-02-09,Pittsburgh Penguins,0,Atlantic,Eastern,16,2,24,0.6666666666666666,17,-1,11,5
2012-13,2013-02-11,Pittsburgh Penguins,0,Atlantic,Eastern,16,2,26,0.6153846153846154,19,-3,12,4
2012-13,2013-02-14,Pittsburgh Penguins,2,Atlantic,Eastern,18,2,28,0.6428571428571429,19,-1,14,4
2012-13,2013-02-16,Pittsburgh Penguins,2,Atlantic,Eastern,20,2,30,0.6666666666666666,21,-1,15,5
2012-13,2013-02-17,Pittsburgh Penguins,2,Atlantic,Eastern,22,2,32,0.6875,22,0,16,6
2012-13,2013-02-21,Pittsburgh Penguins,0,Atlantic,Eastern,22,2,34,0.6470588235294118,22,0,17,5
2012-13,2013-02-23,Pittsburgh Penguins,2,Atlantic,Eastern,24,2,36,0.6666666666666666,24,0,18,6
2012-13,2013-02-25,Pittsburgh Penguins,2,Atlantic,Eastern,26,2,38,0.6842105263157895,26,0,19,7
2012-13,2013-02-27,Pittsburgh Penguins,0,Atlantic,Eastern,26,2,40,0.65,26,0,19,7
2012-13,2013-03-01,Pittsburgh Penguins,0,Atlantic,Eastern,26,2,42,0.6190476190476191,26,0,21,5
2012-13,2013-03-03,Pittsburgh Penguins,2,Atlantic,Eastern,28,2,44,0.6363636363636364,28,0,23,5
2012-13,2013-03-05,Pittsburgh Penguins,2,Atlantic,Eastern,30,2,46,0.6521739130434783,30,0,23,7
2012-13,2013-03-08,Pittsburgh Penguins,2,Atlantic,Eastern,32,2,48,0.6666666666666666,32,0,26,6
2012-13,2013-03-10,Pittsburgh Penguins,2,Atlantic,Eastern,34,2,50,0.68,36,-2,28,6
2012-13,2013-03-10,Pittsburgh Penguins,2,Atlantic,Eastern,36,2,52,0.6923076923076923,36,0,28,8
2012-13,2013-03-12,Pittsburgh Penguins,2,Atlantic,Eastern,38,2,54,0.7037037037037037,38,0,28,10
2012-13,2013-03-14,Pittsburgh Penguins,2,Atlantic,Eastern,40,2,56,0.7142857142857143,40,0,28,12
2012-13,2013-03-16,Pittsburgh Penguins,2,Atlantic,Eastern,42,2,58,0.7241379310344828,42,0,31,11
2012-13,2013-03-17,Pittsburgh Penguins,2,Atlantic,Eastern,44,2,60,0.7333333333333333,44,0,31,13
2012-13,2013-03-19,Pittsburgh Penguins,2,Atlantic,Eastern,46,2,62,0.7419354838709677,46,0,32,14
2012-13,2013-03-22,Pittsburgh Penguins,2,Atlantic,Eastern,48,2,64,0.75,48,0,32,16
2012-13,2013-03-24,Pittsburgh Penguins,2,Atlantic,Eastern,50,2,66,0.7575757575757576,50,0,33,17
2012-13,2013-03-26,Pittsburgh Penguins,2,Atlantic,Eastern,52,2,68,0.7647058823529411,52,0,35,17
2012-13,2013-03-28,Pittsburgh Penguins,2,Atlantic,Eastern,54,2,70,0.7714285714285715,54,0,35,19
2012-13,2013-03-30,Pittsburgh Penguins,2,Atlantic,Eastern,56,2,72,0.7777777777777778,56,0,35,21
2012-13,2013-04-02,Pittsburgh Penguins,0,Atlantic,Eastern,56,2,74,0.7567567567567568,56,0,38,18
2012-13,2013-04-03,Pittsburgh Penguins,0,Atlantic,Eastern,56,2,76,0.7368421052631579,56,0,39,17
2012-13,2013-04-05,Pittsburgh Penguins,2,Atlantic,Eastern,58,2,78,0.7435897435897436,58,0,39,19
2012-13,2013-04-09,Pittsburgh Penguins,2,Atlantic,Eastern,60,2,80,0.75,60,0,42,18
2012-13,2013-04-11,Pittsburgh Penguins,2,Atlantic,Eastern,62,2,82,0.7560975609756098,62,0,44,18
2012-13,2013-04-13,Pittsburgh Penguins,2,Atlantic,Eastern,64,2,84,0.7619047619047619,64,0,46,18
2012-13,2013-04-17,Pittsburgh Penguins,2,Atlantic,Eastern,66,2,86,0.7674418604651163,66,0,46,20
2012-13,2013-04-20,Pittsburgh Penguins,2,Atlantic,Eastern,68,2,88,0.7727272727272727,68,0,50,18
2012-13,2013-04-22,Pittsburgh Penguins,2,Atlantic,Eastern,70,2,90,0.7777777777777778,70,0,52,18
2012-13,2013-04-23,Pittsburgh Penguins,0,Atlantic,Eastern,70,2,92,0.7608695652173914,70,0,52,18
2012-13,2013-04-25,Pittsburgh Penguins,0,Atlantic,Eastern,70,2,94,0.7446808510638298,70,0,54,16
2012-13,2013-04-27,Pittsburgh Penguins,2,Atlantic,Eastern,72,2,96,0.75,72,0,54,18
2012-13,2013-01-20,San Jose Sharks,2,Pacific,Western,2,2,2,1.0,2,0,1,1
2012-13,2013-01-23,San Jose Sharks,2,Pacific,Western,4,2,4,1.0,4,0,3,1
2012-13,2013-01-25,San Jose Sharks,2,Pacific,Western,6,2,6,1.0,6,0,4,2
2012-13,2013-01-26,San Jose Sharks,2,Pacific,Western,8,2,8,1.0,8,0,4,4
2012-13,2013-01-28,San Jose Sharks,2,Pacific,Western,10,2,10,1.0,10,0,5,5
2012-13,2013-01-30,San Jose Sharks,2,Pacific,Western,12,2,12,1.0,12,0,6,6
2012-13,2013-02-01,San Jose Sharks,2,Pacific,Western,14,2,14,1.0,14,0,7,7
2012-13,2013-02-03,San Jose Sharks,1,Pacific,Western,15,2,16,0.9375,15,0,9,6
2012-13,2013-02-05,San Jose Sharks,0,Pacific,Western,15,2,18,0.8333333333333334,15,0,9,6
2012-13,2013-02-06,San Jose Sharks,0,Pacific,Western,15,2,20,0.75,15,0,10,5
2012-13,2013-02-09,San Jose Sharks,1,Pacific,Western,16,2,22,0.7272727272727273,16,0,12,4
2012-13,2013-02-12,San Jose Sharks,0,Pacific,Western,16,2,24,0.6666666666666666,17,-1,13,3
2012-13,2013-02-13,San Jose Sharks,1,Pacific,Western,17,2,26,0.6538461538461539,19,-2,14,3
2012-13,2013-02-16,San Jose Sharks,0,Pacific,Western,17,2,28,0.6071428571428571,21,-4,16,1
2012-13,2013-02-20,San Jose Sharks,2,Pacific,Western,19,2,30,0.6333333333333333,25,-6,17,2
2012-13,2013-02-23,San Jose Sharks,0,Pacific,Western,19,2,32,0.59375,25,-6,18,1
2012-13,2013-02-24,San Jose Sharks,0,Pacific,Western,19,2,34,0.5588235294117647,25,-6,19,0
2012-13,2013-02-27,San Jose Sharks,2,Pacific,Western,21,2,36,0.5833333333333334,27,-6,21,0
2012-13,2013-03-01,San Jose Sharks,1,Pacific,Western,22,2,38,0.5789473684210527,29,-7,22,0
2012-13,2013-03-03,San Jose Sharks,2,Pacific,Western,24,2,40,0.6,32,-8,23,1
2012-13,2013-03-06,San Jose Sharks,2,Pacific,Western,26,2,42,0.6190476190476191,33,-7,24,2
2012-13,2013-03-07,San Jose Sharks,0,Pacific,Western,26,2,44,0.5909090909090909,35,-9,24,2
2012-13,2013-03-09,San Jose Sharks,1,Pacific,Western,27,2,46,0.5869565217391305,37,-10,26,1
2012-13,2013-03-11,San Jose Sharks,1,Pacific,Western,28,2,48,0.5833333333333334,39,-11,28,0
2012-13,2013-03-13,San Jose Sharks,0,Pacific,Western,28,2,50,0.56,41,-13,28,0
2012-13,2013-03-15,San Jose Sharks,2,Pacific,Western,30,2,52,0.5769230769230769,43,-13,29,1
2012-13,2013-03-17,San Jose Sharks,0,Pacific,Western,30,2,54,0.5555555555555556,44,-14,30,0
2012-13,2013-03-19,San Jose Sharks,0,Pacific,Western,30,2,56,0.5357142857142857,46,-16,30,0
2012-13,2013-03-21,San Jose Sharks,2,Pacific,Western,32,2,58,0.5517241379310345,48,-16,32,0
2012-13,2013-03-23,San Jose Sharks,0,Pacific,Western,32,2,60,0.5333333333333333,48,-16,32,0
2012-13,2013-03-26,San Jose Sharks,2,Pacific,Western,34,2,62,0.5483870967741935,48,-14,34,0
2012-13,2013-03-28,San Jose Sharks,2,Pacific,Western,36,2,64,0.5625,48,-12,36,0
2012-13,2013-03-29,San Jose Sharks,2,Pacific,Western,38,2,66,0.5757575757575758,48,-10,36,2
2012-13,2013-03-31,San Jose Sharks,2,Pacific,Western,40,2,68,0.5882352941176471,51,-11,37,3
2012-13,2013-04-02,San Jose Sharks,2,Pacific,Western,42,2,70,0.6,53,-11,38,4
2012-13,2013-04-04,San Jose Sharks,2,Pacific,Western,44,2,72,0.6111111111111112,55,-11,39,5
2012-13,2013-04-06,San Jose Sharks,2,Pacific,Western,46,2,74,0.6216216216216216,55,-9,42,4
2012-13,2013-04-07,San Jose Sharks,1,Pacific,Western,47,2,76,0.618421052631579,55,-8,43,4
2012-13,2013-04-09,San Jose Sharks,0,Pacific,Western,47,2,78,0.6025641025641025,59,-12,43,4
2012-13,2013-04-11,San Jose Sharks,2,Pacific,Western,49,2,80,0.6125,59,-10,44,5
2012-13,2013-04-14,San Jose Sharks,0,Pacific,Western,49,2,82,0.5975609756097561,59,-10,47,2
2012-13,2013-04-16,San Jose Sharks,2,Pacific,Western,51,2,84,0.6071428571428571,59,-8,47,4
2012-13,2013-04-17,San Jose Sharks,2,Pacific,Western,53,2,86,0.6162790697674418,59,-6,47,6
2012-13,2013-04-19,San Jose Sharks,2,Pacific,Western,55,2,88,0.625,60,-5,49,6
2012-13,2013-04-22,San Jose Sharks,0,Pacific,Western,55,2,90,0.6111111111111112,62,-7,51,4
2012-13,2013-04-24,San Jose Sharks,2,Pacific,Western,57,2,92,0.6195652173913043,64,-7,52,5
2012-13,2013-04-25,San Jose Sharks,0,Pacific,Western,57,2,94,0.6063829787234043,64,-7,53,4
2012-13,2013-04-28,San Jose Sharks,0,Pacific,Western,57,2,96,0.59375,66,-9,55,2
2012-13,2013-01-20,St. Louis Blues,2,Central,Western,2,2,2,1.0,2,0,1,1
2012-13,2013-01-21,St. Louis Blues,2,Central,Western,4,2,4,1.0,4,0,2,2
2012-13,2013-01-23,St. Louis Blues,0,Central,Western,4,2,6,0.6666666666666666,6,-2,3,1
2012-13,2013-01-25,St. Louis Blues,2,Central,Western,6,2,8,0.75,8,-2,4,2
2012-13,2013-01-27,St. Louis Blues,2,Central,Western,8,2,10,0.8,10,-2,4,4
2012-13,2013-01-28,St. Louis Blues,2,Central,Western,10,2,12,0.8333333333333334,12,-2,5,5
2012-13,2013-02-01,St. Louis Blues,2,Central,Western,12,2,14,0.8571428571428571,13,-1,7,5
2012-13,2013-02-02,St. Louis Blues,0,Central,Western,12,2,16,0.75,14,-2,9,3
2012-13,2013-02-06,St. Louis Blues,0,Central,Western,12,2,18,0.6666666666666666,18,-6,10,2
2012-13,2013-02-08,St. Louis Blues,0,Central,Western,12,2,20,0.6,20,-8,11,1
2012-13,2013-02-10,St. Louis Blues,1,Central,Western,13,2,22,0.5909090909090909,20,-7,13,0
2012-13,2013-02-12,St. Louis Blues,0,Central,Western,13,2,24,0.5416666666666666,22,-9,13,0
2012-13,2013-02-14,St. Louis Blues,2,Central,Western,15,2,26,0.5769230769230769,23,-8,15,0
2012-13,2013-02-16,St. Louis Blues,2,Central,Western,17,2,28,0.6071428571428571,25,-8,16,1
2012-13,2013-02-18,St. Louis Blues,2,Central,Western,19,2,30,0.6333333333333333,27,-8,16,3
2012-13,2013-02-20,St. Louis Blues,0,Central,Western,19,2,32,0.59375,29,-10,17,2
2012-13,2013-02-21,St. Louis Blues,1,Central,Western,20,2,34,0.5882352941176471,29,-9,17,3
2012-13,2013-02-24,St. Louis Blues,2,Central,Western,22,2,36,0.6111111111111112,31,-9,19,3
2012-13,2013-03-01,St. Louis Blues,0,Central,Western,22,2,38,0.5789473684210527,37,-15,22,0
2012-13,2013-03-02,St. Louis Blues,2,Central,Western,24,2,40,0.6,39,-15,22,2
2012-13,2013-03-03,St. Louis Blues,0,Central,Western,24,2,42,0.5714285714285714,41,-17,23,1
2012-13,2013-03-06,St. Louis Blues,0,Central,Western,24,2,44,0.5454545454545454,43,-19,24,0
2012-13,2013-03-08,St. Louis Blues,2,Central,Western,26,2,46,0.5652173913043478,45,-19,26,0
2012-13,2013-03-09,St. Louis Blues,2,Central,Western,28,2,48,0.5833333333333334,45,-17,26,2
2012-13,2013-03-11,St. Louis Blues,0,Central,Western,28,2,50,0.56,45,-17,28,0
2012-13,2013-03-13,St. Louis Blues,2,Central,Western,30,2,52,0.5769230769230769,45,-15,28,2
2012-13,2013-03-15,St. Louis Blues,2,Central,Western,32,2,54,0.5925925925925926,47,-15,29,3
2012-13,2013-03-17,St. Louis Blues,2,Central,Western,34,2,56,0.6071428571428571,49,-15,30,4
2012-13,2013-03-20,St. Louis Blues,0,Central,Western,34,2,58,0.5862068965517241,51,-17,30,4
2012-13,2013-03-24,St. Louis Blues,2,Central,Western,36,2,60,0.6,51,-15,33,3
2012-13,2013-03-25,St. Louis Blues,0,Central,Western,36,2,62,0.5806451612903226,51,-15,33,3
2012-13,2013-03-27,St. Louis Blues,0,Central,Western,36,2,64,0.5625,53,-17,34,2
2012-13,2013-03-29,St. Louis Blues,0,Central,Western,36,2,66,0.5454545454545454,53,-17,36,0
2012-13,2013-04-02,St. Louis Blues,2,Central,Western,38,2,68,0.5588235294117647,57,-19,38,0
2012-13,2013-04-05,St. Louis Blues,2,Central,Western,40,2,70,0.5714285714285714,58,-18,40,0
2012-13,2013-04-06,St. Louis Blues,2,Central,Western,42,2,72,0.5833333333333334,60,-18,42,0
2012-13,2013-04-07,St. Louis Blues,2,Central,Western,44,2,74,0.5945945945945946,62,-18,43,1
2012-13,2013-04-10,St. Louis Blues,2,Central,Western,46,2,76,0.6052631578947368,64,-18,43,3
2012-13,2013-04-12,St. Louis Blues,0,Central,Western,46,2,78,0.5897435897435898,64,-18,44,2
2012-13,2013-04-12,St. Louis Blues,2,Central,Western,48,2,80,0.6,64,-16,44,4
2012-13,2013-04-14,St. Louis Blues,0,Central,Western,48,2,82,0.5853658536585366,68,-20,47,1
2012-13,2013-04-17,St. Louis Blues,2,Central,Western,50,2,84,0.5952380952380952,70,-20,47,3
2012-13,2013-04-19,St. Louis Blues,2,Central,Western,52,2,86,0.6046511627906976,70,-18,49,3
2012-13,2013-04-20,St. Louis Blues,2,Central,Western,54,2,88,0.6136363636363636,72,-18,49,5
2012-13,2013-04-22,St. Louis Blues,0,Central,Western,54,2,90,0.6,73,-19,51,3
2012-13,2013-04-24,St. Louis Blues,2,Central,Western,56,2,92,0.6086956521739131,73,-17,52,4
2012-13,2013-04-26,St. Louis Blues,2,Central,Western,58,2,94,0.6170212765957447,75,-17,53,5
2012-13,2013-04-28,St. Louis Blues,2,Central,Western,60,2,96,0.625,77,-17,55,5
2012-13,2013-01-20,Tampa Bay Lightning,2,Southeast,Eastern,2,2,2,1.0,2,0,2,0
2012-13,2013-01-21,Tampa Bay Lightning,0,Southeast,Eastern,2,2,4,0.5,2,0,2,0
2012-13,2013-01-23,Tampa Bay Lightning,2,Southeast,Eastern,4,2,6,0.6666666666666666,4,0,2,2
2012-13,2013-01-26,Tampa Bay Lightning,2,Southeast,Eastern,6,2,8,0.75,6,0,4,2
2012-13,2013-01-27,Tampa Bay Lightning,2,Southeast,Eastern,8,2,10,0.8,8,0,4,4
2012-13,2013-01-30,Tampa Bay Lightning,2,Southeast,Eastern,10,2,12,0.8333333333333334,10,0,6,4
2012-13,2013-02-02,Tampa Bay Lightning,2,Southeast,Eastern,12,2,14,0.8571428571428571,12,0,8,4
2012-13,2013-02-03,Tampa Bay Lightning,0,Southeast,Eastern,12,2,16,0.75,12,0,8,4
2012-13,2013-02-06,Tampa Bay Lightning,0,Southeast,Eastern,12,2,18,0.6666666666666666,12,0,9,3
2012-13,2013-02-08,Tampa Bay Lightning,0,Southeast,Eastern,12,2,20,0.6,12,0,10,2
2012-13,2013-02-11,Tampa Bay Lightning,0,Southeast,Eastern,12,2,22,0.5454545454545454,12,0,12,0
2012-13,2013-02-13,Tampa Bay Lightning,1,Southeast,Eastern,13,2,24,0.5416666666666666,15,-2,14,-1
2012-13,2013-02-15,Tampa Bay Lightning,0,Southeast,Eastern,13,2,26,0.5,17,-4,15,-2
2012-13,2013-02-16,Tampa Bay Lightning,2,Southeast,Eastern,15,2,28,0.5357142857142857,17,-2,15,0
2012-13,2013-02-20,Tampa Bay Lightning,2,Southeast,Eastern,17,2,30,0.5666666666666667,17,0,17,0
2012-13,2013-02-22,Tampa Bay Lightning,0,Southeast,Eastern,17,2,32,0.53125,17,0,17,0
2012-13,2013-02-24,Tampa Bay Lightning,2,Southeast,Eastern,19,2,34,0.5588235294117647,19,0,19,0
2012-13,2013-02-25,Tampa Bay Lightning,0,Southeast,Eastern,19,2,36,0.5277777777777778,19,0,19,0
2012-13,2013-02-27,Tampa Bay Lightning,0,Southeast,Eastern,19,2,38,0.5,19,0,19,0
2012-13,2013-03-01,Tampa Bay Lightning,0,Southeast,Eastern,19,2,40,0.475,21,-2,21,-2
2012-13,2013-03-02,Tampa Bay Lightning,0,Southeast,Eastern,19,2,42,0.4523809523809524,21,-2,21,-2
2012-13,2013-03-05,Tampa Bay Lightning,0,Southeast,Eastern,19,2,44,0.4318181818181818,25,-6,23,-4
2012-13,2013-03-06,Tampa Bay Lightning,2,Southeast,Eastern,21,2,46,0.45652173913043476,27,-6,24,-3
2012-13,2013-03-08,Tampa Bay Lightning,0,Southeast,Eastern,21,2,48,0.4375,27,-6,26,-5
2012-13,2013-03-10,Tampa Bay Lightning,0,Southeast,Eastern,21,2,50,0.42,29,-8,28,-7
2012-13,2013-03-12,Tampa Bay Lightning,2,Southeast,Eastern,23,2,52,0.4423076923076923,31,-8,28,-5
2012-13,2013-03-14,Tampa Bay Lightning,0,Southeast,Eastern,23,2,54,0.42592592592592593,31,-8,28,-5
2012-13,2013-03-16,Tampa Bay Lightning,2,Southeast,Eastern,25,2,56,0.44642857142857145,32,-7,31,-6
2012-13,2013-03-18,Tampa Bay Lightning,2,Southeast,Eastern,27,2,58,0.46551724137931033,32,-5,32,-5
2012-13,2013-03-20,Tampa Bay Lightning,0,Southeast,Eastern,27,2,60,0.45,34,-7,32,-5
2012-13,2013-03-23,Tampa Bay Lightning,0,Southeast,Eastern,27,2,62,0.43548387096774194,34,-7,32,-5
2012-13,2013-03-25,Tampa Bay Lightning,0,Southeast,Eastern,27,2,64,0.421875,36,-9,33,-6
2012-13,2013-03-26,Tampa Bay Lightning,2,Southeast,Eastern,29,2,66,0.4393939393939394,38,-9,35,-6
2012-13,2013-03-29,Tampa Bay Lightning,2,Southeast,Eastern,31,2,68,0.45588235294117646,38,-7,35,-4
2012-13,2013-04-02,Tampa Bay Lightning,1,Southeast,Eastern,32,2,70,0.45714285714285713,38,-6,38,-6
2012-13,2013-04-04,Tampa Bay Lightning,2,Southeast,Eastern,34,2,72,0.4722222222222222,38,-4,39,-5
2012-13,2013-04-06,Tampa Bay Lightning,0,Southeast,Eastern,34,2,74,0.4594594594594595,40,-6,40,-6
2012-13,2013-04-07,Tampa Bay Lightning,0,Southeast,Eastern,34,2,76,0.4473684210526316,42,-8,42,-8
2012-13,2013-04-09,Tampa Bay Lightning,2,Southeast,Eastern,36,2,78,0.46153846153846156,44,-8,42,-6
2012-13,2013-04-11,Tampa Bay Lightning,0,Southeast,Eastern,36,2,80,0.45,46,-10,44,-8
2012-13,2013-04-13,Tampa Bay Lightning,1,Southeast,Eastern,37,2,82,0.45121951219512196,48,-11,46,-9
2012-13,2013-04-14,Tampa Bay Lightning,0,Southeast,Eastern,37,2,84,0.44047619047619047,48,-11,46,-9
2012-13,2013-04-17,Tampa Bay Lightning,1,Southeast,Eastern,38,2,86,0.4418604651162791,50,-12,46,-8
2012-13,2013-04-18,Tampa Bay Lightning,0,Southeast,Eastern,38,2,88,0.4318181818181818,50,-12,48,-10
2012-13,2013-04-21,Tampa Bay Lightning,0,Southeast,Eastern,38,2,90,0.4222222222222222,52,-14,52,-14
2012-13,2013-04-24,Tampa Bay Lightning,2,Southeast,Eastern,40,2,92,0.43478260869565216,54,-14,52,-12
2012-13,2013-04-25,Tampa Bay Lightning,0,Southeast,Eastern,40,2,94,0.425531914893617,55,-15,54,-14
2012-13,2013-04-27,Tampa Bay Lightning,0,Southeast,Eastern,40,2,96,0.4166666666666667,57,-17,54,-14
2012-13,2013-01-20,Toronto Maple Leafs,2,Northeast,Eastern,2,2,2,1.0,2,0,2,0
2012-13,2013-01-22,Toronto Maple Leafs,0,Northeast,Eastern,2,2,4,0.5,4,-2,2,0
2012-13,2013-01-24,Toronto Maple Leafs,2,Northeast,Eastern,4,2,6,0.6666666666666666,5,-1,3,1
2012-13,2013-01-25,Toronto Maple Leafs,0,Northeast,Eastern,4,2,8,0.5,6,-2,4,0
2012-13,2013-01-27,Toronto Maple Leafs,0,Northeast,Eastern,4,2,10,0.4,7,-3,4,0
2012-13,2013-01-30,Toronto Maple Leafs,2,Northeast,Eastern,6,2,12,0.5,11,-5,6,0
2012-13,2013-02-01,Toronto Maple Leafs,2,Northeast,Eastern,8,2,14,0.5714285714285714,11,-3,8,0
2012-13,2013-02-03,Toronto Maple Leafs,0,Northeast,Eastern,8,2,16,0.5,13,-5,8,0
2012-13,2013-02-05,Toronto Maple Leafs,0,Northeast,Eastern,8,2,18,0.4444444444444444,13,-5,8,0
2012-13,2013-02-06,Toronto Maple Leafs,2,Northeast,Eastern,10,2,20,0.5,13,-3,9,1
2012-13,2013-02-08,Toronto Maple Leafs,2,Northeast,Eastern,12,2,22,0.5454545454545454,15,-3,10,2
2012-13,2013-02-10,Toronto Maple Leafs,2,Northeast,Eastern,14,2,24,0.5833333333333334,15,-1,11,3
2012-13,2013-02-12,Toronto Maple Leafs,2,Northeast,Eastern,16,2,26,0.6153846153846154,17,-1,12,4
2012-13,2013-02-15,Toronto Maple Leafs,0,Northeast,Eastern,16,2,28,0.5714285714285714,18,-2,15,1
2012-13,2013-02-17,Toronto Maple Leafs,2,Northeast,Eastern,18,2,30,0.6,20,-2,16,2
2012-13,2013-02-19,Toronto Maple Leafs,2,Northeast,Eastern,20,2,32,0.625,21,-1,17,3
2012-13,2013-02-20,Toronto Maple Leafs,0,Northeast,Eastern,20,2,34,0.5882352941176471,23,-3,17,3
2012-13,2013-02-22,Toronto Maple Leafs,2,Northeast,Eastern,22,2,36,0.6111111111111112,24,-2,17,5
2012-13,2013-02-24,Toronto Maple Leafs,0,Northeast,Eastern,22,2,38,0.5789473684210527,26,-4,19,3
2012-13,2013-02-26,Toronto Maple Leafs,2,Northeast,Eastern,24,2,40,0.6,27,-3,19,5
2012-13,2013-02-28,Toronto Maple Leafs,0,Northeast,Eastern,24,2,42,0.5714285714285714,29,-5,19,5
2012-13,2013-03-01,Toronto Maple Leafs,2,Northeast,Eastern,26,2,44,0.5909090909090909,29,-3,21,5
2012-13,2013-03-05,Toronto Maple Leafs,2,Northeast,Eastern,28,2,46,0.6086956521739131,32,-4,23,5
2012-13,2013-03-07,Toronto Maple Leafs,2,Northeast,Eastern,30,2,48,0.625,32,-2,24,6
2012-13,2013-03-08,Toronto Maple Leafs,0,Northeast,Eastern,30,2,50,0.6,34,-4,26,4
2012-13,2013-03-10,Toronto Maple Leafs,1,Northeast,Eastern,31,2,52,0.5961538461538461,36,-5,28,3
2012-13,2013-03-13,Toronto Maple Leafs,0,Northeast,Eastern,31,2,54,0.5740740740740741,40,-9,28,3
2012-13,2013-03-14,Toronto Maple Leafs,0,Northeast,Eastern,31,2,56,0.5535714285714286,40,-9,28,3
2012-13,2013-03-16,Toronto Maple Leafs,1,Northeast,Eastern,32,2,58,0.5517241379310345,42,-10,31,1
2012-13,2013-03-20,Toronto Maple Leafs,2,Northeast,Eastern,34,2,60,0.5666666666666667,43,-9,32,2
2012-13,2013-03-21,Toronto Maple Leafs,1,Northeast,Eastern,35,2,62,0.5645161290322581,45,-10,32,3
2012-13,2013-03-23,Toronto Maple Leafs,2,Northeast,Eastern,37,2,64,0.578125,45,-8,32,5
2012-13,2013-03-25,Toronto Maple Leafs,1,Northeast,Eastern,38,2,66,0.5757575757575758,45,-7,33,5
2012-13,2013-03-26,Toronto Maple Leafs,2,Northeast,Eastern,40,2,68,0.5882352941176471,45,-5,35,5
2012-13,2013-03-28,Toronto Maple Leafs,2,Northeast,Eastern,42,2,70,0.6,47,-5,35,7
2012-13,2013-03-30,Toronto Maple Leafs,2,Northeast,Eastern,44,2,72,0.6111111111111112,49,-5,35,9
2012-13,2013-04-04,Toronto Maple Leafs,0,Northeast,Eastern,44,2,74,0.5945945945945946,53,-9,39,5
2012-13,2013-04-06,Toronto Maple Leafs,2,Northeast,Eastern,46,2,76,0.6052631578947368,55,-9,40,6
2012-13,2013-04-08,Toronto Maple Leafs,2,Northeast,Eastern,48,2,78,0.6153846153846154,55,-7,42,6
2012-13,2013-04-10,Toronto Maple Leafs,1,Northeast,Eastern,49,2,80,0.6125,56,-7,44,5
2012-13,2013-04-13,Toronto Maple Leafs,2,Northeast,Eastern,51,2,82,0.6219512195121951,57,-6,46,5
2012-13,2013-04-15,Toronto Maple Leafs,2,Northeast,Eastern,53,2,84,0.6309523809523809,57,-4,46,7
2012-13,2013-04-16,Toronto Maple Leafs,0,Northeast,Eastern,53,2,86,0.6162790697674418,57,-4,46,7
2012-13,2013-04-18,Toronto Maple Leafs,0,Northeast,Eastern,53,2,88,0.6022727272727273,59,-6,48,5
2012-13,2013-04-20,Toronto Maple Leafs,2,Northeast,Eastern,55,2,90,0.6111111111111112,59,-4,50,5
2012-13,2013-04-24,Toronto Maple Leafs,0,Northeast,Eastern,55,2,92,0.5978260869565217,59,-4,52,3
2012-13,2013-04-25,Toronto Maple Leafs,2,Northeast,Eastern,57,2,94,0.6063829787234043,61,-4,54,3
2012-13,2013-04-27,Toronto Maple Leafs,0,Northeast,Eastern,57,2,96,0.59375,63,-6,54,3
2012-13,2013-01-20,Vancouver Canucks,0,Northwest,Western,0,2,2,0.0,2,-2,1,-1
2012-13,2013-01-21,Vancouver Canucks,1,Northwest,Western,1,2,4,0.25,4,-3,2,-1
2012-13,2013-01-24,Vancouver Canucks,2,Northwest,Western,3,2,6,0.5,4,-1,3,0
2012-13,2013-01-26,Vancouver Canucks,2,Northwest,Western,5,2,8,0.625,5,0,4,1
2012-13,2013-01-28,Vancouver Canucks,0,Northwest,Western,5,2,10,0.5,5,0,5,0
2012-13,2013-01-29,Vancouver Canucks,1,Northwest,Western,6,2,12,0.5,6,0,5,1
2012-13,2013-01-31,Vancouver Canucks,2,Northwest,Western,8,2,14,0.5714285714285714,9,-1,7,1
2012-13,2013-02-02,Vancouver Canucks,2,Northwest,Western,10,2,16,0.625,10,0,9,1
2012-13,2013-02-05,Vancouver Canucks,2,Northwest,Western,12,2,18,0.6666666666666666,12,0,9,3
2012-13,2013-02-08,Vancouver Canucks,2,Northwest,Western,14,2,20,0.7,14,0,11,3
2012-13,2013-02-10,Vancouver Canucks,2,Northwest,Western,16,2,22,0.7272727272727273,16,0,13,3
2012-13,2013-02-13,Vancouver Canucks,2,Northwest,Western,18,2,24,0.75,18,0,14,4
2012-13,2013-02-16,Vancouver Canucks,0,Northwest,Western,18,2,26,0.6923076923076923,18,0,16,2
2012-13,2013-02-18,Vancouver Canucks,1,Northwest,Western,19,2,28,0.6785714285714286,19,0,16,3
2012-13,2013-02-20,Vancouver Canucks,1,Northwest,Western,20,2,30,0.6666666666666666,20,0,17,3
2012-13,2013-02-22,Vancouver Canucks,2,Northwest,Western,22,2,32,0.6875,22,0,18,4
2012-13,2013-02-23,Vancouver Canucks,2,Northwest,Western,24,2,34,0.7058823529411765,24,0,18,6
2012-13,2013-02-24,Vancouver Canucks,0,Northwest,Western,24,2,36,0.6666666666666666,24,0,19,5
2012-13,2013-02-27,Vancouver Canucks,0,Northwest,Western,24,2,38,0.631578947368421,24,0,21,3
2012-13,2013-03-03,Vancouver Canucks,2,Northwest,Western,26,2,40,0.65,26,0,23,3
2012-13,2013-03-04,Vancouver Canucks,0,Northwest,Western,26,2,42,0.6190476190476191,26,0,24,2
2012-13,2013-03-06,Vancouver Canucks,1,Northwest,Western,27,2,44,0.6136363636363636,27,0,24,3
2012-13,2013-03-08,Vancouver Canucks,1,Northwest,Western,28,2,46,0.6086956521739131,28,0,26,2
2012-13,2013-03-11,Vancouver Canucks,0,Northwest,Western,28,2,48,0.5833333333333334,28,0,28,0
2012-13,2013-03-12,Vancouver Canucks,2,Northwest,Western,30,2,50,0.6,30,0,28,2
2012-13,2013-03-15,Vancouver Canucks,2,Northwest,Western,32,2,52,0.6153846153846154,32,0,29,3
2012-13,2013-03-17,Vancouver Canucks,0,Northwest,Western,32,2,54,0.5925925925925926,32,0,30,2
2012-13,2013-03-19,Vancouver Canucks,0,Northwest,Western,32,2,56,0.5714285714285714,34,-2,30,2
2012-13,2013-03-20,Vancouver Canucks,2,Northwest,Western,34,2,58,0.5862068965517241,36,-2,30,4
2012-13,2013-03-22,Vancouver Canucks,2,Northwest,Western,36,2,60,0.6,36,0,32,4
2012-13,2013-03-23,Vancouver Canucks,2,Northwest,Western,38,2,62,0.6129032258064516,38,0,32,6
2012-13,2013-03-25,Vancouver Canucks,2,Northwest,Western,40,2,64,0.625,40,0,33,7
2012-13,2013-03-27,Vancouver Canucks,2,Northwest,Western,42,2,66,0.6363636363636364,42,0,34,8
2012-13,2013-03-29,Vancouver Canucks,2,Northwest,Western,44,2,68,0.6470588235294118,44,0,36,8
2012-13,2013-03-31,Vancouver Canucks,0,Northwest,Western,44,2,70,0.6285714285714286,44,0,37,7
2012-13,2013-04-02,Vancouver Canucks,0,Northwest,Western,44,2,72,0.6111111111111112,44,0,38,6
2012-13,2013-04-05,Vancouver Canucks,2,Northwest,Western,46,2,74,0.6216216216216216,46,0,40,6
2012-13,2013-04-07,Vancouver Canucks,2,Northwest,Western,48,2,76,0.631578947368421,48,0,43,5
2012-13,2013-04-09,Vancouver Canucks,2,Northwest,Western,50,2,78,0.6410256410256411,50,0,43,7
2012-13,2013-04-11,Vancouver Canucks,2,Northwest,Western,52,2,80,0.65,52,0,44,8
2012-13,2013-04-13,Vancouver Canucks,0,Northwest,Western,52,2,82,0.6341463414634146,52,0,45,7
2012-13,2013-04-16,Vancouver Canucks,2,Northwest,Western,54,2,84,0.6428571428571429,54,0,47,7
2012-13,2013-04-17,Vancouver Canucks,1,Northwest,Western,55,2,86,0.6395348837209303,55,0,47,8
2012-13,2013-04-19,Vancouver Canucks,0,Northwest,Western,55,2,88,0.625,55,0,49,6
2012-13,2013-04-21,Vancouver Canucks,2,Northwest,Western,57,2,90,0.6333333333333333,57,0,49,8
2012-13,2013-04-23,Vancouver Canucks,2,Northwest,Western,59,2,92,0.6413043478260869,59,0,51,8
2012-13,2013-04-26,Vancouver Canucks,0,Northwest,Western,59,2,94,0.6276595744680851,59,0,53,6
2012-13,2013-04-28,Vancouver Canucks,0,Northwest,Western,59,2,96,0.6145833333333334,59,0,55,4
2012-13,2013-01-20,Washington Capitals,0,Southeast,Eastern,0,2,2,0.0,2,-2,2,-2
2012-13,2013-01-23,Washington Capitals,0,Southeast,Eastern,0,2,4,0.0,4,-4,2,-2
2012-13,2013-01-25,Washington Capitals,0,Southeast,Eastern,0,2,6,0.0,4,-4,4,-4
2012-13,2013-01-26,Washington Capitals,1,Southeast,Eastern,1,2,8,0.125,6,-5,4,-3
2012-13,2013-01-27,Washington Capitals,2,Southeast,Eastern,3,2,10,0.3,8,-5,4,-1
2012-13,2013-01-30,Washington Capitals,0,Southeast,Eastern,3,2,12,0.25,10,-7,6,-3
2012-13,2013-02-01,Washington Capitals,0,Southeast,Eastern,3,2,14,0.21428571428571427,10,-7,8,-5
2012-13,2013-02-02,Washington Capitals,2,Southeast,Eastern,5,2,16,0.3125,12,-7,8,-3
2012-13,2013-02-03,Washington Capitals,0,Southeast,Eastern,5,2,18,0.2777777777777778,12,-7,8,-3
2012-13,2013-02-06,Washington Capitals,0,Southeast,Eastern,5,2,20,0.25,12,-7,9,-4
2012-13,2013-02-08,Washington Capitals,0,Southeast,Eastern,5,2,22,0.22727272727272727,12,-7,10,-5
2012-13,2013-02-10,Washington Capitals,2,Southeast,Eastern,7,2,24,0.2916666666666667,12,-5,11,-4
2012-13,2013-02-13,Washington Capitals,2,Southeast,Eastern,9,2,26,0.34615384615384615,15,-6,14,-5
2012-13,2013-02-15,Washington Capitals,2,Southeast,Eastern,11,2,28,0.39285714285714285,17,-6,15,-4
2012-13,2013-02-17,Washington Capitals,0,Southeast,Eastern,11,2,30,0.36666666666666664,17,-6,16,-5
2012-13,2013-02-22,Washington Capitals,0,Southeast,Eastern,11,2,32,0.34375,17,-6,17,-6
2012-13,2013-02-23,Washington Capitals,2,Southeast,Eastern,13,2,34,0.38235294117647056,17,-4,18,-5
2012-13,2013-02-27,Washington Capitals,2,Southeast,Eastern,15,2,36,0.4166666666666667,19,-4,19,-4
2012-13,2013-02-28,Washington Capitals,0,Southeast,Eastern,15,2,38,0.39473684210526316,19,-4,19,-4
2012-13,2013-03-02,Washington Capitals,2,Southeast,Eastern,17,2,40,0.425,21,-4,21,-4
2012-13,2013-03-06,Washington Capitals,2,Southeast,Eastern,19,2,42,0.4523809523809524,27,-8,24,-5
2012-13,2013-03-08,Washington Capitals,2,Southeast,Eastern,21,2,44,0.4772727272727273,27,-6,26,-5
2012-13,2013-03-09,Washington Capitals,0,Southeast,Eastern,21,2,46,0.45652173913043476,27,-6,26,-5
2012-13,2013-03-10,Washington Capitals,0,Southeast,Eastern,21,2,48,0.4375,29,-8,28,-7
2012-13,2013-03-12,Washington Capitals,0,Southeast,Eastern,21,2,50,0.42,31,-10,28,-7
2012-13,2013-03-14,Washington Capitals,2,Southeast,Eastern,23,2,52,0.4423076923076923,31,-8,28,-5
2012-13,2013-03-16,Washington Capitals,0,Southeast,Eastern,23,2,54,0.42592592592592593,32,-9,31,-8
2012-13,2013-03-17,Washington Capitals,2,Southeast,Eastern,25,2,56,0.44642857142857145,32,-7,31,-6
2012-13,2013-03-19,Washington Capitals,0,Southeast,Eastern,25,2,58,0.43103448275862066,32,-7,32,-7
2012-13,2013-03-22,Washington Capitals,2,Southeast,Eastern,27,2,60,0.45,34,-7,32,-5
2012-13,2013-03-22,Washington Capitals,2,Southeast,Eastern,29,2,62,0.46774193548387094,34,-5,32,-3
2012-13,2013-03-24,Washington Capitals,2,Southeast,Eastern,31,2,64,0.484375,34,-3,33,-2
2012-13,2013-03-26,Washington Capitals,0,Southeast,Eastern,31,2,66,0.4696969696969697,38,-7,35,-4
2012-13,2013-03-30,Washington Capitals,2,Southeast,Eastern,33,2,68,0.4852941176470588,38,-5,35,-2
2012-13,2013-03-31,Washington Capitals,1,Southeast,Eastern,34,2,70,0.4857142857142857,38,-4,35,-1
2012-13,2013-04-02,Washington Capitals,2,Southeast,Eastern,36,2,72,0.5,38,-2,38,-2
2012-13,2013-04-04,Washington Capitals,2,Southeast,Eastern,38,2,74,0.5135135135135135,38,0,39,-1
2012-13,2013-04-06,Washington Capitals,2,Southeast,Eastern,40,2,76,0.5263157894736842,40,0,40,0
2012-13,2013-04-07,Washington Capitals,2,Southeast,Eastern,42,2,78,0.5384615384615384,42,0,42,0
2012-13,2013-04-09,Washington Capitals,2,Southeast,Eastern,44,2,80,0.55,44,0,42,2
2012-13,2013-04-11,Washington Capitals,2,Southeast,Eastern,46,2,82,0.5609756097560976,46,0,44,2
2012-13,2013-04-13,Washington Capitals,2,Southeast,Eastern,48,2,84,0.5714285714285714,48,0,46,2
2012-13,2013-04-16,Washington Capitals,2,Southeast,Eastern,50,2,86,0.5813953488372093,50,0,46,4
2012-13,2013-04-18,Washington Capitals,0,Southeast,Eastern,50,2,88,0.5681818181818182,50,0,48,2
2012-13,2013-04-20,Washington Capitals,2,Southeast,Eastern,52,2,90,0.5777777777777777,52,0,50,2
2012-13,2013-04-23,Washington Capitals,2,Southeast,Eastern,54,2,92,0.5869565217391305,54,0,52,2
2012-13,2013-04-25,Washington Capitals,1,Southeast,Eastern,55,2,94,0.5851063829787234,55,0,54,1
2012-13,2013-04-27,Washington Capitals,2,Southeast,Eastern,57,2,96,0.59375,57,0,54,3
2012-13,2013-01-19,Winnipeg Jets,0,Southeast,Eastern,0,2,2,0.0,0,0,0,0
2012-13,2013-01-21,Winnipeg Jets,1,Southeast,Eastern,1,2,4,0.25,2,-1,2,-1
2012-13,2013-01-23,Winnipeg Jets,2,Southeast,Eastern,3,2,6,0.5,4,-1,2,1
2012-13,2013-01-26,Winnipeg Jets,2,Southeast,Eastern,5,2,8,0.625,6,-1,4,1
2012-13,2013-01-28,Winnipeg Jets,2,Southeast,Eastern,7,2,10,0.7,8,-1,5,2
2012-13,2013-01-30,Winnipeg Jets,0,Southeast,Eastern,7,2,12,0.5833333333333334,10,-3,6,1
2012-13,2013-02-01,Winnipeg Jets,0,Southeast,Eastern,7,2,14,0.5,10,-3,8,-1
2012-13,2013-02-02,Winnipeg Jets,0,Southeast,Eastern,7,2,16,0.4375,12,-5,8,-1
2012-13,2013-02-06,Winnipeg Jets,2,Southeast,Eastern,9,2,18,0.5,12,-3,9,0
2012-13,2013-02-08,Winnipeg Jets,0,Southeast,Eastern,9,2,20,0.45,12,-3,10,-1
2012-13,2013-02-09,Winnipeg Jets,2,Southeast,Eastern,11,2,22,0.5,12,-1,11,0
2012-13,2013-02-13,Winnipeg Jets,0,Southeast,Eastern,11,2,24,0.4583333333333333,15,-4,14,-3
2012-13,2013-02-16,Winnipeg Jets,0,Southeast,Eastern,11,2,26,0.4230769230769231,17,-6,15,-4
2012-13,2013-02-17,Winnipeg Jets,0,Southeast,Eastern,11,2,28,0.39285714285714285,17,-6,16,-5
2012-13,2013-02-20,Winnipeg Jets,2,Southeast,Eastern,13,2,30,0.43333333333333335,17,-4,17,-4
2012-13,2013-02-22,Winnipeg Jets,2,Southeast,Eastern,15,2,32,0.46875,17,-2,17,-2
2012-13,2013-02-23,Winnipeg Jets,0,Southeast,Eastern,15,2,34,0.4411764705882353,17,-2,18,-3
2012-13,2013-02-24,Winnipeg Jets,2,Southeast,Eastern,17,2,36,0.4722222222222222,19,-2,19,-2
2012-13,2013-02-27,Winnipeg Jets,2,Southeast,Eastern,19,2,38,0.5,19,0,19,0
2012-13,2013-03-01,Winnipeg Jets,2,Southeast,Eastern,21,2,40,0.525,21,0,21,0
2012-13,2013-03-02,Winnipeg Jets,0,Southeast,Eastern,21,2,42,0.5,21,0,21,0
2012-13,2013-03-06,Winnipeg Jets,0,Southeast,Eastern,21,2,44,0.4772727272727273,27,-6,24,-3
2012-13,2013-03-08,Winnipeg Jets,2,Southeast,Eastern,23,2,46,0.5,27,-4,26,-3
2012-13,2013-03-09,Winnipeg Jets,2,Southeast,Eastern,25,2,48,0.5208333333333334,27,-2,26,-1
2012-13,2013-03-10,Winnipeg Jets,1,Southeast,Eastern,26,2,50,0.52,29,-3,28,-2
2012-13,2013-03-13,Winnipeg Jets,2,Southeast,Eastern,28,2,52,0.5384615384615384,31,-3,28,0
2012-13,2013-03-15,Winnipeg Jets,2,Southeast,Eastern,30,2,54,0.5555555555555556,31,-1,30,0
2012-13,2013-03-16,Winnipeg Jets,2,Southeast,Eastern,32,2,56,0.5714285714285714,32,0,31,1
2012-13,2013-03-17,Winnipeg Jets,0,Southeast,Eastern,32,2,58,0.5517241379310345,32,0,31,1
2012-13,2013-03-20,Winnipeg Jets,2,Southeast,Eastern,34,2,60,0.5666666666666667,34,0,32,2
2012-13,2013-03-22,Winnipeg Jets,0,Southeast,Eastern,34,2,62,0.5483870967741935,34,0,32,2
2012-13,2013-03-22,Winnipeg Jets,0,Southeast,Eastern,34,2,64,0.53125,34,0,32,2
2012-13,2013-03-25,Winnipeg Jets,2,Southeast,Eastern,36,2,66,0.5454545454545454,36,0,33,3
2012-13,2013-03-26,Winnipeg Jets,2,Southeast,Eastern,38,2,68,0.5588235294117647,38,0,35,3
2012-13,2013-03-28,Winnipeg Jets,0,Southeast,Eastern,38,2,70,0.5428571428571428,38,0,35,3
2012-13,2013-03-30,Winnipeg Jets,0,Southeast,Eastern,38,2,72,0.5277777777777778,38,0,35,3
2012-13,2013-04-01,Winnipeg Jets,0,Southeast,Eastern,38,2,74,0.5135135135135135,38,0,37,1
2012-13,2013-04-02,Winnipeg Jets,0,Southeast,Eastern,38,2,76,0.5,38,0,38,0
2012-13,2013-04-04,Winnipeg Jets,0,Southeast,Eastern,38,2,78,0.48717948717948717,38,0,39,-1
2012-13,2013-04-06,Winnipeg Jets,2,Southeast,Eastern,40,2,80,0.5,40,0,40,0
2012-13,2013-04-10,Winnipeg Jets,2,Southeast,Eastern,42,2,82,0.5121951219512195,44,-2,44,-2
2012-13,2013-04-12,Winnipeg Jets,2,Southeast,Eastern,44,2,84,0.5238095238095238,46,-2,44,0
2012-13,2013-04-17,Winnipeg Jets,2,Southeast,Eastern,46,2,86,0.5348837209302325,50,-4,46,0
2012-13,2013-04-19,Winnipeg Jets,2,Southeast,Eastern,48,2,88,0.5454545454545454,50,-2,50,-2
2012-13,2013-04-20,Winnipeg Jets,1,Southeast,Eastern,49,2,90,0.5444444444444444,52,-3,50,-1
2012-13,2013-04-22,Winnipeg Jets,2,Southeast,Eastern,51,2,92,0.5543478260869565,52,-1,52,-1
2012-13,2013-04-23,Winnipeg Jets,0,Southeast,Eastern,51,2,94,0.5425531914893617,54,-3,52,-1
2012-13,2013-04-26,Winnipeg Jets,0,Southeast,Eastern,51,2,96,0.53125,55,-4,54,-3
2013-14,2013-10-03,Anaheim Ducks,0,Pacific,Western,0,2,2,0.0,0,0,0,0
2013-14,2013-10-06,Anaheim Ducks,2,Pacific,Western,2,2,4,0.5,2,0,2,0
2013-14,2013-10-07,Anaheim Ducks,2,Pacific,Western,4,2,6,0.6666666666666666,4,0,3,1
2013-14,2013-10-11,Anaheim Ducks,2,Pacific,Western,6,2,8,0.75,6,0,6,0
2013-14,2013-10-14,Anaheim Ducks,2,Pacific,Western,8,2,10,0.8,8,0,8,0
2013-14,2013-10-17,Anaheim Ducks,2,Pacific,Western,10,2,12,0.8333333333333334,10,0,8,2
2013-14,2013-10-19,Anaheim Ducks,2,Pacific,Western,12,2,14,0.8571428571428571,11,1,10,2
2013-14,2013-10-21,Anaheim Ducks,2,Pacific,Western,14,2,16,0.875,12,2,11,3
2013-14,2013-10-22,Anaheim Ducks,0,Pacific,Western,14,2,18,0.7777777777777778,13,1,11,3
2013-14,2013-10-24,Anaheim Ducks,0,Pacific,Western,14,2,20,0.7,14,0,11,3
2013-14,2013-10-25,Anaheim Ducks,2,Pacific,Western,16,2,22,0.7272727272727273,15,1,13,3
2013-14,2013-10-27,Anaheim Ducks,2,Pacific,Western,18,2,24,0.75,17,1,14,4
2013-14,2013-10-29,Anaheim Ducks,2,Pacific,Western,20,2,26,0.7692307692307693,19,1,15,5
2013-14,2013-10-31,Anaheim Ducks,1,Pacific,Western,21,2,28,0.75,19,2,16,5
2013-14,2013-11-02,Anaheim Ducks,2,Pacific,Western,23,2,30,0.7666666666666667,21,2,18,5
2013-14,2013-11-05,Anaheim Ducks,2,Pacific,Western,25,2,32,0.78125,22,3,18,7
2013-14,2013-11-07,Anaheim Ducks,2,Pacific,Western,27,2,34,0.7941176470588235,24,3,20,7
2013-14,2013-11-09,Anaheim Ducks,2,Pacific,Western,29,2,36,0.8055555555555556,24,5,22,7
2013-14,2013-11-11,Anaheim Ducks,2,Pacific,Western,31,2,38,0.8157894736842105,25,6,24,7
2013-14,2013-11-13,Anaheim Ducks,0,Pacific,Western,31,2,40,0.775,27,4,24,7
2013-14,2013-11-15,Anaheim Ducks,0,Pacific,Western,31,2,42,0.7380952380952381,29,2,25,6
2013-14,2013-11-16,Anaheim Ducks,1,Pacific,Western,32,2,44,0.7272727272727273,29,3,27,5
2013-14,2013-11-19,Anaheim Ducks,0,Pacific,Western,32,2,46,0.6956521739130435,31,1,28,4
2013-14,2013-11-21,Anaheim Ducks,1,Pacific,Western,33,2,48,0.6875,31,2,30,3
2013-14,2013-11-23,Anaheim Ducks,2,Pacific,Western,35,2,50,0.7,32,3,32,3
2013-14,2013-11-24,Anaheim Ducks,2,Pacific,Western,37,2,52,0.7115384615384616,33,4,32,5
2013-14,2013-11-27,Anaheim Ducks,0,Pacific,Western,37,2,54,0.6851851851851852,35,2,32,5
2013-14,2013-11-29,Anaheim Ducks,2,Pacific,Western,39,2,56,0.6964285714285714,36,3,34,5
2013-14,2013-12-01,Anaheim Ducks,1,Pacific,Western,40,2,58,0.6896551724137931,36,4,34,6
2013-14,2013-12-04,Anaheim Ducks,1,Pacific,Western,41,2,60,0.6833333333333333,40,1,36,5
2013-14,2013-12-07,Anaheim Ducks,2,Pacific,Western,43,2,62,0.6935483870967742,40,3,37,6
2013-14,2013-12-08,Anaheim Ducks,2,Pacific,Western,45,2,64,0.703125,42,3,37,8
2013-14,2013-12-10,Anaheim Ducks,2,Pacific,Western,47,2,66,0.7121212121212122,42,5,40,7
2013-14,2013-12-12,Anaheim Ducks,2,Pacific,Western,49,2,68,0.7205882352941176,44,5,40,9
2013-14,2013-12-16,Anaheim Ducks,2,Pacific,Western,51,2,70,0.7285714285714285,46,5,43,8
2013-14,2013-12-18,Anaheim Ducks,2,Pacific,Western,53,2,72,0.7361111111111112,48,5,45,8
2013-14,2013-12-21,Anaheim Ducks,2,Pacific,Western,55,2,74,0.7432432432432432,48,7,45,10
2013-14,2013-12-22,Anaheim Ducks,2,Pacific,Western,57,2,76,0.75,50,7,45,12
2013-14,2013-12-24,Anaheim Ducks,2,Pacific,Western,59,2,78,0.7564102564102564,52,7,45,14
2013-14,2013-12-29,Anaheim Ducks,2,Pacific,Western,61,2,80,0.7625,54,7,47,14
2013-14,2013-12-30,Anaheim Ducks,0,Pacific,Western,61,2,82,0.7439024390243902,54,7,47,14
2013-14,2014-01-01,Anaheim Ducks,2,Pacific,Western,63,2,84,0.75,54,9,49,14
2013-14,2014-01-04,Anaheim Ducks,2,Pacific,Western,65,2,86,0.7558139534883721,54,11,49,16
2013-14,2014-01-06,Anaheim Ducks,2,Pacific,Western,67,2,88,0.7613636363636364,56,11,49,18
2013-14,2014-01-08,Anaheim Ducks,2,Pacific,Western,69,2,90,0.7666666666666667,57,12,51,18
2013-14,2014-01-10,Anaheim Ducks,2,Pacific,Western,71,2,92,0.7717391304347826,59,12,53,18
2013-14,2014-01-12,Anaheim Ducks,2,Pacific,Western,73,2,94,0.776595744680851,59,14,53,20
2013-14,2014-01-13,Anaheim Ducks,2,Pacific,Western,75,2,96,0.78125,59,16,55,20
2013-14,2014-01-16,Anaheim Ducks,2,Pacific,Western,77,2,98,0.7857142857142857,61,16,55,22
2013-14,2014-01-18,Anaheim Ducks,0,Pacific,Western,77,2,100,0.77,63,14,57,20
2013-14,2014-01-19,Anaheim Ducks,2,Pacific,Western,79,2,102,0.7745098039215687,64,15,59,20
2013-14,2014-01-22,Anaheim Ducks,0,Pacific,Western,79,2,104,0.7596153846153846,64,15,59,20
2013-14,2014-01-24,Anaheim Ducks,2,Pacific,Western,81,2,106,0.7641509433962265,64,17,61,20
2013-14,2014-01-26,Anaheim Ducks,2,Pacific,Western,83,2,108,0.7685185185185185,64,19,61,22
2013-14,2014-01-29,Anaheim Ducks,0,Pacific,Western,83,2,110,0.7545454545454545,66,17,63,20
2013-14,2014-01-31,Anaheim Ducks,2,Pacific,Western,85,2,112,0.7589285714285714,66,19,63,22
2013-14,2014-02-02,Anaheim Ducks,0,Pacific,Western,85,2,114,0.7456140350877193,66,19,63,22
2013-14,2014-02-04,Anaheim Ducks,0,Pacific,Western,85,2,116,0.7327586206896551,66,19,63,22
2013-14,2014-02-06,Anaheim Ducks,0,Pacific,Western,85,2,118,0.7203389830508474,66,19,63,22
2013-14,2014-02-09,Anaheim Ducks,2,Pacific,Western,87,2,120,0.725,68,19,64,23
2013-14,2014-03-01,Anaheim Ducks,2,Pacific,Western,89,2,122,0.7295081967213115,74,15,66,23
2013-14,2014-03-03,Anaheim Ducks,2,Pacific,Western,91,2,124,0.7338709677419355,74,17,66,25
2013-14,2014-03-06,Anaheim Ducks,1,Pacific,Western,92,2,126,0.7301587301587301,76,16,68,24
2013-14,2014-03-08,Anaheim Ducks,1,Pacific,Western,93,2,128,0.7265625,78,15,70,23
2013-14,2014-03-11,Anaheim Ducks,0,Pacific,Western,93,2,130,0.7153846153846154,82,11,73,20
2013-14,2014-03-13,Anaheim Ducks,0,Pacific,Western,93,2,132,0.7045454545454546,82,11,74,19
2013-14,2014-03-15,Anaheim Ducks,2,Pacific,Western,95,2,134,0.7089552238805971,82,13,75,20
2013-14,2014-03-16,Anaheim Ducks,2,Pacific,Western,97,2,136,0.7132352941176471,82,15,75,22
2013-14,2014-03-19,Anaheim Ducks,0,Pacific,Western,97,2,138,0.7028985507246377,82,15,77,20
2013-14,2014-03-21,Anaheim Ducks,0,Pacific,Western,97,2,140,0.6928571428571428,84,13,79,18
2013-14,2014-03-24,Anaheim Ducks,2,Pacific,Western,99,2,142,0.6971830985915493,88,11,80,19
2013-14,2014-03-27,Anaheim Ducks,2,Pacific,Western,101,2,144,0.7013888888888888,92,9,84,17
2013-14,2014-03-29,Anaheim Ducks,1,Pacific,Western,102,2,146,0.6986301369863014,92,10,84,18
2013-14,2014-03-30,Anaheim Ducks,2,Pacific,Western,104,2,148,0.7027027027027027,94,10,84,20
2013-14,2014-04-01,Anaheim Ducks,2,Pacific,Western,106,2,150,0.7066666666666667,94,12,85,21
2013-14,2014-04-03,Anaheim Ducks,2,Pacific,Western,108,2,152,0.7105263157894737,96,12,85,23
2013-14,2014-04-05,Anaheim Ducks,0,Pacific,Western,108,2,154,0.7012987012987013,96,12,87,21
2013-14,2014-04-07,Anaheim Ducks,0,Pacific,Western,108,2,156,0.6923076923076923,96,12,87,21
2013-14,2014-04-08,Anaheim Ducks,2,Pacific,Western,110,2,158,0.6962025316455697,96,14,87,23
2013-14,2014-04-10,Anaheim Ducks,2,Pacific,Western,112,2,160,0.7,97,15,89,23
2013-14,2014-04-13,Anaheim Ducks,2,Pacific,Western,114,2,162,0.7037037037037037,100,14,91,23
2013-14,2014-04-14,Anaheim Ducks,2,Pacific,Western,116,2,164,0.7073170731707317,100,16,91,25
2013-14,2013-10-03,Boston Bruins,2,Atlantic,Eastern,2,2,2,1.0,2,0,0,2
2013-14,2013-10-05,Boston Bruins,2,Atlantic,Eastern,4,2,4,1.0,4,0,2,2
2013-14,2013-10-10,Boston Bruins,0,Atlantic,Eastern,4,2,6,0.6666666666666666,4,0,4,0
2013-14,2013-10-12,Boston Bruins,2,Atlantic,Eastern,6,2,8,0.75,6,0,4,2
2013-14,2013-10-14,Boston Bruins,0,Atlantic,Eastern,6,2,10,0.6,6,0,5,1
2013-14,2013-10-17,Boston Bruins,2,Atlantic,Eastern,8,2,12,0.6666666666666666,10,-2,8,0
2013-14,2013-10-19,Boston Bruins,2,Atlantic,Eastern,10,2,14,0.7142857142857143,10,0,8,2
2013-14,2013-10-24,Boston Bruins,2,Atlantic,Eastern,12,2,16,0.75,13,-1,10,2
2013-14,2013-10-24,Boston Bruins,2,Atlantic,Eastern,14,2,18,0.7777777777777778,13,1,10,4
2013-14,2013-10-26,Boston Bruins,0,Atlantic,Eastern,14,2,20,0.7,14,0,11,3
2013-14,2013-10-31,Boston Bruins,2,Atlantic,Eastern,16,2,22,0.7272727272727273,16,0,11,5
2013-14,2013-10-31,Boston Bruins,0,Atlantic,Eastern,16,2,24,0.6666666666666666,16,0,11,5
2013-14,2013-11-02,Boston Bruins,0,Atlantic,Eastern,16,2,26,0.6153846153846154,18,-2,14,2
2013-14,2013-11-06,Boston Bruins,1,Atlantic,Eastern,17,2,28,0.6071428571428571,20,-3,15,2
2013-14,2013-11-08,Boston Bruins,2,Atlantic,Eastern,19,2,30,0.6333333333333333,20,-1,16,3
2013-14,2013-11-10,Boston Bruins,2,Atlantic,Eastern,21,2,32,0.65625,22,-1,18,3
2013-14,2013-11-11,Boston Bruins,2,Atlantic,Eastern,23,2,34,0.6764705882352942,22,1,18,5
2013-14,2013-11-15,Boston Bruins,2,Atlantic,Eastern,25,2,36,0.6944444444444444,23,2,18,7
2013-14,2013-11-16,Boston Bruins,0,Atlantic,Eastern,25,2,38,0.6578947368421053,24,1,20,5
2013-14,2013-11-19,Boston Bruins,2,Atlantic,Eastern,27,2,40,0.675,25,2,20,7
2013-14,2013-11-20,Boston Bruins,2,Atlantic,Eastern,29,2,42,0.6904761904761905,27,2,20,9
2013-14,2013-11-22,Boston Bruins,1,Atlantic,Eastern,30,2,44,0.6818181818181818,27,3,23,7
2013-14,2013-11-23,Boston Bruins,2,Atlantic,Eastern,32,2,46,0.6956521739130435,27,5,23,9
2013-14,2013-11-26,Boston Bruins,2,Atlantic,Eastern,34,2,48,0.7083333333333334,29,5,24,10
2013-14,2013-11-28,Boston Bruins,0,Atlantic,Eastern,34,2,50,0.68,31,3,26,8
2013-14,2013-11-29,Boston Bruins,2,Atlantic,Eastern,36,2,52,0.6923076923076923,33,3,26,10
2013-14,2013-12-01,Boston Bruins,2,Atlantic,Eastern,38,2,54,0.7037037037037037,33,5,28,10
2013-14,2013-12-06,Boston Bruins,0,Atlantic,Eastern,38,2,56,0.6785714285714286,35,3,30,8
2013-14,2013-12-08,Boston Bruins,2,Atlantic,Eastern,40,2,58,0.6896551724137931,37,3,31,9
2013-14,2013-12-09,Boston Bruins,2,Atlantic,Eastern,42,2,60,0.7,37,5,31,11
2013-14,2013-12-11,Boston Bruins,2,Atlantic,Eastern,44,2,62,0.7096774193548387,38,6,32,12
2013-14,2013-12-13,Boston Bruins,2,Atlantic,Eastern,46,2,64,0.71875,39,7,33,13
2013-14,2013-12-15,Boston Bruins,0,Atlantic,Eastern,46,2,66,0.696969696969697,39,7,35,11
2013-14,2013-12-18,Boston Bruins,2,Atlantic,Eastern,48,2,68,0.7058823529411765,43,5,35,13
2013-14,2013-12-20,Boston Bruins,0,Atlantic,Eastern,48,2,70,0.6857142857142857,45,3,36,12
2013-14,2013-12-22,Boston Bruins,2,Atlantic,Eastern,50,2,72,0.6944444444444444,47,3,37,13
2013-14,2013-12-24,Boston Bruins,2,Atlantic,Eastern,52,2,74,0.7027027027027027,47,5,38,14
2013-14,2013-12-28,Boston Bruins,2,Atlantic,Eastern,54,2,76,0.7105263157894737,47,7,38,16
2013-14,2013-12-29,Boston Bruins,0,Atlantic,Eastern,54,2,78,0.6923076923076923,49,5,40,14
2013-14,2014-01-01,Boston Bruins,0,Atlantic,Eastern,54,2,80,0.675,50,4,44,10
2013-14,2014-01-03,Boston Bruins,2,Atlantic,Eastern,56,2,82,0.6829268292682927,52,4,44,12
2013-14,2014-01-04,Boston Bruins,2,Atlantic,Eastern,58,2,84,0.6904761904761905,52,6,44,14
2013-14,2014-01-08,Boston Bruins,0,Atlantic,Eastern,58,2,86,0.6744186046511628,55,3,46,12
2013-14,2014-01-10,Boston Bruins,0,Atlantic,Eastern,58,2,88,0.6590909090909091,55,3,47,11
2013-14,2014-01-12,Boston Bruins,2,Atlantic,Eastern,60,2,90,0.6666666666666666,57,3,49,11
2013-14,2014-01-15,Boston Bruins,0,Atlantic,Eastern,60,2,92,0.6521739130434783,57,3,51,9
2013-14,2014-01-17,Boston Bruins,2,Atlantic,Eastern,62,2,94,0.6595744680851063,59,3,52,10
2013-14,2014-01-19,Boston Bruins,1,Atlantic,Eastern,63,2,96,0.65625,59,4,52,11
2013-14,2014-01-20,Boston Bruins,2,Atlantic,Eastern,65,2,98,0.6632653061224489,59,6,52,13
2013-14,2014-01-25,Boston Bruins,2,Atlantic,Eastern,67,2,100,0.67,59,8,56,11
2013-14,2014-01-28,Boston Bruins,2,Atlantic,Eastern,69,2,102,0.6764705882352942,60,9,57,12
2013-14,2014-01-29,Boston Bruins,2,Atlantic,Eastern,71,2,104,0.6826923076923077,62,9,57,14
2013-14,2014-01-31,Boston Bruins,0,Atlantic,Eastern,71,2,106,0.6698113207547169,64,7,58,13
2013-14,2014-02-01,Boston Bruins,2,Atlantic,Eastern,73,2,108,0.6759259259259259,64,9,59,14
2013-14,2014-02-05,Boston Bruins,2,Atlantic,Eastern,75,2,110,0.6818181818181818,66,9,62,13
2013-14,2014-02-07,Boston Bruins,1,Atlantic,Eastern,76,2,112,0.6785714285714286,68,8,64,12
2013-14,2014-02-08,Boston Bruins,2,Atlantic,Eastern,78,2,114,0.6842105263157895,70,8,64,14
2013-14,2014-02-27,Boston Bruins,1,Atlantic,Eastern,79,2,116,0.6810344827586207,71,8,66,13
2013-14,2014-03-01,Boston Bruins,0,Atlantic,Eastern,79,2,118,0.6694915254237288,73,6,68,11
2013-14,2014-03-03,Boston Bruins,2,Atlantic,Eastern,81,2,120,0.675,73,8,68,13
2013-14,2014-03-05,Boston Bruins,2,Atlantic,Eastern,83,2,122,0.680327868852459,73,10,69,14
2013-14,2014-03-07,Boston Bruins,2,Atlantic,Eastern,85,2,124,0.6854838709677419,74,11,69,16
2013-14,2014-03-09,Boston Bruins,2,Atlantic,Eastern,87,2,126,0.6904761904761905,76,11,71,16
2013-14,2014-03-09,Boston Bruins,2,Atlantic,Eastern,89,2,128,0.6953125,76,13,71,18
2013-14,2014-03-12,Boston Bruins,2,Atlantic,Eastern,91,2,130,0.7,77,14,73,18
2013-14,2014-03-13,Boston Bruins,2,Atlantic,Eastern,93,2,132,0.7045454545454546,77,16,73,20
2013-14,2014-03-15,Boston Bruins,2,Atlantic,Eastern,95,2,134,0.7089552238805971,79,16,74,21
2013-14,2014-03-17,Boston Bruins,2,Atlantic,Eastern,97,2,136,0.7132352941176471,81,16,76,21
2013-14,2014-03-18,Boston Bruins,2,Atlantic,Eastern,99,2,138,0.717391304347826,81,18,76,23
2013-14,2014-03-22,Boston Bruins,2,Atlantic,Eastern,101,2,140,0.7214285714285714,85,16,79,22
2013-14,2014-03-23,Boston Bruins,2,Atlantic,Eastern,103,2,142,0.7253521126760564,85,18,80,23
2013-14,2014-03-24,Boston Bruins,1,Atlantic,Eastern,104,2,144,0.7222222222222222,87,17,80,24
2013-14,2014-03-27,Boston Bruins,2,Atlantic,Eastern,106,2,146,0.726027397260274,89,17,80,26
2013-14,2014-03-29,Boston Bruins,2,Atlantic,Eastern,108,2,148,0.7297297297297297,91,17,82,26
2013-14,2014-03-30,Boston Bruins,2,Atlantic,Eastern,110,2,150,0.7333333333333333,91,19,82,28
2013-14,2014-04-03,Boston Bruins,0,Atlantic,Eastern,110,2,152,0.7236842105263158,93,17,85,25
2013-14,2014-04-03,Boston Bruins,1,Atlantic,Eastern,111,2,154,0.7207792207792207,93,18,85,26
2013-14,2014-04-05,Boston Bruins,2,Atlantic,Eastern,113,2,156,0.7243589743589743,93,20,85,28
2013-14,2014-04-09,Boston Bruins,1,Atlantic,Eastern,114,2,158,0.7215189873417721,95,19,89,25
2013-14,2014-04-11,Boston Bruins,1,Atlantic,Eastern,115,2,160,0.71875,98,17,91,24
2013-14,2014-04-12,Boston Bruins,2,Atlantic,Eastern,117,2,162,0.7222222222222222,99,18,91,26
2013-14,2014-04-13,Boston Bruins,0,Atlantic,Eastern,117,2,164,0.7134146341463414,100,17,93,24
2013-14,2013-10-03,Buffalo Sabres,0,Atlantic,Eastern,0,2,2,0.0,2,-2,0,0
2013-14,2013-10-04,Buffalo Sabres,0,Atlantic,Eastern,0,2,4,0.0,2,-2,2,-2
2013-14,2013-10-05,Buffalo Sabres,0,Atlantic,Eastern,0,2,6,0.0,4,-4,2,-2
2013-14,2013-10-08,Buffalo Sabres,1,Atlantic,Eastern,1,2,8,0.125,4,-3,3,-2
2013-14,2013-10-10,Buffalo Sabres,0,Atlantic,Eastern,1,2,10,0.1,4,-3,4,-3
2013-14,2013-10-13,Buffalo Sabres,0,Atlantic,Eastern,1,2,12,0.08333333333333333,6,-5,5,-4
2013-14,2013-10-14,Buffalo Sabres,0,Atlantic,Eastern,1,2,14,0.07142857142857142,6,-5,5,-4
2013-14,2013-10-15,Buffalo Sabres,2,Atlantic,Eastern,3,2,16,0.1875,8,-5,6,-3
2013-14,2013-10-17,Buffalo Sabres,0,Atlantic,Eastern,3,2,18,0.16666666666666666,10,-7,8,-5
2013-14,2013-10-19,Buffalo Sabres,0,Atlantic,Eastern,3,2,20,0.15,10,-7,8,-5
2013-14,2013-10-24,Buffalo Sabres,0,Atlantic,Eastern,3,2,22,0.13636363636363635,13,-10,10,-7
2013-14,2013-10-25,Buffalo Sabres,2,Atlantic,Eastern,5,2,24,0.20833333333333334,12,-7,11,-6
2013-14,2013-10-26,Buffalo Sabres,0,Atlantic,Eastern,5,2,26,0.19230769230769232,14,-9,11,-6
2013-14,2013-10-28,Buffalo Sabres,0,Atlantic,Eastern,5,2,28,0.17857142857142858,14,-9,11,-6
2013-14,2013-10-31,Buffalo Sabres,0,Atlantic,Eastern,5,2,30,0.16666666666666666,16,-11,11,-6
2013-14,2013-11-02,Buffalo Sabres,0,Atlantic,Eastern,5,2,32,0.15625,18,-13,14,-9
2013-14,2013-11-06,Buffalo Sabres,2,Atlantic,Eastern,7,2,34,0.20588235294117646,20,-13,15,-8
2013-14,2013-11-08,Buffalo Sabres,0,Atlantic,Eastern,7,2,36,0.19444444444444445,20,-13,16,-9
2013-14,2013-11-09,Buffalo Sabres,0,Atlantic,Eastern,7,2,38,0.18421052631578946,21,-14,17,-10
2013-14,2013-11-13,Buffalo Sabres,2,Atlantic,Eastern,9,2,40,0.225,23,-14,18,-9
2013-14,2013-11-16,Buffalo Sabres,2,Atlantic,Eastern,11,2,42,0.2619047619047619,24,-13,20,-9
2013-14,2013-11-17,Buffalo Sabres,0,Atlantic,Eastern,11,2,44,0.25,25,-14,20,-9
2013-14,2013-11-20,Buffalo Sabres,0,Atlantic,Eastern,11,2,46,0.2391304347826087,27,-16,20,-9
2013-14,2013-11-22,Buffalo Sabres,0,Atlantic,Eastern,11,2,48,0.22916666666666666,27,-16,23,-12
2013-14,2013-11-24,Buffalo Sabres,0,Atlantic,Eastern,11,2,50,0.22,29,-18,24,-13
2013-14,2013-11-28,Buffalo Sabres,0,Atlantic,Eastern,11,2,52,0.21153846153846154,31,-20,26,-15
2013-14,2013-11-30,Buffalo Sabres,2,Atlantic,Eastern,13,2,54,0.24074074074074073,33,-20,28,-15
2013-14,2013-12-01,Buffalo Sabres,1,Atlantic,Eastern,14,2,56,0.25,33,-19,28,-14
2013-14,2013-12-06,Buffalo Sabres,0,Atlantic,Eastern,14,2,58,0.2413793103448276,35,-21,30,-16
2013-14,2013-12-08,Buffalo Sabres,0,Atlantic,Eastern,14,2,60,0.23333333333333334,37,-23,31,-17
2013-14,2013-12-11,Buffalo Sabres,2,Atlantic,Eastern,16,2,62,0.25806451612903225,38,-22,32,-16
2013-14,2013-12-13,Buffalo Sabres,0,Atlantic,Eastern,16,2,64,0.25,39,-23,33,-17
2013-14,2013-12-14,Buffalo Sabres,1,Atlantic,Eastern,17,2,66,0.25757575757575757,39,-22,33,-16
2013-14,2013-12-18,Buffalo Sabres,2,Atlantic,Eastern,19,2,68,0.27941176470588236,43,-24,35,-16
2013-14,2013-12-20,Buffalo Sabres,2,Atlantic,Eastern,21,2,70,0.3,45,-24,36,-15
2013-14,2013-12-22,Buffalo Sabres,0,Atlantic,Eastern,21,2,72,0.2916666666666667,47,-26,37,-16
2013-14,2013-12-24,Buffalo Sabres,2,Atlantic,Eastern,23,2,74,0.3108108108108108,47,-24,38,-15
2013-14,2013-12-28,Buffalo Sabres,1,Atlantic,Eastern,24,2,76,0.3157894736842105,47,-23,38,-14
2013-14,2013-12-29,Buffalo Sabres,2,Atlantic,Eastern,26,2,78,0.3333333333333333,49,-23,40,-14
2013-14,2014-01-01,Buffalo Sabres,0,Atlantic,Eastern,26,2,80,0.325,50,-24,44,-18
2013-14,2014-01-03,Buffalo Sabres,0,Atlantic,Eastern,26,2,82,0.3170731707317073,52,-26,44,-18
2013-14,2014-01-05,Buffalo Sabres,2,Atlantic,Eastern,28,2,84,0.3333333333333333,53,-25,46,-18
2013-14,2014-01-10,Buffalo Sabres,1,Atlantic,Eastern,29,2,86,0.3372093023255814,55,-26,47,-18
2013-14,2014-01-12,Buffalo Sabres,2,Atlantic,Eastern,31,2,88,0.3522727272727273,57,-26,49,-18
2013-14,2014-01-15,Buffalo Sabres,0,Atlantic,Eastern,31,2,90,0.34444444444444444,57,-26,51,-20
2013-14,2014-01-16,Buffalo Sabres,1,Atlantic,Eastern,32,2,92,0.34782608695652173,57,-25,51,-19
2013-14,2014-01-19,Buffalo Sabres,1,Atlantic,Eastern,33,2,94,0.35106382978723405,59,-26,52,-19
2013-14,2014-01-22,Buffalo Sabres,0,Atlantic,Eastern,33,2,96,0.34375,59,-26,54,-21
2013-14,2014-01-24,Buffalo Sabres,0,Atlantic,Eastern,33,2,98,0.336734693877551,59,-26,56,-23
2013-14,2014-01-26,Buffalo Sabres,2,Atlantic,Eastern,35,2,100,0.35,60,-25,56,-21
2013-14,2014-01-28,Buffalo Sabres,0,Atlantic,Eastern,35,2,102,0.3431372549019608,60,-25,57,-22
2013-14,2014-01-29,Buffalo Sabres,1,Atlantic,Eastern,36,2,104,0.34615384615384615,62,-26,57,-21
2013-14,2014-01-31,Buffalo Sabres,2,Atlantic,Eastern,38,2,106,0.3584905660377358,64,-26,58,-20
2013-14,2014-02-01,Buffalo Sabres,0,Atlantic,Eastern,38,2,108,0.35185185185185186,64,-26,59,-21
2013-14,2014-02-04,Buffalo Sabres,0,Atlantic,Eastern,38,2,110,0.34545454545454546,66,-28,62,-24
2013-14,2014-02-06,Buffalo Sabres,0,Atlantic,Eastern,38,2,112,0.3392857142857143,66,-28,62,-24
2013-14,2014-02-07,Buffalo Sabres,0,Atlantic,Eastern,38,2,114,0.3333333333333333,68,-30,64,-26
2013-14,2014-02-26,Buffalo Sabres,2,Atlantic,Eastern,40,2,116,0.3448275862068966,70,-30,64,-24
2013-14,2014-02-27,Buffalo Sabres,2,Atlantic,Eastern,42,2,118,0.3559322033898305,71,-29,66,-24
2013-14,2014-03-01,Buffalo Sabres,2,Atlantic,Eastern,44,2,120,0.36666666666666664,73,-29,68,-24
2013-14,2014-03-04,Buffalo Sabres,0,Atlantic,Eastern,44,2,122,0.36065573770491804,73,-29,68,-24
2013-14,2014-03-07,Buffalo Sabres,2,Atlantic,Eastern,46,2,124,0.3709677419354839,74,-28,69,-23
2013-14,2014-03-08,Buffalo Sabres,0,Atlantic,Eastern,46,2,126,0.36507936507936506,74,-28,71,-25
2013-14,2014-03-09,Buffalo Sabres,0,Atlantic,Eastern,46,2,128,0.359375,76,-30,71,-25
2013-14,2014-03-11,Buffalo Sabres,0,Atlantic,Eastern,46,2,130,0.35384615384615387,77,-31,73,-27
2013-14,2014-03-13,Buffalo Sabres,0,Atlantic,Eastern,46,2,132,0.3484848484848485,77,-31,73,-27
2013-14,2014-03-15,Buffalo Sabres,0,Atlantic,Eastern,46,2,134,0.34328358208955223,79,-33,74,-28
2013-14,2014-03-16,Buffalo Sabres,0,Atlantic,Eastern,46,2,136,0.3382352941176471,80,-34,76,-30
2013-14,2014-03-19,Buffalo Sabres,0,Atlantic,Eastern,46,2,138,0.3333333333333333,83,-37,76,-30
2013-14,2014-03-21,Buffalo Sabres,2,Atlantic,Eastern,48,2,140,0.34285714285714286,83,-35,78,-30
2013-14,2014-03-24,Buffalo Sabres,0,Atlantic,Eastern,48,2,142,0.3380281690140845,87,-39,80,-32
2013-14,2014-03-25,Buffalo Sabres,0,Atlantic,Eastern,48,2,144,0.3333333333333333,87,-39,80,-32
2013-14,2014-03-28,Buffalo Sabres,0,Atlantic,Eastern,48,2,146,0.3287671232876712,89,-41,80,-32
2013-14,2014-03-29,Buffalo Sabres,1,Atlantic,Eastern,49,2,148,0.3310810810810811,91,-42,82,-33
2013-14,2014-04-01,Buffalo Sabres,2,Atlantic,Eastern,51,2,150,0.34,93,-42,83,-32
2013-14,2014-04-04,Buffalo Sabres,0,Atlantic,Eastern,51,2,152,0.3355263157894737,93,-42,85,-34
2013-14,2014-04-04,Buffalo Sabres,0,Atlantic,Eastern,51,2,154,0.33116883116883117,93,-42,85,-34
2013-14,2014-04-06,Buffalo Sabres,0,Atlantic,Eastern,51,2,156,0.3269230769230769,93,-42,87,-36
2013-14,2014-04-08,Buffalo Sabres,0,Atlantic,Eastern,51,2,158,0.3227848101265823,95,-44,89,-38
2013-14,2014-04-10,Buffalo Sabres,0,Atlantic,Eastern,51,2,160,0.31875,97,-46,91,-40
2013-14,2014-04-12,Buffalo Sabres,0,Atlantic,Eastern,51,2,162,0.3148148148148148,99,-48,91,-40
2013-14,2014-04-13,Buffalo Sabres,1,Atlantic,Eastern,52,2,164,0.3170731707317073,100,-48,93,-41
2013-14,2013-10-03,Calgary Flames,1,Pacific,Western,1,2,2,0.5,0,1,0,1
2013-14,2013-10-04,Calgary Flames,2,Pacific,Western,3,2,4,0.75,2,1,2,1
2013-14,2013-10-07,Calgary Flames,1,Pacific,Western,4,2,6,0.6666666666666666,4,0,3,1
2013-14,2013-10-10,Calgary Flames,2,Pacific,Western,6,2,8,0.75,6,0,4,2
2013-14,2013-10-12,Calgary Flames,2,Pacific,Western,8,2,10,0.8,6,2,6,2
2013-14,2013-10-17,Calgary Flames,0,Pacific,Western,8,2,12,0.6666666666666666,10,-2,8,0
2013-14,2013-10-20,Calgary Flames,0,Pacific,Western,8,2,14,0.5714285714285714,12,-4,11,-3
2013-14,2013-10-22,Calgary Flames,2,Pacific,Western,10,2,16,0.625,13,-3,11,-1
2013-14,2013-10-23,Calgary Flames,0,Pacific,Western,10,2,18,0.5555555555555556,14,-4,11,-1
2013-14,2013-10-25,Calgary Flames,0,Pacific,Western,10,2,20,0.5,15,-5,13,-3
2013-14,2013-10-27,Calgary Flames,2,Pacific,Western,12,2,22,0.5454545454545454,17,-5,14,-2
2013-14,2013-10-31,Calgary Flames,0,Pacific,Western,12,2,24,0.5,19,-7,16,-4
2013-14,2013-11-02,Calgary Flames,0,Pacific,Western,12,2,26,0.46153846153846156,21,-9,18,-6
2013-14,2013-11-04,Calgary Flames,2,Pacific,Western,14,2,28,0.5,22,-8,18,-4
2013-14,2013-11-06,Calgary Flames,0,Pacific,Western,14,2,30,0.4666666666666667,24,-10,20,-6
2013-14,2013-11-08,Calgary Flames,0,Pacific,Western,14,2,32,0.4375,24,-10,22,-8
2013-14,2013-11-09,Calgary Flames,0,Pacific,Western,14,2,34,0.4117647058823529,24,-10,22,-8
2013-14,2013-11-13,Calgary Flames,1,Pacific,Western,15,2,36,0.4166666666666667,27,-12,24,-9
2013-14,2013-11-15,Calgary Flames,0,Pacific,Western,15,2,38,0.39473684210526316,29,-14,25,-10
2013-14,2013-11-17,Calgary Flames,0,Pacific,Western,15,2,40,0.375,31,-16,27,-12
2013-14,2013-11-19,Calgary Flames,2,Pacific,Western,17,2,42,0.40476190476190477,31,-14,28,-11
2013-14,2013-11-21,Calgary Flames,1,Pacific,Western,18,2,44,0.4090909090909091,31,-13,30,-12
2013-14,2013-11-23,Calgary Flames,2,Pacific,Western,20,2,46,0.43478260869565216,32,-12,32,-12
2013-14,2013-11-28,Calgary Flames,0,Pacific,Western,20,2,48,0.4166666666666667,36,-16,34,-14
2013-14,2013-11-29,Calgary Flames,0,Pacific,Western,20,2,50,0.4,36,-16,34,-14
2013-14,2013-12-01,Calgary Flames,2,Pacific,Western,22,2,52,0.4230769230769231,36,-14,34,-12
2013-14,2013-12-05,Calgary Flames,2,Pacific,Western,24,2,54,0.4444444444444444,40,-16,36,-12
2013-14,2013-12-07,Calgary Flames,0,Pacific,Western,24,2,56,0.42857142857142855,40,-16,37,-13
2013-14,2013-12-08,Calgary Flames,2,Pacific,Western,26,2,58,0.4482758620689655,42,-16,37,-11
2013-14,2013-12-11,Calgary Flames,0,Pacific,Western,26,2,60,0.43333333333333335,44,-18,40,-14
2013-14,2013-12-13,Calgary Flames,2,Pacific,Western,28,2,62,0.45161290322580644,46,-18,41,-13
2013-14,2013-12-14,Calgary Flames,2,Pacific,Western,30,2,64,0.46875,46,-16,41,-11
2013-14,2013-12-16,Calgary Flames,1,Pacific,Western,31,2,66,0.4696969696969697,46,-15,43,-12
2013-14,2013-12-18,Calgary Flames,0,Pacific,Western,31,2,68,0.45588235294117646,48,-17,45,-14
2013-14,2013-12-20,Calgary Flames,1,Pacific,Western,32,2,70,0.45714285714285713,48,-16,45,-13
2013-14,2013-12-21,Calgary Flames,0,Pacific,Western,32,2,72,0.4444444444444444,48,-16,45,-13
2013-14,2013-12-24,Calgary Flames,2,Pacific,Western,34,2,74,0.4594594594594595,52,-18,45,-11
2013-14,2013-12-28,Calgary Flames,0,Pacific,Western,34,2,76,0.4473684210526316,54,-20,46,-12
2013-14,2013-12-30,Calgary Flames,0,Pacific,Western,34,2,78,0.4358974358974359,54,-20,47,-13
2013-14,2014-01-01,Calgary Flames,0,Pacific,Western,34,2,80,0.425,54,-20,49,-15
2013-14,2014-01-04,Calgary Flames,0,Pacific,Western,34,2,82,0.4146341463414634,54,-20,49,-15
2013-14,2014-01-07,Calgary Flames,2,Pacific,Western,36,2,84,0.42857142857142855,56,-20,49,-13
2013-14,2014-01-08,Calgary Flames,0,Pacific,Western,36,2,86,0.4186046511627907,57,-21,51,-15
2013-14,2014-01-10,Calgary Flames,0,Pacific,Western,36,2,88,0.4090909090909091,59,-23,53,-17
2013-14,2014-01-12,Calgary Flames,0,Pacific,Western,36,2,90,0.4,59,-23,53,-17
2013-14,2014-01-14,Calgary Flames,2,Pacific,Western,38,2,92,0.41304347826086957,61,-23,55,-17
2013-14,2014-01-15,Calgary Flames,0,Pacific,Western,38,2,94,0.40425531914893614,61,-23,55,-17
2013-14,2014-01-17,Calgary Flames,0,Pacific,Western,38,2,96,0.3958333333333333,63,-25,57,-19
2013-14,2014-01-19,Calgary Flames,1,Pacific,Western,39,2,98,0.3979591836734694,64,-25,59,-20
2013-14,2014-01-21,Calgary Flames,0,Pacific,Western,39,2,100,0.39,64,-25,59,-20
2013-14,2014-01-23,Calgary Flames,2,Pacific,Western,41,2,102,0.4019607843137255,64,-23,59,-18
2013-14,2014-01-25,Calgary Flames,2,Pacific,Western,43,2,104,0.41346153846153844,64,-21,61,-18
2013-14,2014-01-29,Calgary Flames,2,Pacific,Western,45,2,106,0.42452830188679247,66,-21,63,-18
2013-14,2014-01-31,Calgary Flames,2,Pacific,Western,47,2,108,0.4351851851851852,66,-19,63,-16
2013-14,2014-02-02,Calgary Flames,2,Pacific,Western,49,2,110,0.44545454545454544,66,-17,63,-14
2013-14,2014-02-05,Calgary Flames,0,Pacific,Western,49,2,112,0.4375,66,-17,63,-14
2013-14,2014-02-07,Calgary Flames,2,Pacific,Western,51,2,114,0.4473684210526316,68,-17,63,-12
2013-14,2014-02-08,Calgary Flames,0,Pacific,Western,51,2,116,0.4396551724137931,68,-17,64,-13
2013-14,2014-02-28,Calgary Flames,0,Pacific,Western,51,2,118,0.4322033898305085,72,-21,66,-15
2013-14,2014-03-02,Calgary Flames,2,Pacific,Western,53,2,120,0.44166666666666665,74,-21,66,-13
2013-14,2014-03-04,Calgary Flames,0,Pacific,Western,53,2,122,0.4344262295081967,76,-23,68,-15
2013-14,2014-03-06,Calgary Flames,2,Pacific,Western,55,2,124,0.4435483870967742,76,-21,68,-13
2013-14,2014-03-08,Calgary Flames,2,Pacific,Western,57,2,126,0.4523809523809524,78,-21,70,-13
2013-14,2014-03-09,Calgary Flames,0,Pacific,Western,57,2,128,0.4453125,78,-21,72,-15
2013-14,2014-03-11,Calgary Flames,0,Pacific,Western,57,2,130,0.43846153846153846,82,-25,73,-16
2013-14,2014-03-13,Calgary Flames,2,Pacific,Western,59,2,132,0.44696969696969696,82,-23,74,-15
2013-14,2014-03-15,Calgary Flames,2,Pacific,Western,61,2,134,0.4552238805970149,82,-21,75,-14
2013-14,2014-03-16,Calgary Flames,0,Pacific,Western,61,2,136,0.4485294117647059,82,-21,75,-14
2013-14,2014-03-19,Calgary Flames,2,Pacific,Western,63,2,138,0.45652173913043476,82,-19,77,-14
2013-14,2014-03-22,Calgary Flames,0,Pacific,Western,63,2,140,0.45,86,-23,79,-16
2013-14,2014-03-23,Calgary Flames,2,Pacific,Western,65,2,142,0.45774647887323944,86,-21,79,-14
2013-14,2014-03-25,Calgary Flames,2,Pacific,Western,67,2,144,0.4652777777777778,90,-23,82,-15
2013-14,2014-03-27,Calgary Flames,0,Pacific,Western,67,2,146,0.4589041095890411,92,-25,84,-17
2013-14,2014-03-29,Calgary Flames,2,Pacific,Western,69,2,148,0.46621621621621623,92,-23,84,-15
2013-14,2014-03-30,Calgary Flames,0,Pacific,Western,69,2,150,0.46,94,-25,84,-15
2013-14,2014-04-01,Calgary Flames,0,Pacific,Western,69,2,152,0.45394736842105265,94,-25,85,-16
2013-14,2014-04-03,Calgary Flames,2,Pacific,Western,71,2,154,0.461038961038961,96,-25,85,-14
2013-14,2014-04-04,Calgary Flames,2,Pacific,Western,73,2,156,0.46794871794871795,96,-23,85,-12
2013-14,2014-04-07,Calgary Flames,2,Pacific,Western,75,2,158,0.47468354430379744,96,-21,87,-12
2013-14,2014-04-10,Calgary Flames,2,Pacific,Western,77,2,160,0.48125,97,-20,89,-12
2013-14,2014-04-12,Calgary Flames,0,Pacific,Western,77,2,162,0.47530864197530864,99,-22,91,-14
2013-14,2014-04-14,Calgary Flames,0,Pacific,Western,77,2,164,0.4695121951219512,100,-23,91,-14
2013-14,2013-10-04,Carolina Hurricanes,1,Metropolitan,Eastern,1,2,2,0.5,2,-1,2,-1
2013-14,2013-10-06,Carolina Hurricanes,2,Metropolitan,Eastern,3,2,4,0.75,3,0,2,1
2013-14,2013-10-08,Carolina Hurricanes,0,Metropolitan,Eastern,3,2,6,0.5,3,0,3,0
2013-14,2013-10-10,Carolina Hurricanes,2,Metropolitan,Eastern,5,2,8,0.625,5,0,4,1
2013-14,2013-10-11,Carolina Hurricanes,1,Metropolitan,Eastern,6,2,10,0.6,5,1,4,2
2013-14,2013-10-13,Carolina Hurricanes,0,Metropolitan,Eastern,6,2,12,0.5,5,1,5,1
2013-14,2013-10-15,Carolina Hurricanes,1,Metropolitan,Eastern,7,2,14,0.5,6,1,6,1
2013-14,2013-10-17,Carolina Hurricanes,2,Metropolitan,Eastern,9,2,16,0.5625,8,1,8,1
2013-14,2013-10-19,Carolina Hurricanes,2,Metropolitan,Eastern,11,2,18,0.6111111111111112,8,3,8,3
2013-14,2013-10-25,Carolina Hurricanes,0,Metropolitan,Eastern,11,2,20,0.55,11,0,11,0
2013-14,2013-10-26,Carolina Hurricanes,0,Metropolitan,Eastern,11,2,22,0.5,11,0,11,0
2013-14,2013-10-28,Carolina Hurricanes,0,Metropolitan,Eastern,11,2,24,0.4583333333333333,11,0,11,0
2013-14,2013-11-01,Carolina Hurricanes,0,Metropolitan,Eastern,11,2,26,0.4230769230769231,12,-1,12,-1
2013-14,2013-11-02,Carolina Hurricanes,0,Metropolitan,Eastern,11,2,28,0.39285714285714285,14,-3,14,-3
2013-14,2013-11-06,Carolina Hurricanes,2,Metropolitan,Eastern,13,2,30,0.43333333333333335,15,-2,15,-2
2013-14,2013-11-08,Carolina Hurricanes,2,Metropolitan,Eastern,15,2,32,0.46875,16,-1,16,-1
2013-14,2013-11-10,Carolina Hurricanes,1,Metropolitan,Eastern,16,2,34,0.47058823529411764,16,0,18,-2
2013-14,2013-11-13,Carolina Hurricanes,2,Metropolitan,Eastern,18,2,36,0.5,18,0,18,0
2013-14,2013-11-16,Carolina Hurricanes,2,Metropolitan,Eastern,20,2,38,0.5263157894736842,20,0,20,0
2013-14,2013-11-17,Carolina Hurricanes,0,Metropolitan,Eastern,20,2,40,0.5,20,0,20,0
2013-14,2013-11-19,Carolina Hurricanes,0,Metropolitan,Eastern,20,2,42,0.47619047619047616,20,0,20,0
2013-14,2013-11-22,Carolina Hurricanes,0,Metropolitan,Eastern,20,2,44,0.45454545454545453,23,-3,23,-3
2013-14,2013-11-23,Carolina Hurricanes,1,Metropolitan,Eastern,21,2,46,0.45652173913043476,23,-2,23,-2
2013-14,2013-11-24,Carolina Hurricanes,2,Metropolitan,Eastern,23,2,48,0.4791666666666667,24,-1,24,-1
2013-14,2013-11-28,Carolina Hurricanes,2,Metropolitan,Eastern,25,2,50,0.5,26,-1,26,-1
2013-14,2013-11-30,Carolina Hurricanes,0,Metropolitan,Eastern,25,2,52,0.4807692307692308,28,-3,28,-3
2013-14,2013-12-01,Carolina Hurricanes,0,Metropolitan,Eastern,25,2,54,0.46296296296296297,28,-3,28,-3
2013-14,2013-12-04,Carolina Hurricanes,2,Metropolitan,Eastern,27,2,56,0.48214285714285715,28,-1,28,-1
2013-14,2013-12-06,Carolina Hurricanes,2,Metropolitan,Eastern,29,2,58,0.5,30,-1,30,-1
2013-14,2013-12-07,Carolina Hurricanes,2,Metropolitan,Eastern,31,2,60,0.5166666666666667,30,1,30,1
2013-14,2013-12-10,Carolina Hurricanes,0,Metropolitan,Eastern,31,2,62,0.5,31,0,31,0
2013-14,2013-12-11,Carolina Hurricanes,1,Metropolitan,Eastern,32,2,64,0.5,32,0,32,0
2013-14,2013-12-13,Carolina Hurricanes,1,Metropolitan,Eastern,33,2,66,0.5,33,0,33,0
2013-14,2013-12-15,Carolina Hurricanes,2,Metropolitan,Eastern,35,2,68,0.5147058823529411,35,0,35,0
2013-14,2013-12-21,Carolina Hurricanes,0,Metropolitan,Eastern,35,2,70,0.5,36,-1,36,-1
2013-14,2013-12-22,Carolina Hurricanes,1,Metropolitan,Eastern,36,2,72,0.5,37,-1,37,-1
2013-14,2013-12-24,Carolina Hurricanes,0,Metropolitan,Eastern,36,2,74,0.4864864864864865,38,-2,38,-2
2013-14,2013-12-28,Carolina Hurricanes,1,Metropolitan,Eastern,37,2,76,0.4868421052631579,38,-1,38,-1
2013-14,2013-12-30,Carolina Hurricanes,0,Metropolitan,Eastern,37,2,78,0.47435897435897434,40,-3,40,-3
2013-14,2014-01-01,Carolina Hurricanes,2,Metropolitan,Eastern,39,2,80,0.4875,44,-5,44,-5
2013-14,2014-01-03,Carolina Hurricanes,2,Metropolitan,Eastern,41,2,82,0.5,44,-3,44,-3
2013-14,2014-01-05,Carolina Hurricanes,2,Metropolitan,Eastern,43,2,84,0.5119047619047619,46,-3,46,-3
2013-14,2014-01-06,Carolina Hurricanes,2,Metropolitan,Eastern,45,2,86,0.5232558139534884,46,-1,46,-1
2013-14,2014-01-10,Carolina Hurricanes,2,Metropolitan,Eastern,47,2,88,0.5340909090909091,48,-1,47,0
2013-14,2014-01-11,Carolina Hurricanes,0,Metropolitan,Eastern,47,2,90,0.5222222222222223,50,-3,48,-1
2013-14,2014-01-14,Carolina Hurricanes,0,Metropolitan,Eastern,47,2,92,0.5108695652173914,51,-4,50,-3
2013-14,2014-01-19,Carolina Hurricanes,2,Metropolitan,Eastern,49,2,94,0.5212765957446809,55,-6,52,-3
2013-14,2014-01-19,Carolina Hurricanes,0,Metropolitan,Eastern,49,2,96,0.5104166666666666,55,-6,52,-3
2013-14,2014-01-22,Carolina Hurricanes,2,Metropolitan,Eastern,51,2,98,0.5204081632653061,56,-5,54,-3
2013-14,2014-01-24,Carolina Hurricanes,2,Metropolitan,Eastern,53,2,100,0.53,56,-3,56,-3
2013-14,2014-01-25,Carolina Hurricanes,2,Metropolitan,Eastern,55,2,102,0.5392156862745098,56,-1,56,-1
2013-14,2014-01-28,Carolina Hurricanes,2,Metropolitan,Eastern,57,2,104,0.5480769230769231,57,0,57,0
2013-14,2014-01-29,Carolina Hurricanes,0,Metropolitan,Eastern,57,2,106,0.5377358490566038,58,-1,57,0
2013-14,2014-02-01,Carolina Hurricanes,2,Metropolitan,Eastern,59,2,108,0.5462962962962963,60,-1,59,0
2013-14,2014-02-05,Carolina Hurricanes,0,Metropolitan,Eastern,59,2,110,0.5363636363636364,62,-3,62,-3
2013-14,2014-02-08,Carolina Hurricanes,0,Metropolitan,Eastern,59,2,112,0.5267857142857143,66,-7,64,-5
2013-14,2014-02-08,Carolina Hurricanes,2,Metropolitan,Eastern,61,2,114,0.5350877192982456,66,-5,64,-3
2013-14,2014-02-26,Carolina Hurricanes,0,Metropolitan,Eastern,61,2,116,0.5258620689655172,66,-5,64,-3
2013-14,2014-02-28,Carolina Hurricanes,0,Metropolitan,Eastern,61,2,118,0.5169491525423728,66,-5,66,-5
2013-14,2014-03-01,Carolina Hurricanes,0,Metropolitan,Eastern,61,2,120,0.5083333333333333,68,-7,68,-7
2013-14,2014-03-03,Carolina Hurricanes,0,Metropolitan,Eastern,61,2,122,0.5,69,-8,68,-7
2013-14,2014-03-05,Carolina Hurricanes,2,Metropolitan,Eastern,63,2,124,0.5080645161290323,69,-6,69,-6
2013-14,2014-03-08,Carolina Hurricanes,0,Metropolitan,Eastern,63,2,126,0.5,72,-9,71,-8
2013-14,2014-03-09,Carolina Hurricanes,0,Metropolitan,Eastern,63,2,128,0.4921875,73,-10,71,-8
2013-14,2014-03-11,Carolina Hurricanes,2,Metropolitan,Eastern,65,2,130,0.5,73,-8,73,-8
2013-14,2014-03-13,Carolina Hurricanes,2,Metropolitan,Eastern,67,2,132,0.5075757575757576,74,-7,73,-6
2013-14,2014-03-15,Carolina Hurricanes,0,Metropolitan,Eastern,67,2,134,0.5,75,-8,74,-7
2013-14,2014-03-16,Carolina Hurricanes,0,Metropolitan,Eastern,67,2,136,0.49264705882352944,76,-9,76,-9
2013-14,2014-03-18,Carolina Hurricanes,2,Metropolitan,Eastern,69,2,138,0.5,78,-9,76,-7
2013-14,2014-03-22,Carolina Hurricanes,2,Metropolitan,Eastern,71,2,140,0.5071428571428571,82,-11,79,-8
2013-14,2014-03-22,Carolina Hurricanes,0,Metropolitan,Eastern,71,2,142,0.5,82,-11,79,-8
2013-14,2014-03-25,Carolina Hurricanes,0,Metropolitan,Eastern,71,2,144,0.4930555555555556,83,-12,80,-9
2013-14,2014-03-27,Carolina Hurricanes,2,Metropolitan,Eastern,73,2,146,0.5,83,-10,80,-7
2013-14,2014-03-29,Carolina Hurricanes,1,Metropolitan,Eastern,74,2,148,0.5,85,-11,82,-8
2013-14,2014-03-31,Carolina Hurricanes,1,Metropolitan,Eastern,75,2,150,0.5,86,-11,82,-7
2013-14,2014-04-01,Carolina Hurricanes,2,Metropolitan,Eastern,77,2,152,0.506578947368421,86,-9,83,-6
2013-14,2014-04-03,Carolina Hurricanes,2,Metropolitan,Eastern,79,2,154,0.512987012987013,87,-8,85,-6
2013-14,2014-04-05,Carolina Hurricanes,0,Metropolitan,Eastern,79,2,156,0.5064102564102564,87,-8,85,-6
2013-14,2014-04-08,Carolina Hurricanes,0,Metropolitan,Eastern,79,2,158,0.5,91,-12,89,-10
2013-14,2014-04-10,Carolina Hurricanes,0,Metropolitan,Eastern,79,2,160,0.49375,91,-12,91,-12
2013-14,2014-04-11,Carolina Hurricanes,2,Metropolitan,Eastern,81,2,162,0.5,91,-10,91,-10
2013-14,2014-04-13,Carolina Hurricanes,2,Metropolitan,Eastern,83,2,164,0.5060975609756098,94,-11,93,-10
2013-14,2013-10-02,Chicago Blackhawks,2,Central,Western,2,2,2,1.0,0,2,0,2
2013-14,2013-10-06,Chicago Blackhawks,1,Central,Western,3,2,4,0.75,4,-1,2,1
2013-14,2013-10-10,Chicago Blackhawks,0,Central,Western,3,2,6,0.5,4,-1,4,-1
2013-14,2013-10-12,Chicago Blackhawks,2,Central,Western,5,2,8,0.625,5,0,6,-1
2013-14,2013-10-13,Chicago Blackhawks,2,Central,Western,7,2,10,0.7,7,0,6,1
2013-14,2013-10-15,Chicago Blackhawks,2,Central,Western,9,2,12,0.75,8,1,8,1
2013-14,2013-10-18,Chicago Blackhawks,1,Central,Western,10,2,14,0.7142857142857143,10,0,9,1
2013-14,2013-10-19,Chicago Blackhawks,2,Central,Western,12,2,16,0.75,11,1,10,2
2013-14,2013-10-22,Chicago Blackhawks,2,Central,Western,14,2,18,0.7777777777777778,11,3,11,3
2013-14,2013-10-24,Chicago Blackhawks,1,Central,Western,15,2,20,0.75,11,4,11,4
2013-14,2013-10-27,Chicago Blackhawks,0,Central,Western,15,2,22,0.6818181818181818,15,0,14,1
2013-14,2013-10-29,Chicago Blackhawks,2,Central,Western,17,2,24,0.7083333333333334,15,2,15,2
2013-14,2013-10-30,Chicago Blackhawks,2,Central,Western,19,2,26,0.7307692307692307,16,3,16,3
2013-14,2013-11-02,Chicago Blackhawks,2,Central,Western,21,2,28,0.75,18,3,18,3
2013-14,2013-11-04,Chicago Blackhawks,1,Central,Western,22,2,30,0.7333333333333333,19,3,18,4
2013-14,2013-11-07,Chicago Blackhawks,2,Central,Western,24,2,32,0.75,21,3,20,4
2013-14,2013-11-10,Chicago Blackhawks,2,Central,Western,26,2,34,0.7647058823529411,24,2,24,2
2013-14,2013-11-11,Chicago Blackhawks,2,Central,Western,28,2,36,0.7777777777777778,24,4,24,4
2013-14,2013-11-15,Chicago Blackhawks,2,Central,Western,30,2,38,0.7894736842105263,27,3,25,5
2013-14,2013-11-17,Chicago Blackhawks,0,Central,Western,30,2,40,0.75,28,2,27,3
2013-14,2013-11-18,Chicago Blackhawks,2,Central,Western,32,2,42,0.7619047619047619,28,4,28,4
2013-14,2013-11-20,Chicago Blackhawks,0,Central,Western,32,2,44,0.7272727272727273,30,2,30,2
2013-14,2013-11-22,Chicago Blackhawks,2,Central,Western,34,2,46,0.7391304347826086,32,2,32,2
2013-14,2013-11-24,Chicago Blackhawks,2,Central,Western,36,2,48,0.75,34,2,32,4
2013-14,2013-11-26,Chicago Blackhawks,2,Central,Western,38,2,50,0.76,34,4,32,6
2013-14,2013-11-28,Chicago Blackhawks,2,Central,Western,40,2,52,0.7692307692307693,34,6,34,6
2013-14,2013-11-30,Chicago Blackhawks,2,Central,Western,42,2,54,0.7777777777777778,36,6,34,8
2013-14,2013-12-01,Chicago Blackhawks,2,Central,Western,44,2,56,0.7857142857142857,38,6,34,10
2013-14,2013-12-04,Chicago Blackhawks,0,Central,Western,44,2,58,0.7586206896551724,38,6,36,8
2013-14,2013-12-06,Chicago Blackhawks,0,Central,Western,44,2,60,0.7333333333333333,39,5,36,8
2013-14,2013-12-07,Chicago Blackhawks,1,Central,Western,45,2,62,0.7258064516129032,40,5,37,8
2013-14,2013-12-09,Chicago Blackhawks,2,Central,Western,47,2,64,0.734375,41,6,39,8
2013-14,2013-12-11,Chicago Blackhawks,2,Central,Western,49,2,66,0.7424242424242424,41,8,40,9
2013-14,2013-12-12,Chicago Blackhawks,2,Central,Western,51,2,68,0.75,41,10,40,11
2013-14,2013-12-15,Chicago Blackhawks,0,Central,Western,51,2,70,0.7285714285714285,43,8,43,8
2013-14,2013-12-16,Chicago Blackhawks,2,Central,Western,53,2,72,0.7361111111111112,43,10,43,10
2013-14,2013-12-18,Chicago Blackhawks,2,Central,Western,55,2,74,0.7432432432432432,45,10,45,10
2013-14,2013-12-21,Chicago Blackhawks,1,Central,Western,56,2,76,0.7368421052631579,48,8,45,11
2013-14,2013-12-24,Chicago Blackhawks,2,Central,Western,58,2,78,0.7435897435897436,49,9,45,13
2013-14,2013-12-28,Chicago Blackhawks,2,Central,Western,60,2,80,0.75,49,11,46,14
2013-14,2013-12-29,Chicago Blackhawks,1,Central,Western,61,2,82,0.7439024390243902,49,12,47,14
2013-14,2013-12-31,Chicago Blackhawks,2,Central,Western,63,2,84,0.75,50,13,47,16
2013-14,2014-01-03,Chicago Blackhawks,1,Central,Western,64,2,86,0.7441860465116279,54,10,49,15
2013-14,2014-01-04,Chicago Blackhawks,2,Central,Western,66,2,88,0.75,56,10,49,17
2013-14,2014-01-06,Chicago Blackhawks,1,Central,Western,67,2,90,0.7444444444444445,56,11,49,18
2013-14,2014-01-09,Chicago Blackhawks,0,Central,Western,67,2,92,0.7282608695652174,58,9,51,16
2013-14,2014-01-12,Chicago Blackhawks,1,Central,Western,68,2,94,0.723404255319149,61,7,53,15
2013-14,2014-01-13,Chicago Blackhawks,2,Central,Western,70,2,96,0.7291666666666666,61,9,55,15
2013-14,2014-01-15,Chicago Blackhawks,1,Central,Western,71,2,98,0.7244897959183674,63,8,55,16
2013-14,2014-01-18,Chicago Blackhawks,2,Central,Western,73,2,100,0.73,65,8,57,16
2013-14,2014-01-19,Chicago Blackhawks,2,Central,Western,75,2,102,0.7352941176470589,67,8,59,16
2013-14,2014-01-23,Chicago Blackhawks,1,Central,Western,76,2,104,0.7307692307692307,67,9,59,17
2013-14,2014-01-24,Chicago Blackhawks,0,Central,Western,76,2,106,0.7169811320754716,67,9,61,15
2013-14,2014-01-27,Chicago Blackhawks,0,Central,Western,76,2,108,0.7037037037037037,69,7,62,14
2013-14,2014-01-29,Chicago Blackhawks,1,Central,Western,77,2,110,0.7,71,6,63,14
2013-14,2014-01-30,Chicago Blackhawks,2,Central,Western,79,2,112,0.7053571428571429,71,8,63,16
2013-14,2014-02-02,Chicago Blackhawks,1,Central,Western,80,2,114,0.7017543859649122,75,5,63,17
2013-14,2014-02-04,Chicago Blackhawks,2,Central,Western,82,2,116,0.7068965517241379,77,5,63,19
2013-14,2014-02-06,Chicago Blackhawks,2,Central,Western,84,2,118,0.711864406779661,77,7,63,21
2013-14,2014-02-08,Chicago Blackhawks,0,Central,Western,84,2,120,0.7,77,7,64,20
2013-14,2014-02-28,Chicago Blackhawks,0,Central,Western,84,2,122,0.6885245901639344,79,5,66,18
2013-14,2014-03-02,Chicago Blackhawks,2,Central,Western,86,2,124,0.6935483870967742,81,5,66,20
2013-14,2014-03-05,Chicago Blackhawks,0,Central,Western,86,2,126,0.6825396825396826,85,1,68,18
2013-14,2014-03-07,Chicago Blackhawks,2,Central,Western,88,2,128,0.6875,87,1,70,18
2013-14,2014-03-09,Chicago Blackhawks,2,Central,Western,90,2,130,0.6923076923076923,87,3,72,18
2013-14,2014-03-13,Chicago Blackhawks,0,Central,Western,90,2,132,0.6818181818181818,90,0,74,16
2013-14,2014-03-15,Chicago Blackhawks,0,Central,Western,90,2,134,0.6716417910447762,90,0,75,15
2013-14,2014-03-16,Chicago Blackhawks,2,Central,Western,92,2,136,0.6764705882352942,92,0,75,17
2013-14,2014-03-18,Chicago Blackhawks,1,Central,Western,93,2,138,0.6739130434782609,93,0,77,16
2013-14,2014-03-20,Chicago Blackhawks,2,Central,Western,95,2,140,0.6785714285714286,94,1,77,18
2013-14,2014-03-22,Chicago Blackhawks,2,Central,Western,97,2,142,0.6830985915492958,94,3,79,18
2013-14,2014-03-23,Chicago Blackhawks,0,Central,Western,97,2,144,0.6736111111111112,94,3,79,18
2013-14,2014-03-26,Chicago Blackhawks,2,Central,Western,99,2,146,0.678082191780822,96,3,82,17
2013-14,2014-03-27,Chicago Blackhawks,0,Central,Western,99,2,148,0.668918918918919,96,3,84,15
2013-14,2014-03-28,Chicago Blackhawks,0,Central,Western,99,2,150,0.66,98,1,84,15
2013-14,2014-03-30,Chicago Blackhawks,0,Central,Western,99,2,152,0.6513157894736842,99,0,84,15
2013-14,2014-04-04,Chicago Blackhawks,2,Central,Western,101,2,154,0.6558441558441559,103,-2,85,16
2013-14,2014-04-04,Chicago Blackhawks,2,Central,Western,103,2,156,0.6602564102564102,103,0,85,18
2013-14,2014-04-06,Chicago Blackhawks,2,Central,Western,105,2,158,0.6645569620253164,105,0,87,18
2013-14,2014-04-09,Chicago Blackhawks,2,Central,Western,107,2,160,0.66875,107,0,89,18
2013-14,2014-04-11,Chicago Blackhawks,0,Central,Western,107,2,162,0.6604938271604939,107,0,89,18
2013-14,2014-04-13,Chicago Blackhawks,0,Central,Western,107,2,164,0.6524390243902439,107,0,91,16
2013-14,2013-10-03,Colorado Avalanche,2,Central,Western,2,2,2,1.0,2,0,0,2
2013-14,2013-10-05,Colorado Avalanche,2,Central,Western,4,2,4,1.0,2,2,2,2
2013-14,2013-10-08,Colorado Avalanche,2,Central,Western,6,2,6,1.0,4,2,3,3
2013-14,2013-10-10,Colorado Avalanche,2,Central,Western,8,2,8,1.0,4,4,4,4
2013-14,2013-10-12,Colorado Avalanche,2,Central,Western,10,2,10,1.0,5,5,6,4
2013-14,2013-10-16,Colorado Avalanche,2,Central,Western,12,2,12,1.0,8,4,8,4
2013-14,2013-10-18,Colorado Avalanche,0,Central,Western,12,2,14,0.8571428571428571,10,2,9,3
2013-14,2013-10-19,Colorado Avalanche,2,Central,Western,14,2,16,0.875,11,3,10,4
2013-14,2013-10-21,Colorado Avalanche,2,Central,Western,16,2,18,0.8888888888888888,11,5,11,5
2013-14,2013-10-26,Colorado Avalanche,2,Central,Western,18,2,20,0.9,13,5,13,5
2013-14,2013-10-28,Colorado Avalanche,2,Central,Western,20,2,22,0.9090909090909091,15,5,15,5
2013-14,2013-11-02,Colorado Avalanche,2,Central,Western,22,2,24,0.9166666666666666,18,4,18,4
2013-14,2013-11-03,Colorado Avalanche,2,Central,Western,24,2,26,0.9230769230769231,18,6,18,6
2013-14,2013-11-07,Colorado Avalanche,0,Central,Western,24,2,28,0.8571428571428571,21,3,20,4
2013-14,2013-11-09,Colorado Avalanche,2,Central,Western,26,2,30,0.8666666666666667,22,4,22,4
2013-14,2013-11-11,Colorado Avalanche,2,Central,Western,28,2,32,0.875,24,4,24,4
2013-14,2013-11-13,Colorado Avalanche,0,Central,Western,28,2,34,0.8235294117647058,25,3,24,4
2013-14,2013-11-15,Colorado Avalanche,0,Central,Western,28,2,36,0.7777777777777778,27,1,25,3
2013-14,2013-11-17,Colorado Avalanche,0,Central,Western,28,2,38,0.7368421052631579,28,0,27,1
2013-14,2013-11-20,Colorado Avalanche,2,Central,Western,30,2,40,0.75,30,0,30,0
2013-14,2013-11-22,Colorado Avalanche,2,Central,Western,32,2,42,0.7619047619047619,32,0,32,0
2013-14,2013-11-24,Colorado Avalanche,2,Central,Western,34,2,44,0.7727272727272727,34,0,32,2
2013-14,2013-11-28,Colorado Avalanche,0,Central,Western,34,2,46,0.7391304347826086,34,0,34,0
2013-14,2013-11-29,Colorado Avalanche,2,Central,Western,36,2,48,0.75,36,0,34,2
2013-14,2013-12-01,Colorado Avalanche,2,Central,Western,38,2,50,0.76,38,0,34,4
2013-14,2013-12-06,Colorado Avalanche,0,Central,Western,38,2,52,0.7307692307692307,39,-1,36,2
2013-14,2013-12-07,Colorado Avalanche,2,Central,Western,40,2,54,0.7407407407407407,40,0,37,3
2013-14,2013-12-09,Colorado Avalanche,0,Central,Western,40,2,56,0.7142857142857143,41,-1,39,1
2013-14,2013-12-11,Colorado Avalanche,0,Central,Western,40,2,58,0.6896551724137931,41,-1,40,0
2013-14,2013-12-13,Colorado Avalanche,2,Central,Western,42,2,60,0.7,42,0,41,1
2013-14,2013-12-15,Colorado Avalanche,1,Central,Western,43,2,62,0.6935483870967742,43,0,43,0
2013-14,2013-12-17,Colorado Avalanche,2,Central,Western,45,2,64,0.703125,45,0,43,2
2013-14,2013-12-18,Colorado Avalanche,0,Central,Western,45,2,66,0.6818181818181818,45,0,45,0
2013-14,2013-12-20,Colorado Avalanche,2,Central,Western,47,2,68,0.6911764705882353,47,0,45,2
2013-14,2013-12-21,Colorado Avalanche,1,Central,Western,48,2,70,0.6857142857142857,48,0,45,3
2013-14,2013-12-24,Colorado Avalanche,1,Central,Western,49,2,72,0.6805555555555556,49,0,45,4
2013-14,2013-12-28,Colorado Avalanche,0,Central,Western,49,2,74,0.6621621621621622,49,0,46,3
2013-14,2013-12-30,Colorado Avalanche,1,Central,Western,50,2,76,0.6578947368421053,50,0,47,3
2013-14,2014-01-01,Colorado Avalanche,2,Central,Western,52,2,78,0.6666666666666666,52,0,49,3
2013-14,2014-01-03,Colorado Avalanche,2,Central,Western,54,2,80,0.675,54,0,49,5
2013-14,2014-01-04,Colorado Avalanche,2,Central,Western,56,2,82,0.6829268292682927,56,0,49,7
2013-14,2014-01-07,Colorado Avalanche,0,Central,Western,56,2,84,0.6666666666666666,56,0,49,7
2013-14,2014-01-09,Colorado Avalanche,2,Central,Western,58,2,86,0.6744186046511628,58,0,51,7
2013-14,2014-01-11,Colorado Avalanche,1,Central,Western,59,2,88,0.6704545454545454,59,0,53,6
2013-14,2014-01-12,Colorado Avalanche,2,Central,Western,61,2,90,0.6777777777777778,61,0,53,8
2013-14,2014-01-15,Colorado Avalanche,2,Central,Western,63,2,92,0.6847826086956522,63,0,55,8
2013-14,2014-01-17,Colorado Avalanche,2,Central,Western,65,2,94,0.6914893617021277,65,0,57,8
2013-14,2014-01-19,Colorado Avalanche,2,Central,Western,67,2,96,0.6979166666666666,67,0,59,8
2013-14,2014-01-22,Colorado Avalanche,0,Central,Western,67,2,98,0.6836734693877551,67,0,59,8
2013-14,2014-01-25,Colorado Avalanche,2,Central,Western,69,2,100,0.69,69,0,61,8
2013-14,2014-01-26,Colorado Avalanche,0,Central,Western,69,2,102,0.6764705882352942,69,0,61,8
2013-14,2014-01-28,Colorado Avalanche,2,Central,Western,71,2,104,0.6826923076923077,71,0,62,9
2013-14,2014-01-31,Colorado Avalanche,2,Central,Western,73,2,106,0.6886792452830188,73,0,63,10
2013-14,2014-02-01,Colorado Avalanche,2,Central,Western,75,2,108,0.6944444444444444,75,0,63,12
2013-14,2014-02-04,Colorado Avalanche,2,Central,Western,77,2,110,0.7,77,0,63,14
2013-14,2014-02-05,Colorado Avalanche,0,Central,Western,77,2,112,0.6875,77,0,63,14
2013-14,2014-02-07,Colorado Avalanche,0,Central,Western,77,2,114,0.6754385964912281,77,0,63,14
2013-14,2014-02-09,Colorado Avalanche,2,Central,Western,79,2,116,0.6810344827586207,79,0,64,15
2013-14,2014-02-27,Colorado Avalanche,0,Central,Western,79,2,118,0.6694915254237288,79,0,65,14
2013-14,2014-03-01,Colorado Avalanche,2,Central,Western,81,2,120,0.675,81,0,66,15
2013-14,2014-03-03,Colorado Avalanche,2,Central,Western,83,2,122,0.680327868852459,83,0,66,17
2013-14,2014-03-05,Colorado Avalanche,2,Central,Western,85,2,124,0.6854838709677419,85,0,68,17
2013-14,2014-03-07,Colorado Avalanche,2,Central,Western,87,2,126,0.6904761904761905,87,0,70,17
2013-14,2014-03-08,Colorado Avalanche,0,Central,Western,87,2,128,0.6796875,87,0,70,17
2013-14,2014-03-11,Colorado Avalanche,2,Central,Western,89,2,130,0.6846153846153846,89,0,73,16
2013-14,2014-03-13,Colorado Avalanche,2,Central,Western,91,2,132,0.6893939393939394,90,1,74,17
2013-14,2014-03-15,Colorado Avalanche,0,Central,Western,91,2,134,0.6791044776119403,90,1,75,16
2013-14,2014-03-16,Colorado Avalanche,2,Central,Western,93,2,136,0.6838235294117647,92,1,75,18
2013-14,2014-03-18,Colorado Avalanche,0,Central,Western,93,2,138,0.6739130434782609,93,0,77,16
2013-14,2014-03-20,Colorado Avalanche,1,Central,Western,94,2,140,0.6714285714285714,94,0,77,17
2013-14,2014-03-22,Colorado Avalanche,0,Central,Western,94,2,142,0.6619718309859155,94,0,79,15
2013-14,2014-03-26,Colorado Avalanche,2,Central,Western,96,2,144,0.6666666666666666,96,0,82,14
2013-14,2014-03-28,Colorado Avalanche,2,Central,Western,98,2,146,0.6712328767123288,98,0,84,14
2013-14,2014-03-29,Colorado Avalanche,2,Central,Western,100,2,148,0.6756756756756757,99,1,84,16
2013-14,2014-04-01,Colorado Avalanche,2,Central,Western,102,2,150,0.68,99,3,85,17
2013-14,2014-04-04,Colorado Avalanche,2,Central,Western,104,2,152,0.6842105263157895,103,1,85,19
2013-14,2014-04-05,Colorado Avalanche,2,Central,Western,106,2,154,0.6883116883116883,101,5,87,19
2013-14,2014-04-07,Colorado Avalanche,1,Central,Western,107,2,156,0.6858974358974359,105,2,87,20
2013-14,2014-04-09,Colorado Avalanche,2,Central,Western,109,2,158,0.689873417721519,107,2,89,20
2013-14,2014-04-11,Colorado Avalanche,2,Central,Western,111,2,160,0.69375,107,4,89,22
2013-14,2014-04-12,Colorado Avalanche,0,Central,Western,111,2,162,0.6851851851851852,107,4,91,20
2013-14,2014-04-14,Colorado Avalanche,1,Central,Western,112,2,164,0.6829268292682927,107,5,91,21
2013-14,2013-10-04,Columbus Blue Jackets,0,Metropolitan,Eastern,0,2,2,0.0,2,-2,2,-2
2013-14,2013-10-05,Columbus Blue Jackets,2,Metropolitan,Eastern,2,2,4,0.5,2,0,2,0
2013-14,2013-10-10,Columbus Blue Jackets,2,Metropolitan,Eastern,4,2,6,0.6666666666666666,5,-1,4,0
2013-14,2013-10-12,Columbus Blue Jackets,0,Metropolitan,Eastern,4,2,8,0.5,5,-1,4,0
2013-14,2013-10-16,Columbus Blue Jackets,0,Metropolitan,Eastern,4,2,10,0.4,6,-2,6,-2
2013-14,2013-10-17,Columbus Blue Jackets,0,Metropolitan,Eastern,4,2,12,0.3333333333333333,8,-4,8,-4
2013-14,2013-10-19,Columbus Blue Jackets,0,Metropolitan,Eastern,4,2,14,0.2857142857142857,8,-4,8,-4
2013-14,2013-10-20,Columbus Blue Jackets,2,Metropolitan,Eastern,6,2,16,0.375,8,-2,8,-2
2013-14,2013-10-22,Columbus Blue Jackets,2,Metropolitan,Eastern,8,2,18,0.4444444444444444,9,-1,9,-1
2013-14,2013-10-25,Columbus Blue Jackets,2,Metropolitan,Eastern,10,2,20,0.5,11,-1,11,-1
2013-14,2013-10-27,Columbus Blue Jackets,0,Metropolitan,Eastern,10,2,22,0.45454545454545453,11,-1,11,-1
2013-14,2013-11-01,Columbus Blue Jackets,0,Metropolitan,Eastern,10,2,24,0.4166666666666667,12,-2,12,-2
2013-14,2013-11-02,Columbus Blue Jackets,0,Metropolitan,Eastern,10,2,26,0.38461538461538464,14,-4,14,-4
2013-14,2013-11-06,Columbus Blue Jackets,0,Metropolitan,Eastern,10,2,28,0.35714285714285715,15,-5,15,-5
2013-14,2013-11-08,Columbus Blue Jackets,0,Metropolitan,Eastern,10,2,30,0.3333333333333333,16,-6,16,-6
2013-14,2013-11-10,Columbus Blue Jackets,2,Metropolitan,Eastern,12,2,32,0.375,16,-4,18,-6
2013-14,2013-11-13,Columbus Blue Jackets,1,Metropolitan,Eastern,13,2,34,0.38235294117647056,18,-5,18,-5
2013-14,2013-11-15,Columbus Blue Jackets,1,Metropolitan,Eastern,14,2,36,0.3888888888888889,18,-4,18,-4
2013-14,2013-11-16,Columbus Blue Jackets,1,Metropolitan,Eastern,15,2,38,0.39473684210526316,20,-5,20,-5
2013-14,2013-11-17,Columbus Blue Jackets,2,Metropolitan,Eastern,17,2,40,0.425,20,-3,20,-3
2013-14,2013-11-20,Columbus Blue Jackets,0,Metropolitan,Eastern,17,2,42,0.40476190476190477,20,-3,20,-3
2013-14,2013-11-21,Columbus Blue Jackets,2,Metropolitan,Eastern,19,2,44,0.4318181818181818,21,-2,21,-2
2013-14,2013-11-23,Columbus Blue Jackets,0,Metropolitan,Eastern,19,2,46,0.41304347826086957,23,-4,23,-4
2013-14,2013-11-26,Columbus Blue Jackets,2,Metropolitan,Eastern,21,2,48,0.4375,24,-3,24,-3
2013-14,2013-11-28,Columbus Blue Jackets,0,Metropolitan,Eastern,21,2,50,0.42,26,-5,26,-5
2013-14,2013-11-30,Columbus Blue Jackets,2,Metropolitan,Eastern,23,2,52,0.4423076923076923,28,-5,28,-5
2013-14,2013-12-01,Columbus Blue Jackets,0,Metropolitan,Eastern,23,2,54,0.42592592592592593,28,-5,28,-5
2013-14,2013-12-04,Columbus Blue Jackets,2,Metropolitan,Eastern,25,2,56,0.44642857142857145,28,-3,28,-3
2013-14,2013-12-07,Columbus Blue Jackets,2,Metropolitan,Eastern,27,2,58,0.46551724137931033,30,-3,30,-3
2013-14,2013-12-10,Columbus Blue Jackets,0,Metropolitan,Eastern,27,2,60,0.45,31,-4,31,-4
2013-14,2013-12-11,Columbus Blue Jackets,2,Metropolitan,Eastern,29,2,62,0.46774193548387094,32,-3,32,-3
2013-14,2013-12-13,Columbus Blue Jackets,2,Metropolitan,Eastern,31,2,64,0.484375,33,-2,33,-2
2013-14,2013-12-15,Columbus Blue Jackets,1,Metropolitan,Eastern,32,2,66,0.48484848484848486,35,-3,35,-3
2013-14,2013-12-17,Columbus Blue Jackets,0,Metropolitan,Eastern,32,2,68,0.47058823529411764,35,-3,35,-3
2013-14,2013-12-20,Columbus Blue Jackets,0,Metropolitan,Eastern,32,2,70,0.45714285714285713,36,-4,36,-4
2013-14,2013-12-22,Columbus Blue Jackets,2,Metropolitan,Eastern,34,2,72,0.4722222222222222,37,-3,37,-3
2013-14,2013-12-24,Columbus Blue Jackets,2,Metropolitan,Eastern,36,2,74,0.4864864864864865,38,-2,38,-2
2013-14,2013-12-28,Columbus Blue Jackets,2,Metropolitan,Eastern,38,2,76,0.5,38,0,38,0
2013-14,2013-12-29,Columbus Blue Jackets,0,Metropolitan,Eastern,38,2,78,0.48717948717948717,40,-2,40,-2
2013-14,2014-01-01,Columbus Blue Jackets,0,Metropolitan,Eastern,38,2,80,0.475,44,-6,44,-6
2013-14,2014-01-03,Columbus Blue Jackets,2,Metropolitan,Eastern,40,2,82,0.4878048780487805,44,-4,44,-4
2013-14,2014-01-05,Columbus Blue Jackets,0,Metropolitan,Eastern,40,2,84,0.47619047619047616,46,-6,46,-6
2013-14,2014-01-07,Columbus Blue Jackets,2,Metropolitan,Eastern,42,2,86,0.4883720930232558,46,-4,46,-4
2013-14,2014-01-11,Columbus Blue Jackets,2,Metropolitan,Eastern,44,2,88,0.5,50,-6,48,-4
2013-14,2014-01-12,Columbus Blue Jackets,2,Metropolitan,Eastern,46,2,90,0.5111111111111111,50,-4,49,-3
2013-14,2014-01-14,Columbus Blue Jackets,2,Metropolitan,Eastern,48,2,92,0.5217391304347826,51,-3,50,-2
2013-14,2014-01-18,Columbus Blue Jackets,2,Metropolitan,Eastern,50,2,94,0.5319148936170213,53,-3,52,-2
2013-14,2014-01-19,Columbus Blue Jackets,2,Metropolitan,Eastern,52,2,96,0.5416666666666666,55,-3,52,0
2013-14,2014-01-22,Columbus Blue Jackets,2,Metropolitan,Eastern,54,2,98,0.5510204081632653,56,-2,54,0
2013-14,2014-01-24,Columbus Blue Jackets,2,Metropolitan,Eastern,56,2,100,0.56,56,0,56,0
2013-14,2014-01-26,Columbus Blue Jackets,0,Metropolitan,Eastern,56,2,102,0.5490196078431373,56,0,56,0
2013-14,2014-01-28,Columbus Blue Jackets,0,Metropolitan,Eastern,56,2,104,0.5384615384615384,57,-1,57,-1
2013-14,2014-01-29,Columbus Blue Jackets,0,Metropolitan,Eastern,56,2,106,0.5283018867924528,58,-2,57,-1
2013-14,2014-01-31,Columbus Blue Jackets,2,Metropolitan,Eastern,58,2,108,0.5370370370370371,58,0,58,0
2013-14,2014-02-02,Columbus Blue Jackets,2,Metropolitan,Eastern,60,2,110,0.5454545454545454,60,0,60,0
2013-14,2014-02-04,Columbus Blue Jackets,2,Metropolitan,Eastern,62,2,112,0.5535714285714286,62,0,62,0
2013-14,2014-02-07,Columbus Blue Jackets,1,Metropolitan,Eastern,63,2,114,0.5526315789473685,64,-1,64,-1
2013-14,2014-02-08,Columbus Blue Jackets,0,Metropolitan,Eastern,63,2,116,0.5431034482758621,66,-3,64,-1
2013-14,2014-02-28,Columbus Blue Jackets,0,Metropolitan,Eastern,63,2,118,0.5338983050847458,66,-3,66,-3
2013-14,2014-03-01,Columbus Blue Jackets,2,Metropolitan,Eastern,65,2,120,0.5416666666666666,68,-3,68,-3
2013-14,2014-03-04,Columbus Blue Jackets,2,Metropolitan,Eastern,67,2,122,0.5491803278688525,69,-2,68,-1
2013-14,2014-03-05,Columbus Blue Jackets,2,Metropolitan,Eastern,69,2,124,0.5564516129032258,69,0,69,0
2013-14,2014-03-07,Columbus Blue Jackets,0,Metropolitan,Eastern,69,2,126,0.5476190476190477,70,-1,69,0
2013-14,2014-03-09,Columbus Blue Jackets,2,Metropolitan,Eastern,71,2,128,0.5546875,73,-2,71,0
2013-14,2014-03-11,Columbus Blue Jackets,2,Metropolitan,Eastern,73,2,130,0.5615384615384615,73,0,73,0
2013-14,2014-03-13,Columbus Blue Jackets,1,Metropolitan,Eastern,74,2,132,0.5606060606060606,74,0,73,1
2013-14,2014-03-16,Columbus Blue Jackets,2,Metropolitan,Eastern,76,2,134,0.5671641791044776,76,0,76,0
2013-14,2014-03-18,Columbus Blue Jackets,0,Metropolitan,Eastern,76,2,136,0.5588235294117647,78,-2,76,0
2013-14,2014-03-20,Columbus Blue Jackets,2,Metropolitan,Eastern,78,2,138,0.5652173913043478,78,0,78,0
2013-14,2014-03-21,Columbus Blue Jackets,0,Metropolitan,Eastern,78,2,140,0.5571428571428572,80,-2,78,0
2013-14,2014-03-23,Columbus Blue Jackets,0,Metropolitan,Eastern,78,2,142,0.5492957746478874,82,-4,80,-2
2013-14,2014-03-25,Columbus Blue Jackets,2,Metropolitan,Eastern,80,2,144,0.5555555555555556,83,-3,80,0
2013-14,2014-03-28,Columbus Blue Jackets,0,Metropolitan,Eastern,80,2,146,0.547945205479452,85,-5,80,0
2013-14,2014-03-29,Columbus Blue Jackets,2,Metropolitan,Eastern,82,2,148,0.5540540540540541,85,-3,82,0
2013-14,2014-04-01,Columbus Blue Jackets,1,Metropolitan,Eastern,83,2,150,0.5533333333333333,86,-3,83,0
2013-14,2014-04-03,Columbus Blue Jackets,2,Metropolitan,Eastern,85,2,152,0.5592105263157895,87,-2,85,0
2013-14,2014-04-04,Columbus Blue Jackets,0,Metropolitan,Eastern,85,2,154,0.551948051948052,87,-2,85,0
2013-14,2014-04-06,Columbus Blue Jackets,2,Metropolitan,Eastern,87,2,156,0.5576923076923077,89,-2,87,0
2013-14,2014-04-08,Columbus Blue Jackets,2,Metropolitan,Eastern,89,2,158,0.5632911392405063,91,-2,89,0
2013-14,2014-04-10,Columbus Blue Jackets,2,Metropolitan,Eastern,91,2,160,0.56875,91,0,91,0
2013-14,2014-04-11,Columbus Blue Jackets,0,Metropolitan,Eastern,91,2,162,0.5617283950617284,91,0,91,0
2013-14,2014-04-12,Columbus Blue Jackets,2,Metropolitan,Eastern,93,2,164,0.5670731707317073,93,0,91,2
2013-14,2013-10-04,Dallas Stars,0,Central,Western,0,2,2,0.0,2,-2,2,-2
2013-14,2013-10-06,Dallas Stars,2,Central,Western,2,2,4,0.5,4,-2,2,0
2013-14,2013-10-12,Dallas Stars,2,Central,Western,4,2,6,0.6666666666666666,5,-1,6,-2
2013-14,2013-10-13,Dallas Stars,0,Central,Western,4,2,8,0.5,7,-3,6,-2
2013-14,2013-10-16,Dallas Stars,0,Central,Western,4,2,10,0.4,8,-4,8,-4
2013-14,2013-10-18,Dallas Stars,2,Central,Western,6,2,12,0.5,10,-4,9,-3
2013-14,2013-10-20,Dallas Stars,0,Central,Western,6,2,14,0.42857142857142855,11,-5,11,-5
2013-14,2013-10-21,Dallas Stars,0,Central,Western,6,2,16,0.375,11,-5,11,-5
2013-14,2013-10-25,Dallas Stars,2,Central,Western,8,2,18,0.4444444444444444,13,-5,13,-5
2013-14,2013-10-26,Dallas Stars,1,Central,Western,9,2,20,0.45,13,-4,13,-4
2013-14,2013-10-28,Dallas Stars,2,Central,Western,11,2,22,0.5,15,-4,15,-4
2013-14,2013-10-29,Dallas Stars,0,Central,Western,11,2,24,0.4583333333333333,15,-4,15,-4
2013-14,2013-11-02,Dallas Stars,1,Central,Western,12,2,26,0.46153846153846156,18,-6,18,-6
2013-14,2013-11-03,Dallas Stars,2,Central,Western,14,2,28,0.5,18,-4,18,-4
2013-14,2013-11-06,Dallas Stars,2,Central,Western,16,2,30,0.5333333333333333,21,-5,20,-4
2013-14,2013-11-08,Dallas Stars,2,Central,Western,18,2,32,0.5625,22,-4,22,-4
2013-14,2013-11-10,Dallas Stars,0,Central,Western,18,2,34,0.5294117647058824,24,-6,24,-6
2013-14,2013-11-14,Dallas Stars,2,Central,Western,20,2,36,0.5555555555555556,26,-6,24,-4
2013-14,2013-11-15,Dallas Stars,2,Central,Western,22,2,38,0.5789473684210527,27,-5,25,-3
2013-14,2013-11-18,Dallas Stars,2,Central,Western,24,2,40,0.6,28,-4,28,-4
2013-14,2013-11-22,Dallas Stars,0,Central,Western,24,2,42,0.5714285714285714,32,-8,32,-8
2013-14,2013-11-24,Dallas Stars,0,Central,Western,24,2,44,0.5454545454545454,34,-10,32,-8
2013-14,2013-11-27,Dallas Stars,2,Central,Western,26,2,46,0.5652173913043478,34,-8,32,-6
2013-14,2013-11-30,Dallas Stars,1,Central,Western,27,2,48,0.5625,36,-9,34,-7
2013-14,2013-12-01,Dallas Stars,1,Central,Western,28,2,50,0.56,38,-10,34,-6
2013-14,2013-12-04,Dallas Stars,2,Central,Western,30,2,52,0.5769230769230769,38,-8,36,-6
2013-14,2013-12-06,Dallas Stars,1,Central,Western,31,2,54,0.5740740740740741,39,-8,36,-5
2013-14,2013-12-07,Dallas Stars,2,Central,Western,33,2,56,0.5892857142857143,40,-7,37,-4
2013-14,2013-12-11,Dallas Stars,0,Central,Western,33,2,58,0.5689655172413793,41,-8,40,-7
2013-14,2013-12-13,Dallas Stars,0,Central,Western,33,2,60,0.55,42,-9,41,-8
2013-14,2013-12-14,Dallas Stars,2,Central,Western,35,2,62,0.5645161290322581,42,-7,41,-6
2013-14,2013-12-17,Dallas Stars,0,Central,Western,35,2,64,0.546875,45,-10,43,-8
2013-14,2013-12-18,Dallas Stars,2,Central,Western,37,2,66,0.5606060606060606,45,-8,45,-8
2013-14,2013-12-20,Dallas Stars,2,Central,Western,39,2,68,0.5735294117647058,47,-8,45,-6
2013-14,2013-12-22,Dallas Stars,1,Central,Western,40,2,70,0.5714285714285714,48,-8,45,-5
2013-14,2013-12-24,Dallas Stars,2,Central,Western,42,2,72,0.5833333333333334,49,-7,45,-3
2013-14,2013-12-28,Dallas Stars,2,Central,Western,44,2,74,0.5945945945945946,49,-5,46,-2
2013-14,2013-12-29,Dallas Stars,1,Central,Western,45,2,76,0.5921052631578947,49,-4,47,-2
2013-14,2014-01-01,Dallas Stars,2,Central,Western,47,2,78,0.6025641025641025,52,-5,49,-2
2013-14,2014-01-03,Dallas Stars,0,Central,Western,47,2,80,0.5875,54,-7,49,-2
2013-14,2014-01-05,Dallas Stars,0,Central,Western,47,2,82,0.573170731707317,56,-9,49,-2
2013-14,2014-01-07,Dallas Stars,0,Central,Western,47,2,84,0.5595238095238095,56,-9,49,-2
2013-14,2014-01-10,Dallas Stars,0,Central,Western,47,2,86,0.5465116279069767,58,-11,53,-6
2013-14,2014-01-11,Dallas Stars,0,Central,Western,47,2,88,0.5340909090909091,59,-12,53,-6
2013-14,2014-01-12,Dallas Stars,0,Central,Western,47,2,90,0.5222222222222223,61,-14,53,-6
2013-14,2014-01-15,Dallas Stars,2,Central,Western,49,2,92,0.532608695652174,63,-14,55,-6
2013-14,2014-01-17,Dallas Stars,0,Central,Western,49,2,94,0.5212765957446809,65,-16,57,-8
2013-14,2014-01-19,Dallas Stars,1,Central,Western,50,2,96,0.5208333333333334,67,-17,59,-9
2013-14,2014-01-21,Dallas Stars,0,Central,Western,50,2,98,0.5102040816326531,67,-17,59,-9
2013-14,2014-01-22,Dallas Stars,2,Central,Western,52,2,100,0.52,67,-15,59,-7
2013-14,2014-01-24,Dallas Stars,2,Central,Western,54,2,102,0.5294117647058824,67,-13,61,-7
2013-14,2014-01-26,Dallas Stars,2,Central,Western,56,2,104,0.5384615384615384,69,-13,61,-5
2013-14,2014-01-28,Dallas Stars,0,Central,Western,56,2,106,0.5283018867924528,71,-15,62,-6
2013-14,2014-01-31,Dallas Stars,1,Central,Western,57,2,108,0.5277777777777778,73,-16,63,-6
2013-14,2014-02-02,Dallas Stars,2,Central,Western,59,2,110,0.5363636363636364,75,-16,63,-4
2013-14,2014-02-05,Dallas Stars,2,Central,Western,61,2,112,0.5446428571428571,77,-16,63,-2
2013-14,2014-02-06,Dallas Stars,1,Central,Western,62,2,114,0.543859649122807,77,-15,63,-1
2013-14,2014-02-09,Dallas Stars,2,Central,Western,64,2,116,0.5517241379310345,79,-15,64,0
2013-14,2014-02-28,Dallas Stars,2,Central,Western,66,2,118,0.559322033898305,79,-13,66,0
2013-14,2014-03-01,Dallas Stars,0,Central,Western,66,2,120,0.55,81,-15,66,0
2013-14,2014-03-04,Dallas Stars,2,Central,Western,68,2,122,0.5573770491803278,83,-15,68,0
2013-14,2014-03-05,Dallas Stars,0,Central,Western,68,2,124,0.5483870967741935,85,-17,68,0
2013-14,2014-03-07,Dallas Stars,2,Central,Western,70,2,126,0.5555555555555556,87,-17,70,0
2013-14,2014-03-09,Dallas Stars,2,Central,Western,72,2,128,0.5625,87,-15,72,0
2013-14,2014-03-12,Dallas Stars,2,Central,Western,74,2,130,0.5692307692307692,89,-15,74,0
2013-14,2014-03-15,Dallas Stars,1,Central,Western,75,2,132,0.5681818181818182,90,-15,75,0
2013-14,2014-03-17,Dallas Stars,0,Central,Western,75,2,134,0.5597014925373134,92,-17,75,0
2013-14,2014-03-18,Dallas Stars,0,Central,Western,75,2,136,0.5514705882352942,93,-18,77,-2
2013-14,2014-03-20,Dallas Stars,0,Central,Western,75,2,138,0.5434782608695652,94,-19,77,-2
2013-14,2014-03-22,Dallas Stars,2,Central,Western,77,2,140,0.55,94,-17,79,-2
2013-14,2014-03-25,Dallas Stars,2,Central,Western,79,2,142,0.5563380281690141,94,-15,82,-3
2013-14,2014-03-26,Dallas Stars,0,Central,Western,79,2,144,0.5486111111111112,96,-17,82,-3
2013-14,2014-03-29,Dallas Stars,2,Central,Western,81,2,146,0.5547945205479452,99,-18,84,-3
2013-14,2014-03-30,Dallas Stars,2,Central,Western,83,2,148,0.5608108108108109,99,-16,84,-1
2013-14,2014-04-01,Dallas Stars,2,Central,Western,85,2,150,0.5666666666666667,99,-14,85,0
2013-14,2014-04-03,Dallas Stars,0,Central,Western,85,2,152,0.5592105263157895,99,-14,85,0
2013-14,2014-04-05,Dallas Stars,2,Central,Western,87,2,154,0.564935064935065,101,-14,87,0
2013-14,2014-04-06,Dallas Stars,0,Central,Western,87,2,156,0.5576923076923077,105,-18,87,0
2013-14,2014-04-09,Dallas Stars,2,Central,Western,89,2,158,0.5632911392405063,107,-18,89,0
2013-14,2014-04-10,Dallas Stars,0,Central,Western,89,2,160,0.55625,107,-18,89,0
2013-14,2014-04-12,Dallas Stars,2,Central,Western,91,2,162,0.5617283950617284,107,-16,91,0
2013-14,2014-04-14,Dallas Stars,0,Central,Western,91,2,164,0.5548780487804879,107,-16,91,0
2013-14,2013-10-03,Detroit Red Wings,2,Atlantic,Eastern,2,2,2,1.0,2,0,0,2
2013-14,2013-10-04,Detroit Red Wings,2,Atlantic,Eastern,4,2,4,1.0,2,2,2,2
2013-14,2013-10-05,Detroit Red Wings,0,Atlantic,Eastern,4,2,6,0.6666666666666666,4,0,2,2
2013-14,2013-10-10,Detroit Red Wings,0,Atlantic,Eastern,4,2,8,0.5,4,0,4,0
2013-14,2013-10-12,Detroit Red Wings,2,Atlantic,Eastern,6,2,10,0.6,6,0,4,2
2013-14,2013-10-14,Detroit Red Wings,2,Atlantic,Eastern,8,2,12,0.6666666666666666,6,2,5,3
2013-14,2013-10-16,Detroit Red Wings,2,Atlantic,Eastern,10,2,14,0.7142857142857143,8,2,6,4
2013-14,2013-10-18,Detroit Red Wings,2,Atlantic,Eastern,12,2,16,0.75,10,2,8,4
2013-14,2013-10-20,Detroit Red Wings,0,Atlantic,Eastern,12,2,18,0.6666666666666666,10,2,8,4
2013-14,2013-10-21,Detroit Red Wings,1,Atlantic,Eastern,13,2,20,0.65,10,3,8,5
2013-14,2013-10-23,Detroit Red Wings,0,Atlantic,Eastern,13,2,22,0.5909090909090909,10,3,10,3
2013-14,2013-10-26,Detroit Red Wings,1,Atlantic,Eastern,14,2,24,0.5833333333333334,14,0,11,3
2013-14,2013-10-31,Detroit Red Wings,2,Atlantic,Eastern,16,2,26,0.6153846153846154,16,0,11,5
2013-14,2013-11-02,Detroit Red Wings,2,Atlantic,Eastern,18,2,28,0.6428571428571429,18,0,14,4
2013-14,2013-11-03,Detroit Red Wings,2,Atlantic,Eastern,20,2,30,0.6666666666666666,20,0,14,6
2013-14,2013-11-05,Detroit Red Wings,0,Atlantic,Eastern,20,2,32,0.625,20,0,14,6
2013-14,2013-11-08,Detroit Red Wings,1,Atlantic,Eastern,21,2,34,0.6176470588235294,20,1,16,5
2013-14,2013-11-10,Detroit Red Wings,1,Atlantic,Eastern,22,2,36,0.6111111111111112,22,0,18,4
2013-14,2013-11-13,Detroit Red Wings,1,Atlantic,Eastern,23,2,38,0.6052631578947368,23,0,18,5
2013-14,2013-11-16,Detroit Red Wings,1,Atlantic,Eastern,24,2,40,0.6,24,0,20,4
2013-14,2013-11-17,Detroit Red Wings,1,Atlantic,Eastern,25,2,42,0.5952380952380952,25,0,20,5
2013-14,2013-11-20,Detroit Red Wings,0,Atlantic,Eastern,25,2,44,0.5681818181818182,27,-2,20,5
2013-14,2013-11-22,Detroit Red Wings,2,Atlantic,Eastern,27,2,46,0.5869565217391305,27,0,23,4
2013-14,2013-11-24,Detroit Red Wings,0,Atlantic,Eastern,27,2,48,0.5625,29,-2,24,3
2013-14,2013-11-24,Detroit Red Wings,2,Atlantic,Eastern,29,2,50,0.58,29,0,24,5
2013-14,2013-11-28,Detroit Red Wings,2,Atlantic,Eastern,31,2,52,0.5961538461538461,31,0,26,5
2013-14,2013-11-29,Detroit Red Wings,2,Atlantic,Eastern,33,2,54,0.6111111111111112,33,0,26,7
2013-14,2013-12-01,Detroit Red Wings,2,Atlantic,Eastern,35,2,56,0.625,33,2,28,7
2013-14,2013-12-05,Detroit Red Wings,0,Atlantic,Eastern,35,2,58,0.603448275862069,35,0,28,7
2013-14,2013-12-07,Detroit Red Wings,2,Atlantic,Eastern,37,2,60,0.6166666666666667,37,0,30,7
2013-14,2013-12-08,Detroit Red Wings,0,Atlantic,Eastern,37,2,62,0.5967741935483871,37,0,31,6
2013-14,2013-12-11,Detroit Red Wings,1,Atlantic,Eastern,38,2,64,0.59375,38,0,32,6
2013-14,2013-12-13,Detroit Red Wings,1,Atlantic,Eastern,39,2,66,0.5909090909090909,39,0,33,6
2013-14,2013-12-15,Detroit Red Wings,0,Atlantic,Eastern,39,2,68,0.5735294117647058,39,0,35,4
2013-14,2013-12-15,Detroit Red Wings,0,Atlantic,Eastern,39,2,70,0.5571428571428572,39,0,35,4
2013-14,2013-12-18,Detroit Red Wings,0,Atlantic,Eastern,39,2,72,0.5416666666666666,43,-4,35,4
2013-14,2013-12-20,Detroit Red Wings,2,Atlantic,Eastern,41,2,74,0.5540540540540541,45,-4,36,5
2013-14,2013-12-22,Detroit Red Wings,2,Atlantic,Eastern,43,2,76,0.5657894736842105,47,-4,37,6
2013-14,2013-12-24,Detroit Red Wings,0,Atlantic,Eastern,43,2,78,0.5512820512820513,47,-4,38,5
2013-14,2013-12-29,Detroit Red Wings,2,Atlantic,Eastern,45,2,80,0.5625,49,-4,40,5
2013-14,2013-12-31,Detroit Red Wings,0,Atlantic,Eastern,45,2,82,0.5487804878048781,49,-4,42,3
2013-14,2014-01-01,Detroit Red Wings,1,Atlantic,Eastern,46,2,84,0.5476190476190477,50,-4,44,2
2013-14,2014-01-05,Detroit Red Wings,2,Atlantic,Eastern,48,2,86,0.5581395348837209,53,-5,46,2
2013-14,2014-01-10,Detroit Red Wings,0,Atlantic,Eastern,48,2,88,0.5454545454545454,55,-7,47,1
2013-14,2014-01-12,Detroit Red Wings,2,Atlantic,Eastern,50,2,90,0.5555555555555556,57,-7,49,1
2013-14,2014-01-13,Detroit Red Wings,0,Atlantic,Eastern,50,2,92,0.5434782608695652,57,-7,50,0
2013-14,2014-01-17,Detroit Red Wings,0,Atlantic,Eastern,50,2,94,0.5319148936170213,59,-9,52,-2
2013-14,2014-01-19,Detroit Red Wings,2,Atlantic,Eastern,52,2,96,0.5416666666666666,59,-7,52,0
2013-14,2014-01-21,Detroit Red Wings,0,Atlantic,Eastern,52,2,98,0.5306122448979592,59,-7,52,0
2013-14,2014-01-23,Detroit Red Wings,2,Atlantic,Eastern,54,2,100,0.54,59,-5,54,0
2013-14,2014-01-25,Detroit Red Wings,2,Atlantic,Eastern,56,2,102,0.5490196078431373,59,-3,56,0
2013-14,2014-01-26,Detroit Red Wings,1,Atlantic,Eastern,57,2,104,0.5480769230769231,60,-3,56,1
2013-14,2014-01-29,Detroit Red Wings,0,Atlantic,Eastern,57,2,106,0.5377358490566038,62,-5,57,0
2013-14,2014-02-01,Detroit Red Wings,2,Atlantic,Eastern,59,2,108,0.5462962962962963,64,-5,59,0
2013-14,2014-02-02,Detroit Red Wings,1,Atlantic,Eastern,60,2,110,0.5454545454545454,66,-6,60,0
2013-14,2014-02-04,Detroit Red Wings,2,Atlantic,Eastern,62,2,112,0.5535714285714286,66,-4,62,0
2013-14,2014-02-07,Detroit Red Wings,2,Atlantic,Eastern,64,2,114,0.5614035087719298,68,-4,64,0
2013-14,2014-02-09,Detroit Red Wings,0,Atlantic,Eastern,64,2,116,0.5517241379310345,70,-6,64,0
2013-14,2014-02-27,Detroit Red Wings,2,Atlantic,Eastern,66,2,118,0.559322033898305,71,-5,66,0
2013-14,2014-02-28,Detroit Red Wings,2,Atlantic,Eastern,68,2,120,0.5666666666666667,71,-3,66,2
2013-14,2014-03-05,Detroit Red Wings,0,Atlantic,Eastern,68,2,122,0.5573770491803278,73,-5,69,-1
2013-14,2014-03-07,Detroit Red Wings,1,Atlantic,Eastern,69,2,124,0.5564516129032258,74,-5,69,0
2013-14,2014-03-08,Detroit Red Wings,2,Atlantic,Eastern,71,2,126,0.5634920634920635,74,-3,71,0
2013-14,2014-03-09,Detroit Red Wings,0,Atlantic,Eastern,71,2,128,0.5546875,76,-5,71,0
2013-14,2014-03-11,Detroit Red Wings,0,Atlantic,Eastern,71,2,130,0.5461538461538461,77,-6,73,-2
2013-14,2014-03-14,Detroit Red Wings,2,Atlantic,Eastern,73,2,132,0.553030303030303,77,-4,73,0
2013-14,2014-03-16,Detroit Red Wings,0,Atlantic,Eastern,73,2,134,0.5447761194029851,80,-7,76,-3
2013-14,2014-03-18,Detroit Red Wings,2,Atlantic,Eastern,75,2,136,0.5514705882352942,81,-6,76,-1
2013-14,2014-03-20,Detroit Red Wings,2,Atlantic,Eastern,77,2,138,0.5579710144927537,83,-6,78,-1
2013-14,2014-03-22,Detroit Red Wings,2,Atlantic,Eastern,79,2,140,0.5642857142857143,85,-6,79,0
2013-14,2014-03-23,Detroit Red Wings,1,Atlantic,Eastern,80,2,142,0.5633802816901409,85,-5,80,0
2013-14,2014-03-25,Detroit Red Wings,0,Atlantic,Eastern,80,2,144,0.5555555555555556,87,-7,80,0
2013-14,2014-03-27,Detroit Red Wings,0,Atlantic,Eastern,80,2,146,0.547945205479452,89,-9,80,0
2013-14,2014-03-29,Detroit Red Wings,2,Atlantic,Eastern,82,2,148,0.5540540540540541,91,-9,82,0
2013-14,2014-03-30,Detroit Red Wings,2,Atlantic,Eastern,84,2,150,0.56,91,-7,82,2
2013-14,2014-04-03,Detroit Red Wings,2,Atlantic,Eastern,86,2,152,0.5657894736842105,93,-7,85,1
2013-14,2014-04-04,Detroit Red Wings,2,Atlantic,Eastern,88,2,154,0.5714285714285714,93,-5,85,3
2013-14,2014-04-05,Detroit Red Wings,0,Atlantic,Eastern,88,2,156,0.5641025641025641,93,-5,85,3
2013-14,2014-04-08,Detroit Red Wings,2,Atlantic,Eastern,90,2,158,0.569620253164557,95,-5,89,1
2013-14,2014-04-10,Detroit Red Wings,1,Atlantic,Eastern,91,2,160,0.56875,97,-6,91,0
2013-14,2014-04-11,Detroit Red Wings,0,Atlantic,Eastern,91,2,162,0.5617283950617284,98,-7,91,0
2013-14,2014-04-13,Detroit Red Wings,2,Atlantic,Eastern,93,2,164,0.5670731707317073,100,-7,93,0
2013-14,2013-10-02,Edmonton Oilers,0,Pacific,Western,0,2,2,0.0,0,0,0,0
2013-14,2013-10-06,Edmonton Oilers,0,Pacific,Western,0,2,4,0.0,2,-2,2,-2
2013-14,2013-10-08,Edmonton Oilers,2,Pacific,Western,2,2,6,0.3333333333333333,4,-2,3,-1
2013-14,2013-10-11,Edmonton Oilers,0,Pacific,Western,2,2,8,0.25,6,-4,6,-4
2013-14,2013-10-12,Edmonton Oilers,1,Pacific,Western,3,2,10,0.3,6,-3,6,-3
2013-14,2013-10-14,Edmonton Oilers,0,Pacific,Western,3,2,12,0.25,8,-5,8,-5
2013-14,2013-10-15,Edmonton Oilers,0,Pacific,Western,3,2,14,0.21428571428571427,8,-5,8,-5
2013-14,2013-10-17,Edmonton Oilers,0,Pacific,Western,3,2,16,0.1875,10,-7,8,-5
2013-14,2013-10-19,Edmonton Oilers,2,Pacific,Western,5,2,18,0.2777777777777778,11,-6,10,-5
2013-14,2013-10-22,Edmonton Oilers,2,Pacific,Western,7,2,20,0.35,13,-6,11,-4
2013-14,2013-10-25,Edmonton Oilers,0,Pacific,Western,7,2,22,0.3181818181818182,15,-8,13,-6
2013-14,2013-10-26,Edmonton Oilers,0,Pacific,Western,7,2,24,0.2916666666666667,16,-9,13,-6
2013-14,2013-10-28,Edmonton Oilers,1,Pacific,Western,8,2,26,0.3076923076923077,17,-9,15,-7
2013-14,2013-10-30,Edmonton Oilers,0,Pacific,Western,8,2,28,0.2857142857142857,19,-11,16,-8
2013-14,2013-11-03,Edmonton Oilers,0,Pacific,Western,8,2,30,0.26666666666666666,22,-14,18,-10
2013-14,2013-11-06,Edmonton Oilers,2,Pacific,Western,10,2,32,0.3125,24,-14,20,-10
2013-14,2013-11-08,Edmonton Oilers,0,Pacific,Western,10,2,34,0.29411764705882354,24,-14,22,-12
2013-14,2013-11-09,Edmonton Oilers,0,Pacific,Western,10,2,36,0.2777777777777778,24,-14,22,-12
2013-14,2013-11-11,Edmonton Oilers,0,Pacific,Western,10,2,38,0.2631578947368421,25,-15,24,-14
2013-14,2013-11-14,Edmonton Oilers,0,Pacific,Western,10,2,40,0.25,27,-17,24,-14
2013-14,2013-11-16,Edmonton Oilers,0,Pacific,Western,10,2,42,0.23809523809523808,29,-19,27,-17
2013-14,2013-11-17,Edmonton Oilers,2,Pacific,Western,12,2,44,0.2727272727272727,31,-19,27,-15
2013-14,2013-11-20,Edmonton Oilers,2,Pacific,Western,14,2,46,0.30434782608695654,31,-17,30,-16
2013-14,2013-11-22,Edmonton Oilers,2,Pacific,Western,16,2,48,0.3333333333333333,32,-16,32,-16
2013-14,2013-11-26,Edmonton Oilers,0,Pacific,Western,16,2,50,0.32,35,-19,32,-16
2013-14,2013-11-29,Edmonton Oilers,2,Pacific,Western,18,2,52,0.34615384615384615,36,-18,34,-16
2013-14,2013-11-30,Edmonton Oilers,0,Pacific,Western,18,2,54,0.3333333333333333,36,-18,34,-16
2013-14,2013-12-01,Edmonton Oilers,2,Pacific,Western,20,2,56,0.35714285714285715,36,-16,34,-14
2013-14,2013-12-04,Edmonton Oilers,0,Pacific,Western,20,2,58,0.3448275862068966,40,-20,36,-16
2013-14,2013-12-06,Edmonton Oilers,2,Pacific,Western,22,2,60,0.36666666666666664,40,-18,36,-14
2013-14,2013-12-08,Edmonton Oilers,1,Pacific,Western,23,2,62,0.3709677419354839,42,-19,37,-14
2013-14,2013-12-11,Edmonton Oilers,2,Pacific,Western,25,2,64,0.390625,44,-19,40,-15
2013-14,2013-12-13,Edmonton Oilers,0,Pacific,Western,25,2,66,0.3787878787878788,46,-21,41,-16
2013-14,2013-12-14,Edmonton Oilers,0,Pacific,Western,25,2,68,0.36764705882352944,46,-21,41,-16
2013-14,2013-12-16,Edmonton Oilers,0,Pacific,Western,25,2,70,0.35714285714285715,46,-21,43,-18
2013-14,2013-12-18,Edmonton Oilers,0,Pacific,Western,25,2,72,0.3472222222222222,48,-23,45,-20
2013-14,2013-12-20,Edmonton Oilers,0,Pacific,Western,25,2,74,0.33783783783783783,48,-23,45,-20
2013-14,2013-12-22,Edmonton Oilers,0,Pacific,Western,25,2,76,0.32894736842105265,50,-25,45,-20
2013-14,2013-12-24,Edmonton Oilers,2,Pacific,Western,27,2,78,0.34615384615384615,52,-25,45,-18
2013-14,2013-12-28,Edmonton Oilers,2,Pacific,Western,29,2,80,0.3625,54,-25,46,-17
2013-14,2013-12-29,Edmonton Oilers,1,Pacific,Western,30,2,82,0.36585365853658536,54,-24,47,-17
2013-14,2014-01-01,Edmonton Oilers,1,Pacific,Western,31,2,84,0.36904761904761907,54,-23,49,-18
2013-14,2014-01-03,Edmonton Oilers,0,Pacific,Western,31,2,86,0.36046511627906974,54,-23,49,-18
2013-14,2014-01-04,Edmonton Oilers,0,Pacific,Western,31,2,88,0.3522727272727273,54,-23,49,-18
2013-14,2014-01-06,Edmonton Oilers,2,Pacific,Western,33,2,90,0.36666666666666664,56,-23,49,-16
2013-14,2014-01-08,Edmonton Oilers,0,Pacific,Western,33,2,92,0.358695652173913,57,-24,51,-18
2013-14,2014-01-11,Edmonton Oilers,2,Pacific,Western,35,2,94,0.3723404255319149,59,-24,53,-18
2013-14,2014-01-13,Edmonton Oilers,0,Pacific,Western,35,2,96,0.3645833333333333,59,-24,55,-20
2013-14,2014-01-15,Edmonton Oilers,0,Pacific,Western,35,2,98,0.35714285714285715,61,-26,55,-20
2013-14,2014-01-17,Edmonton Oilers,0,Pacific,Western,35,2,100,0.35,63,-28,57,-22
2013-14,2014-01-18,Edmonton Oilers,1,Pacific,Western,36,2,102,0.35294117647058826,63,-27,57,-21
2013-14,2014-01-22,Edmonton Oilers,0,Pacific,Western,36,2,104,0.34615384615384615,64,-28,59,-23
2013-14,2014-01-25,Edmonton Oilers,0,Pacific,Western,36,2,106,0.33962264150943394,64,-28,61,-25
2013-14,2014-01-27,Edmonton Oilers,2,Pacific,Western,38,2,108,0.35185185185185186,64,-26,62,-24
2013-14,2014-01-28,Edmonton Oilers,2,Pacific,Western,40,2,110,0.36363636363636365,66,-26,62,-22
2013-14,2014-01-30,Edmonton Oilers,2,Pacific,Western,42,2,112,0.375,66,-24,63,-21
2013-14,2014-02-01,Edmonton Oilers,0,Pacific,Western,42,2,114,0.3684210526315789,66,-24,63,-21
2013-14,2014-02-04,Edmonton Oilers,2,Pacific,Western,44,2,116,0.3793103448275862,66,-22,63,-19
2013-14,2014-02-07,Edmonton Oilers,2,Pacific,Western,46,2,118,0.3898305084745763,68,-22,63,-17
2013-14,2014-02-08,Edmonton Oilers,1,Pacific,Western,47,2,120,0.39166666666666666,68,-21,64,-17
2013-14,2014-02-28,Edmonton Oilers,0,Pacific,Western,47,2,122,0.38524590163934425,72,-25,66,-19
2013-14,2014-03-02,Edmonton Oilers,1,Pacific,Western,48,2,124,0.3870967741935484,74,-26,66,-18
2013-14,2014-03-05,Edmonton Oilers,2,Pacific,Western,50,2,126,0.3968253968253968,76,-26,68,-18
2013-14,2014-03-07,Edmonton Oilers,2,Pacific,Western,52,2,128,0.40625,78,-26,70,-18
2013-14,2014-03-10,Edmonton Oilers,0,Pacific,Western,52,2,130,0.4,80,-28,72,-20
2013-14,2014-03-12,Edmonton Oilers,2,Pacific,Western,54,2,132,0.4090909090909091,82,-28,74,-20
2013-14,2014-03-14,Edmonton Oilers,0,Pacific,Western,54,2,134,0.40298507462686567,82,-28,74,-20
2013-14,2014-03-14,Edmonton Oilers,1,Pacific,Western,55,2,136,0.40441176470588236,82,-27,74,-19
2013-14,2014-03-16,Edmonton Oilers,2,Pacific,Western,57,2,138,0.41304347826086957,82,-25,75,-18
2013-14,2014-03-19,Edmonton Oilers,2,Pacific,Western,59,2,140,0.42142857142857143,82,-23,77,-18
2013-14,2014-03-21,Edmonton Oilers,0,Pacific,Western,59,2,142,0.4154929577464789,84,-25,79,-20
2013-14,2014-03-23,Edmonton Oilers,0,Pacific,Western,59,2,144,0.4097222222222222,86,-27,79,-20
2013-14,2014-03-26,Edmonton Oilers,0,Pacific,Western,59,2,146,0.4041095890410959,90,-31,82,-23
2013-14,2014-03-29,Edmonton Oilers,2,Pacific,Western,61,2,148,0.41216216216216217,92,-31,84,-23
2013-14,2014-03-31,Edmonton Oilers,0,Pacific,Western,61,2,150,0.4066666666666667,94,-33,84,-23
2013-14,2014-04-02,Edmonton Oilers,0,Pacific,Western,61,2,152,0.40131578947368424,94,-33,85,-24
2013-14,2014-04-03,Edmonton Oilers,0,Pacific,Western,61,2,154,0.3961038961038961,96,-35,85,-24
2013-14,2014-04-05,Edmonton Oilers,2,Pacific,Western,63,2,156,0.40384615384615385,96,-33,87,-24
2013-14,2014-04-07,Edmonton Oilers,2,Pacific,Western,65,2,158,0.41139240506329117,96,-31,87,-22
2013-14,2014-04-09,Edmonton Oilers,0,Pacific,Western,65,2,160,0.40625,96,-31,89,-24
2013-14,2014-04-11,Edmonton Oilers,0,Pacific,Western,65,2,162,0.4012345679012346,99,-34,89,-24
2013-14,2014-04-13,Edmonton Oilers,2,Pacific,Western,67,2,164,0.40853658536585363,100,-33,91,-24
2013-14,2013-10-04,Florida Panthers,2,Atlantic,Eastern,2,2,2,1.0,2,0,2,0
2013-14,2013-10-06,Florida Panthers,0,Atlantic,Eastern,2,2,4,0.5,4,-2,2,0
2013-14,2013-10-08,Florida Panthers,0,Atlantic,Eastern,2,2,6,0.3333333333333333,4,-2,3,-1
2013-14,2013-10-10,Florida Panthers,0,Atlantic,Eastern,2,2,8,0.25,4,-2,4,-2
2013-14,2013-10-11,Florida Panthers,2,Atlantic,Eastern,4,2,10,0.4,4,0,4,0
2013-14,2013-10-13,Florida Panthers,0,Atlantic,Eastern,4,2,12,0.3333333333333333,6,-2,5,-1
2013-14,2013-10-16,Florida Panthers,0,Atlantic,Eastern,4,2,14,0.2857142857142857,8,-4,6,-2
2013-14,2013-10-17,Florida Panthers,0,Atlantic,Eastern,4,2,16,0.25,10,-6,8,-4
2013-14,2013-10-19,Florida Panthers,2,Atlantic,Eastern,6,2,18,0.3333333333333333,10,-4,8,-2
2013-14,2013-10-22,Florida Panthers,1,Atlantic,Eastern,7,2,20,0.35,10,-3,9,-2
2013-14,2013-10-25,Florida Panthers,0,Atlantic,Eastern,7,2,22,0.3181818181818182,12,-5,11,-4
2013-14,2013-10-27,Florida Panthers,1,Atlantic,Eastern,8,2,24,0.3333333333333333,14,-6,11,-3
2013-14,2013-11-01,Florida Panthers,0,Atlantic,Eastern,8,2,26,0.3076923076923077,16,-8,12,-4
2013-14,2013-11-02,Florida Panthers,1,Atlantic,Eastern,9,2,28,0.32142857142857145,18,-9,14,-5
2013-14,2013-11-06,Florida Panthers,1,Atlantic,Eastern,10,2,30,0.3333333333333333,20,-10,15,-5
2013-14,2013-11-08,Florida Panthers,0,Atlantic,Eastern,10,2,32,0.3125,20,-10,16,-6
2013-14,2013-11-09,Florida Panthers,0,Atlantic,Eastern,10,2,34,0.29411764705882354,21,-11,17,-7
2013-14,2013-11-11,Florida Panthers,0,Atlantic,Eastern,10,2,36,0.2777777777777778,22,-12,18,-8
2013-14,2013-11-13,Florida Panthers,2,Atlantic,Eastern,12,2,38,0.3157894736842105,23,-11,18,-6
2013-14,2013-11-16,Florida Panthers,0,Atlantic,Eastern,12,2,40,0.3,24,-12,20,-8
2013-14,2013-11-17,Florida Panthers,2,Atlantic,Eastern,14,2,42,0.3333333333333333,25,-11,20,-6
2013-14,2013-11-20,Florida Panthers,2,Atlantic,Eastern,16,2,44,0.36363636363636365,27,-11,20,-4
2013-14,2013-11-22,Florida Panthers,0,Atlantic,Eastern,16,2,46,0.34782608695652173,27,-11,23,-7
2013-14,2013-11-23,Florida Panthers,1,Atlantic,Eastern,17,2,48,0.3541666666666667,27,-10,23,-6
2013-14,2013-11-26,Florida Panthers,2,Atlantic,Eastern,19,2,50,0.38,29,-10,24,-5
2013-14,2013-11-28,Florida Panthers,0,Atlantic,Eastern,19,2,52,0.36538461538461536,31,-12,26,-7
2013-14,2013-12-01,Florida Panthers,0,Atlantic,Eastern,19,2,54,0.35185185185185186,33,-14,28,-9
2013-14,2013-12-04,Florida Panthers,0,Atlantic,Eastern,19,2,56,0.3392857142857143,35,-16,28,-9
2013-14,2013-12-06,Florida Panthers,2,Atlantic,Eastern,21,2,58,0.3620689655172414,35,-14,30,-9
2013-14,2013-12-08,Florida Panthers,2,Atlantic,Eastern,23,2,60,0.38333333333333336,37,-14,31,-8
2013-14,2013-12-09,Florida Panthers,0,Atlantic,Eastern,23,2,62,0.3709677419354839,37,-14,31,-8
2013-14,2013-12-11,Florida Panthers,2,Atlantic,Eastern,25,2,64,0.390625,38,-13,32,-7
2013-14,2013-12-14,Florida Panthers,2,Atlantic,Eastern,27,2,66,0.4090909090909091,39,-12,33,-6
2013-14,2013-12-15,Florida Panthers,2,Atlantic,Eastern,29,2,68,0.4264705882352941,39,-10,35,-6
2013-14,2013-12-18,Florida Panthers,2,Atlantic,Eastern,31,2,70,0.44285714285714284,43,-12,35,-4
2013-14,2013-12-20,Florida Panthers,2,Atlantic,Eastern,33,2,72,0.4583333333333333,45,-12,36,-3
2013-14,2013-12-21,Florida Panthers,0,Atlantic,Eastern,33,2,74,0.44594594594594594,45,-12,36,-3
2013-14,2013-12-24,Florida Panthers,0,Atlantic,Eastern,33,2,76,0.4342105263157895,47,-14,38,-5
2013-14,2013-12-29,Florida Panthers,0,Atlantic,Eastern,33,2,78,0.4230769230769231,49,-16,40,-7
2013-14,2013-12-29,Florida Panthers,2,Atlantic,Eastern,35,2,80,0.4375,49,-14,40,-5
2013-14,2013-12-31,Florida Panthers,1,Atlantic,Eastern,36,2,82,0.43902439024390244,49,-13,42,-6
2013-14,2014-01-05,Florida Panthers,2,Atlantic,Eastern,38,2,84,0.4523809523809524,53,-15,46,-8
2013-14,2014-01-07,Florida Panthers,0,Atlantic,Eastern,38,2,86,0.4418604651162791,54,-16,46,-8
2013-14,2014-01-10,Florida Panthers,2,Atlantic,Eastern,40,2,88,0.45454545454545453,55,-15,47,-7
2013-14,2014-01-12,Florida Panthers,1,Atlantic,Eastern,41,2,90,0.45555555555555555,57,-16,49,-8
2013-14,2014-01-15,Florida Panthers,2,Atlantic,Eastern,43,2,92,0.4673913043478261,57,-14,51,-8
2013-14,2014-01-17,Florida Panthers,0,Atlantic,Eastern,43,2,94,0.4574468085106383,59,-16,52,-9
2013-14,2014-01-19,Florida Panthers,0,Atlantic,Eastern,43,2,96,0.4479166666666667,59,-16,52,-9
2013-14,2014-01-21,Florida Panthers,2,Atlantic,Eastern,45,2,98,0.45918367346938777,59,-14,52,-7
2013-14,2014-01-22,Florida Panthers,2,Atlantic,Eastern,47,2,100,0.47,59,-12,54,-7
2013-14,2014-01-25,Florida Panthers,0,Atlantic,Eastern,47,2,102,0.46078431372549017,59,-12,56,-9
2013-14,2014-01-26,Florida Panthers,2,Atlantic,Eastern,49,2,104,0.47115384615384615,60,-11,56,-7
2013-14,2014-01-29,Florida Panthers,0,Atlantic,Eastern,49,2,106,0.46226415094339623,62,-13,57,-8
2013-14,2014-01-31,Florida Panthers,0,Atlantic,Eastern,49,2,108,0.4537037037037037,64,-15,58,-9
2013-14,2014-02-02,Florida Panthers,0,Atlantic,Eastern,49,2,110,0.44545454545454544,66,-17,60,-11
2013-14,2014-02-05,Florida Panthers,2,Atlantic,Eastern,51,2,112,0.45535714285714285,66,-15,62,-11
2013-14,2014-02-07,Florida Panthers,0,Atlantic,Eastern,51,2,114,0.4473684210526316,68,-17,64,-13
2013-14,2014-02-08,Florida Panthers,0,Atlantic,Eastern,51,2,116,0.4396551724137931,70,-19,64,-13
2013-14,2014-02-28,Florida Panthers,0,Atlantic,Eastern,51,2,118,0.4322033898305085,71,-20,66,-15
2013-14,2014-03-01,Florida Panthers,0,Atlantic,Eastern,51,2,120,0.425,73,-22,68,-17
2013-14,2014-03-02,Florida Panthers,2,Atlantic,Eastern,53,2,122,0.4344262295081967,73,-20,68,-15
2013-14,2014-03-05,Florida Panthers,0,Atlantic,Eastern,53,2,124,0.4274193548387097,73,-20,69,-16
2013-14,2014-03-08,Florida Panthers,2,Atlantic,Eastern,55,2,126,0.4365079365079365,74,-19,71,-16
2013-14,2014-03-09,Florida Panthers,0,Atlantic,Eastern,55,2,128,0.4296875,76,-21,71,-16
2013-14,2014-03-11,Florida Panthers,0,Atlantic,Eastern,55,2,130,0.4230769230769231,77,-22,73,-18
2013-14,2014-03-13,Florida Panthers,0,Atlantic,Eastern,55,2,132,0.4166666666666667,77,-22,73,-18
2013-14,2014-03-14,Florida Panthers,2,Atlantic,Eastern,57,2,134,0.4253731343283582,77,-20,73,-16
2013-14,2014-03-16,Florida Panthers,1,Atlantic,Eastern,58,2,136,0.4264705882352941,80,-22,76,-18
2013-14,2014-03-19,Florida Panthers,2,Atlantic,Eastern,60,2,138,0.43478260869565216,83,-23,76,-16
2013-14,2014-03-21,Florida Panthers,0,Atlantic,Eastern,60,2,140,0.42857142857142855,83,-23,78,-18
2013-14,2014-03-22,Florida Panthers,0,Atlantic,Eastern,60,2,142,0.4225352112676056,85,-25,79,-19
2013-14,2014-03-24,Florida Panthers,0,Atlantic,Eastern,60,2,144,0.4166666666666667,87,-27,80,-20
2013-14,2014-03-25,Florida Panthers,2,Atlantic,Eastern,62,2,146,0.4246575342465753,87,-25,80,-18
2013-14,2014-03-27,Florida Panthers,0,Atlantic,Eastern,62,2,148,0.4189189189189189,89,-27,80,-18
2013-14,2014-03-29,Florida Panthers,0,Atlantic,Eastern,62,2,150,0.41333333333333333,91,-29,82,-20
2013-14,2014-03-31,Florida Panthers,0,Atlantic,Eastern,62,2,152,0.40789473684210525,91,-29,82,-20
2013-14,2014-04-01,Florida Panthers,0,Atlantic,Eastern,62,2,154,0.4025974025974026,93,-31,83,-21
2013-14,2014-04-04,Florida Panthers,0,Atlantic,Eastern,62,2,156,0.3974358974358974,93,-31,85,-23
2013-14,2014-04-06,Florida Panthers,2,Atlantic,Eastern,64,2,158,0.4050632911392405,93,-29,87,-23
2013-14,2014-04-08,Florida Panthers,0,Atlantic,Eastern,64,2,160,0.4,95,-31,89,-25
2013-14,2014-04-10,Florida Panthers,2,Atlantic,Eastern,66,2,162,0.4074074074074074,97,-31,91,-25
2013-14,2014-04-12,Florida Panthers,0,Atlantic,Eastern,66,2,164,0.4024390243902439,99,-33,91,-25
2013-14,2013-10-04,Los Angeles Kings,2,Pacific,Western,2,2,2,1.0,2,0,2,0
2013-14,2013-10-05,Los Angeles Kings,0,Pacific,Western,2,2,4,0.5,2,0,2,0
2013-14,2013-10-08,Los Angeles Kings,0,Pacific,Western,2,2,6,0.3333333333333333,4,-2,3,-1
2013-14,2013-10-10,Los Angeles Kings,2,Pacific,Western,4,2,8,0.5,6,-2,4,0
2013-14,2013-10-11,Los Angeles Kings,2,Pacific,Western,6,2,10,0.6,6,0,6,0
2013-14,2013-10-13,Los Angeles Kings,2,Pacific,Western,8,2,12,0.6666666666666666,8,0,6,2
2013-14,2013-10-15,Los Angeles Kings,0,Pacific,Western,8,2,14,0.5714285714285714,8,0,8,0
2013-14,2013-10-18,Los Angeles Kings,2,Pacific,Western,10,2,16,0.625,10,0,9,1
2013-14,2013-10-20,Los Angeles Kings,2,Pacific,Western,12,2,18,0.6666666666666666,12,0,11,1
2013-14,2013-10-22,Los Angeles Kings,0,Pacific,Western,12,2,20,0.6,13,-1,11,1
2013-14,2013-10-25,Los Angeles Kings,2,Pacific,Western,14,2,22,0.6363636363636364,15,-1,13,1
2013-14,2013-10-28,Los Angeles Kings,2,Pacific,Western,16,2,24,0.6666666666666666,17,-1,15,1
2013-14,2013-10-30,Los Angeles Kings,0,Pacific,Western,16,2,26,0.6153846153846154,19,-3,16,0
2013-14,2013-10-31,Los Angeles Kings,2,Pacific,Western,18,2,28,0.6428571428571429,19,-1,16,2
2013-14,2013-11-03,Los Angeles Kings,0,Pacific,Western,18,2,30,0.6,22,-4,18,0
2013-14,2013-11-08,Los Angeles Kings,2,Pacific,Western,20,2,32,0.625,24,-4,22,-2
2013-14,2013-11-10,Los Angeles Kings,2,Pacific,Western,22,2,34,0.6470588235294118,24,-2,24,-2
2013-14,2013-11-13,Los Angeles Kings,1,Pacific,Western,23,2,36,0.6388888888888888,27,-4,24,-1
2013-14,2013-11-15,Los Angeles Kings,2,Pacific,Western,25,2,38,0.6578947368421053,29,-4,25,0
2013-14,2013-11-16,Los Angeles Kings,2,Pacific,Western,27,2,40,0.675,29,-2,27,0
2013-14,2013-11-18,Los Angeles Kings,2,Pacific,Western,29,2,42,0.6904761904761905,31,-2,28,1
2013-14,2013-11-20,Los Angeles Kings,2,Pacific,Western,31,2,44,0.7045454545454546,31,0,30,1
2013-14,2013-11-22,Los Angeles Kings,1,Pacific,Western,32,2,46,0.6956521739130435,32,0,32,0
2013-14,2013-11-24,Los Angeles Kings,1,Pacific,Western,33,2,48,0.6875,33,0,32,1
2013-14,2013-11-26,Los Angeles Kings,2,Pacific,Western,35,2,50,0.7,35,0,32,3
2013-14,2013-11-28,Los Angeles Kings,1,Pacific,Western,36,2,52,0.6923076923076923,36,0,34,2
2013-14,2013-12-01,Los Angeles Kings,0,Pacific,Western,36,2,54,0.6666666666666666,36,0,34,2
2013-14,2013-12-03,Los Angeles Kings,2,Pacific,Western,38,2,56,0.6785714285714286,38,0,34,4
2013-14,2013-12-04,Los Angeles Kings,2,Pacific,Western,40,2,58,0.6896551724137931,40,0,36,4
2013-14,2013-12-08,Los Angeles Kings,2,Pacific,Western,42,2,60,0.7,42,0,37,5
2013-14,2013-12-11,Los Angeles Kings,2,Pacific,Western,44,2,62,0.7096774193548387,44,0,40,4
2013-14,2013-12-12,Los Angeles Kings,2,Pacific,Western,46,2,64,0.71875,44,2,40,6
2013-14,2013-12-14,Los Angeles Kings,2,Pacific,Western,48,2,66,0.7272727272727273,46,2,41,7
2013-14,2013-12-16,Los Angeles Kings,0,Pacific,Western,48,2,68,0.7058823529411765,46,2,43,5
2013-14,2013-12-18,Los Angeles Kings,2,Pacific,Western,50,2,70,0.7142857142857143,48,2,45,5
2013-14,2013-12-20,Los Angeles Kings,2,Pacific,Western,52,2,72,0.7222222222222222,48,4,45,7
2013-14,2013-12-21,Los Angeles Kings,2,Pacific,Western,54,2,74,0.7297297297297297,48,6,45,9
2013-14,2013-12-24,Los Angeles Kings,0,Pacific,Western,54,2,76,0.7105263157894737,52,2,45,9
2013-14,2013-12-29,Los Angeles Kings,0,Pacific,Western,54,2,78,0.6923076923076923,54,0,47,7
2013-14,2013-12-31,Los Angeles Kings,0,Pacific,Western,54,2,80,0.675,54,0,47,7
2013-14,2014-01-01,Los Angeles Kings,0,Pacific,Western,54,2,82,0.6585365853658537,54,0,49,5
2013-14,2014-01-03,Los Angeles Kings,0,Pacific,Western,54,2,84,0.6428571428571429,54,0,49,5
2013-14,2014-01-05,Los Angeles Kings,2,Pacific,Western,56,2,86,0.6511627906976745,56,0,49,7
2013-14,2014-01-08,Los Angeles Kings,1,Pacific,Western,57,2,88,0.6477272727272727,57,0,51,6
2013-14,2014-01-10,Los Angeles Kings,2,Pacific,Western,59,2,90,0.6555555555555556,59,0,53,6
2013-14,2014-01-12,Los Angeles Kings,0,Pacific,Western,59,2,92,0.6413043478260869,59,0,53,6
2013-14,2014-01-14,Los Angeles Kings,2,Pacific,Western,61,2,94,0.648936170212766,61,0,55,6
2013-14,2014-01-17,Los Angeles Kings,2,Pacific,Western,63,2,96,0.65625,63,0,57,6
2013-14,2014-01-19,Los Angeles Kings,1,Pacific,Western,64,2,98,0.6530612244897959,64,0,59,5
2013-14,2014-01-20,Los Angeles Kings,0,Pacific,Western,64,2,100,0.64,64,0,59,5
2013-14,2014-01-22,Los Angeles Kings,0,Pacific,Western,64,2,102,0.6274509803921569,64,0,59,5
2013-14,2014-01-24,Los Angeles Kings,0,Pacific,Western,64,2,104,0.6153846153846154,64,0,61,3
2013-14,2014-01-26,Los Angeles Kings,0,Pacific,Western,64,2,106,0.6037735849056604,64,0,61,3
2013-14,2014-01-28,Los Angeles Kings,2,Pacific,Western,66,2,108,0.6111111111111112,66,0,62,4
2013-14,2014-01-29,Los Angeles Kings,0,Pacific,Western,66,2,110,0.6,66,0,63,3
2013-14,2014-01-31,Los Angeles Kings,0,Pacific,Western,66,2,112,0.5892857142857143,66,0,63,3
2013-14,2014-02-01,Los Angeles Kings,0,Pacific,Western,66,2,114,0.5789473684210527,66,0,63,3
2013-14,2014-02-04,Los Angeles Kings,0,Pacific,Western,66,2,116,0.5689655172413793,66,0,63,3
2013-14,2014-02-07,Los Angeles Kings,2,Pacific,Western,68,2,118,0.576271186440678,68,0,63,5
2013-14,2014-02-27,Los Angeles Kings,2,Pacific,Western,70,2,120,0.5833333333333334,70,0,65,5
2013-14,2014-02-28,Los Angeles Kings,2,Pacific,Western,72,2,122,0.5901639344262295,72,0,66,6
2013-14,2014-03-01,Los Angeles Kings,2,Pacific,Western,74,2,124,0.5967741935483871,74,0,66,8
2013-14,2014-03-04,Los Angeles Kings,2,Pacific,Western,76,2,126,0.6031746031746031,76,0,68,8
2013-14,2014-03-07,Los Angeles Kings,2,Pacific,Western,78,2,128,0.609375,78,0,70,8
2013-14,2014-03-10,Los Angeles Kings,2,Pacific,Western,80,2,130,0.6153846153846154,80,0,72,8
2013-14,2014-03-11,Los Angeles Kings,2,Pacific,Western,82,2,132,0.6212121212121212,82,0,73,9
2013-14,2014-03-14,Los Angeles Kings,0,Pacific,Western,82,2,134,0.6119402985074627,82,0,74,8
2013-14,2014-03-16,Los Angeles Kings,0,Pacific,Western,82,2,136,0.6029411764705882,82,0,75,7
2013-14,2014-03-18,Los Angeles Kings,0,Pacific,Western,82,2,138,0.5942028985507246,82,0,77,5
2013-14,2014-03-21,Los Angeles Kings,2,Pacific,Western,84,2,140,0.6,84,0,79,5
2013-14,2014-03-22,Los Angeles Kings,2,Pacific,Western,86,2,142,0.6056338028169014,86,0,79,7
2013-14,2014-03-24,Los Angeles Kings,2,Pacific,Western,88,2,144,0.6111111111111112,88,0,80,8
2013-14,2014-03-25,Los Angeles Kings,2,Pacific,Western,90,2,146,0.6164383561643836,90,0,82,8
2013-14,2014-03-27,Los Angeles Kings,2,Pacific,Western,92,2,148,0.6216216216216216,92,0,84,8
2013-14,2014-03-30,Los Angeles Kings,2,Pacific,Western,94,2,150,0.6266666666666667,94,0,84,10
2013-14,2014-04-01,Los Angeles Kings,0,Pacific,Western,94,2,152,0.618421052631579,94,0,85,9
2013-14,2014-04-03,Los Angeles Kings,2,Pacific,Western,96,2,154,0.6233766233766234,96,0,85,11
2013-14,2014-04-04,Los Angeles Kings,0,Pacific,Western,96,2,156,0.6153846153846154,96,0,85,11
2013-14,2014-04-06,Los Angeles Kings,0,Pacific,Western,96,2,158,0.6075949367088608,96,0,87,9
2013-14,2014-04-10,Los Angeles Kings,1,Pacific,Western,97,2,160,0.60625,97,0,89,8
2013-14,2014-04-11,Los Angeles Kings,2,Pacific,Western,99,2,162,0.6111111111111112,99,0,89,10
2013-14,2014-04-13,Los Angeles Kings,1,Pacific,Western,100,2,164,0.6097560975609756,100,0,91,9
2013-14,2013-10-04,Minnesota Wild,1,Central,Western,1,2,2,0.5,2,-1,2,-1
2013-14,2013-10-06,Minnesota Wild,1,Central,Western,2,2,4,0.5,4,-2,2,0
2013-14,2013-10-09,Minnesota Wild,0,Central,Western,2,2,6,0.3333333333333333,4,-2,3,-1
2013-14,2013-10-11,Minnesota Wild,2,Central,Western,4,2,8,0.5,4,0,6,-2
2013-14,2013-10-13,Minnesota Wild,2,Central,Western,6,2,10,0.6,7,-1,6,0
2013-14,2013-10-14,Minnesota Wild,2,Central,Western,8,2,12,0.6666666666666666,8,0,8,0
2013-14,2013-10-15,Minnesota Wild,0,Central,Western,8,2,14,0.5714285714285714,8,0,8,0
2013-14,2013-10-17,Minnesota Wild,0,Central,Western,8,2,16,0.5,8,0,8,0
2013-14,2013-10-19,Minnesota Wild,1,Central,Western,9,2,18,0.5,11,-2,10,-1
2013-14,2013-10-23,Minnesota Wild,2,Central,Western,11,2,20,0.55,11,0,11,0
2013-14,2013-10-25,Minnesota Wild,2,Central,Western,13,2,22,0.5909090909090909,13,0,13,0
2013-14,2013-10-27,Minnesota Wild,2,Central,Western,15,2,24,0.625,15,0,14,1
2013-14,2013-10-29,Minnesota Wild,0,Central,Western,15,2,26,0.5769230769230769,15,0,15,0
2013-14,2013-11-02,Minnesota Wild,2,Central,Western,17,2,28,0.6071428571428571,18,-1,18,-1
2013-14,2013-11-04,Minnesota Wild,2,Central,Western,19,2,30,0.6333333333333333,19,0,18,1
2013-14,2013-11-06,Minnesota Wild,2,Central,Western,21,2,32,0.65625,21,0,20,1
2013-14,2013-11-08,Minnesota Wild,1,Central,Western,22,2,34,0.6470588235294118,22,0,22,0
2013-14,2013-11-10,Minnesota Wild,2,Central,Western,24,2,36,0.6666666666666666,24,0,24,0
2013-14,2013-11-14,Minnesota Wild,2,Central,Western,26,2,38,0.6842105263157895,26,0,24,2
2013-14,2013-11-16,Minnesota Wild,2,Central,Western,28,2,40,0.7,28,0,27,1
2013-14,2013-11-18,Minnesota Wild,2,Central,Western,30,2,42,0.7142857142857143,28,2,28,2
2013-14,2013-11-20,Minnesota Wild,0,Central,Western,30,2,44,0.6818181818181818,30,0,30,0
2013-14,2013-11-21,Minnesota Wild,2,Central,Western,32,2,46,0.6956521739130435,31,1,30,2
2013-14,2013-11-23,Minnesota Wild,2,Central,Western,34,2,48,0.7083333333333334,33,1,32,2
2013-14,2013-11-26,Minnesota Wild,0,Central,Western,34,2,50,0.68,34,0,32,2
2013-14,2013-11-28,Minnesota Wild,0,Central,Western,34,2,52,0.6538461538461539,34,0,34,0
2013-14,2013-11-29,Minnesota Wild,0,Central,Western,34,2,54,0.6296296296296297,36,-2,34,0
2013-14,2013-12-01,Minnesota Wild,1,Central,Western,35,2,56,0.625,38,-3,34,1
2013-14,2013-12-03,Minnesota Wild,2,Central,Western,37,2,58,0.6379310344827587,38,-1,34,3
2013-14,2013-12-06,Minnesota Wild,2,Central,Western,39,2,60,0.65,39,0,36,3
2013-14,2013-12-07,Minnesota Wild,0,Central,Western,39,2,62,0.6290322580645161,40,-1,37,2
2013-14,2013-12-08,Minnesota Wild,2,Central,Western,41,2,64,0.640625,41,0,37,4
2013-14,2013-12-12,Minnesota Wild,0,Central,Western,41,2,66,0.6212121212121212,41,0,40,1
2013-14,2013-12-13,Minnesota Wild,0,Central,Western,41,2,68,0.6029411764705882,42,-1,41,0
2013-14,2013-12-15,Minnesota Wild,2,Central,Western,43,2,70,0.6142857142857143,43,0,43,0
2013-14,2013-12-18,Minnesota Wild,2,Central,Western,45,2,72,0.625,45,0,45,0
2013-14,2013-12-20,Minnesota Wild,0,Central,Western,45,2,74,0.6081081081081081,47,-2,45,0
2013-14,2013-12-23,Minnesota Wild,0,Central,Western,45,2,76,0.5921052631578947,48,-3,45,0
2013-14,2013-12-24,Minnesota Wild,0,Central,Western,45,2,78,0.5769230769230769,49,-4,45,0
2013-14,2013-12-28,Minnesota Wild,0,Central,Western,45,2,80,0.5625,49,-4,46,-1
2013-14,2013-12-30,Minnesota Wild,0,Central,Western,45,2,82,0.5487804878048781,50,-5,47,-2
2013-14,2013-12-31,Minnesota Wild,0,Central,Western,45,2,84,0.5357142857142857,50,-5,47,-2
2013-14,2014-01-03,Minnesota Wild,2,Central,Western,47,2,86,0.5465116279069767,54,-7,49,-2
2013-14,2014-01-05,Minnesota Wild,2,Central,Western,49,2,88,0.5568181818181818,56,-7,49,0
2013-14,2014-01-08,Minnesota Wild,2,Central,Western,51,2,90,0.5666666666666667,56,-5,51,0
2013-14,2014-01-10,Minnesota Wild,2,Central,Western,53,2,92,0.5760869565217391,58,-5,53,0
2013-14,2014-01-12,Minnesota Wild,0,Central,Western,53,2,94,0.5638297872340425,61,-8,53,0
2013-14,2014-01-13,Minnesota Wild,2,Central,Western,55,2,96,0.5729166666666666,61,-6,55,0
2013-14,2014-01-15,Minnesota Wild,0,Central,Western,55,2,98,0.5612244897959183,63,-8,55,0
2013-14,2014-01-17,Minnesota Wild,2,Central,Western,57,2,100,0.57,65,-8,57,0
2013-14,2014-01-19,Minnesota Wild,2,Central,Western,59,2,102,0.5784313725490197,67,-8,59,0
2013-14,2014-01-22,Minnesota Wild,0,Central,Western,59,2,104,0.5673076923076923,67,-8,59,0
2013-14,2014-01-24,Minnesota Wild,2,Central,Western,61,2,106,0.5754716981132075,67,-6,61,0
2013-14,2014-01-26,Minnesota Wild,1,Central,Western,62,2,108,0.5740740740740741,69,-7,61,1
2013-14,2014-01-29,Minnesota Wild,2,Central,Western,64,2,110,0.5818181818181818,71,-7,63,1
2013-14,2014-01-31,Minnesota Wild,0,Central,Western,64,2,112,0.5714285714285714,73,-9,63,1
2013-14,2014-02-02,Minnesota Wild,1,Central,Western,65,2,114,0.5701754385964912,75,-10,63,2
2013-14,2014-02-05,Minnesota Wild,2,Central,Western,67,2,116,0.5775862068965517,77,-10,63,4
2013-14,2014-02-07,Minnesota Wild,2,Central,Western,69,2,118,0.5847457627118644,77,-8,63,6
2013-14,2014-02-28,Minnesota Wild,2,Central,Western,71,2,120,0.5916666666666667,79,-8,66,5
2013-14,2014-03-01,Minnesota Wild,2,Central,Western,73,2,122,0.5983606557377049,81,-8,66,7
2013-14,2014-03-04,Minnesota Wild,2,Central,Western,75,2,124,0.6048387096774194,83,-8,68,7
2013-14,2014-03-09,Minnesota Wild,0,Central,Western,75,2,126,0.5952380952380952,87,-12,72,3
2013-14,2014-03-10,Minnesota Wild,1,Central,Western,76,2,128,0.59375,87,-11,72,4
2013-14,2014-03-12,Minnesota Wild,1,Central,Western,77,2,130,0.5923076923076923,89,-12,74,3
2013-14,2014-03-14,Minnesota Wild,2,Central,Western,79,2,132,0.5984848484848485,90,-11,74,5
2013-14,2014-03-16,Minnesota Wild,1,Central,Western,80,2,134,0.5970149253731343,92,-12,75,5
2013-14,2014-03-17,Minnesota Wild,0,Central,Western,80,2,136,0.5882352941176471,92,-12,75,5
2013-14,2014-03-18,Minnesota Wild,2,Central,Western,82,2,138,0.5942028985507246,93,-11,77,5
2013-14,2014-03-20,Minnesota Wild,1,Central,Western,83,2,140,0.5928571428571429,94,-11,77,6
2013-14,2014-03-22,Minnesota Wild,0,Central,Western,83,2,142,0.5845070422535211,94,-11,79,4
2013-14,2014-03-23,Minnesota Wild,2,Central,Western,85,2,144,0.5902777777777778,94,-9,79,6
2013-14,2014-03-26,Minnesota Wild,0,Central,Western,85,2,146,0.5821917808219178,96,-11,82,3
2013-14,2014-03-28,Minnesota Wild,0,Central,Western,85,2,148,0.5743243243243243,98,-13,84,1
2013-14,2014-03-30,Minnesota Wild,2,Central,Western,87,2,150,0.58,99,-12,84,3
2013-14,2014-04-01,Minnesota Wild,2,Central,Western,89,2,152,0.5855263157894737,99,-10,85,4
2013-14,2014-04-04,Minnesota Wild,1,Central,Western,90,2,154,0.5844155844155844,103,-13,85,5
2013-14,2014-04-06,Minnesota Wild,2,Central,Western,92,2,156,0.5897435897435898,105,-13,87,5
2013-14,2014-04-08,Minnesota Wild,2,Central,Western,94,2,158,0.5949367088607594,105,-11,87,7
2013-14,2014-04-09,Minnesota Wild,2,Central,Western,96,2,160,0.6,107,-11,89,7
2013-14,2014-04-11,Minnesota Wild,2,Central,Western,98,2,162,0.6049382716049383,107,-9,89,9
2013-14,2014-04-14,Minnesota Wild,0,Central,Western,98,2,164,0.5975609756097561,107,-9,91,7
2013-14,2013-10-01,Montréal Canadiens,0,Atlantic,Eastern,0,2,2,0.0,0,0,0,0
2013-14,2013-10-05,Montréal Canadiens,2,Atlantic,Eastern,2,2,4,0.5,4,-2,2,0
2013-14,2013-10-10,Montréal Canadiens,0,Atlantic,Eastern,2,2,6,0.3333333333333333,4,-2,4,-2
2013-14,2013-10-11,Montréal Canadiens,2,Atlantic,Eastern,4,2,8,0.5,4,0,4,0
2013-14,2013-10-13,Montréal Canadiens,2,Atlantic,Eastern,6,2,10,0.6,6,0,5,1
2013-14,2013-10-16,Montréal Canadiens,2,Atlantic,Eastern,8,2,12,0.6666666666666666,8,0,6,2
2013-14,2013-10-17,Montréal Canadiens,2,Atlantic,Eastern,10,2,14,0.7142857142857143,10,0,8,2
2013-14,2013-10-19,Montréal Canadiens,0,Atlantic,Eastern,10,2,16,0.625,10,0,8,2
2013-14,2013-10-22,Montréal Canadiens,0,Atlantic,Eastern,10,2,18,0.5555555555555556,10,0,9,1
2013-14,2013-10-24,Montréal Canadiens,2,Atlantic,Eastern,12,2,20,0.6,13,-1,10,2
2013-14,2013-10-26,Montréal Canadiens,0,Atlantic,Eastern,12,2,22,0.5454545454545454,14,-2,11,1
2013-14,2013-10-28,Montréal Canadiens,2,Atlantic,Eastern,14,2,24,0.5833333333333334,14,0,11,3
2013-14,2013-10-29,Montréal Canadiens,2,Atlantic,Eastern,16,2,26,0.6153846153846154,16,0,11,5
2013-14,2013-11-02,Montréal Canadiens,0,Atlantic,Eastern,16,2,28,0.5714285714285714,18,-2,14,2
2013-14,2013-11-03,Montréal Canadiens,0,Atlantic,Eastern,16,2,30,0.5333333333333333,20,-4,14,2
2013-14,2013-11-06,Montréal Canadiens,1,Atlantic,Eastern,17,2,32,0.53125,20,-3,15,2
2013-14,2013-11-08,Montréal Canadiens,0,Atlantic,Eastern,17,2,34,0.5,20,-3,16,1
2013-14,2013-11-10,Montréal Canadiens,2,Atlantic,Eastern,19,2,36,0.5277777777777778,22,-3,18,1
2013-14,2013-11-13,Montréal Canadiens,1,Atlantic,Eastern,20,2,38,0.5263157894736842,23,-3,18,2
2013-14,2013-11-16,Montréal Canadiens,2,Atlantic,Eastern,22,2,40,0.55,24,-2,20,2
2013-14,2013-11-17,Montréal Canadiens,0,Atlantic,Eastern,22,2,42,0.5238095238095238,25,-3,20,2
2013-14,2013-11-20,Montréal Canadiens,2,Atlantic,Eastern,24,2,44,0.5454545454545454,27,-3,20,4
2013-14,2013-11-23,Montréal Canadiens,2,Atlantic,Eastern,26,2,46,0.5652173913043478,27,-1,23,3
2013-14,2013-11-24,Montréal Canadiens,2,Atlantic,Eastern,28,2,48,0.5833333333333334,29,-1,24,4
2013-14,2013-11-28,Montréal Canadiens,2,Atlantic,Eastern,30,2,50,0.6,31,-1,26,4
2013-14,2013-11-29,Montréal Canadiens,1,Atlantic,Eastern,31,2,52,0.5961538461538461,33,-2,26,5
2013-14,2013-12-01,Montréal Canadiens,2,Atlantic,Eastern,33,2,54,0.6111111111111112,33,0,28,5
2013-14,2013-12-03,Montréal Canadiens,2,Atlantic,Eastern,35,2,56,0.625,35,0,28,7
2013-14,2013-12-05,Montréal Canadiens,2,Atlantic,Eastern,37,2,58,0.6379310344827587,35,2,28,9
2013-14,2013-12-06,Montréal Canadiens,2,Atlantic,Eastern,39,2,60,0.65,35,4,30,9
2013-14,2013-12-08,Montréal Canadiens,2,Atlantic,Eastern,41,2,62,0.6612903225806451,37,4,31,10
2013-14,2013-12-11,Montréal Canadiens,0,Atlantic,Eastern,41,2,64,0.640625,38,3,32,9
2013-14,2013-12-13,Montréal Canadiens,0,Atlantic,Eastern,41,2,66,0.6212121212121212,39,2,33,8
2013-14,2013-12-15,Montréal Canadiens,2,Atlantic,Eastern,43,2,68,0.6323529411764706,39,4,35,8
2013-14,2013-12-15,Montréal Canadiens,0,Atlantic,Eastern,43,2,70,0.6142857142857143,39,4,35,8
2013-14,2013-12-18,Montréal Canadiens,2,Atlantic,Eastern,45,2,72,0.625,43,2,35,10
2013-14,2013-12-20,Montréal Canadiens,0,Atlantic,Eastern,45,2,74,0.6081081081081081,45,0,36,9
2013-14,2013-12-22,Montréal Canadiens,2,Atlantic,Eastern,47,2,76,0.618421052631579,47,0,37,10
2013-14,2013-12-29,Montréal Canadiens,2,Atlantic,Eastern,49,2,78,0.6282051282051282,49,0,40,9
2013-14,2013-12-29,Montréal Canadiens,0,Atlantic,Eastern,49,2,80,0.6125,49,0,40,9
2013-14,2014-01-01,Montréal Canadiens,1,Atlantic,Eastern,50,2,82,0.6097560975609756,50,0,44,6
2013-14,2014-01-03,Montréal Canadiens,2,Atlantic,Eastern,52,2,84,0.6190476190476191,52,0,44,8
2013-14,2014-01-05,Montréal Canadiens,1,Atlantic,Eastern,53,2,86,0.6162790697674418,53,0,46,7
2013-14,2014-01-07,Montréal Canadiens,2,Atlantic,Eastern,55,2,88,0.625,54,1,46,9
2013-14,2014-01-09,Montréal Canadiens,0,Atlantic,Eastern,55,2,90,0.6111111111111112,55,0,47,8
2013-14,2014-01-12,Montréal Canadiens,2,Atlantic,Eastern,57,2,92,0.6195652173913043,57,0,49,8
2013-14,2014-01-15,Montréal Canadiens,0,Atlantic,Eastern,57,2,94,0.6063829787234043,57,0,51,6
2013-14,2014-01-17,Montréal Canadiens,2,Atlantic,Eastern,59,2,96,0.6145833333333334,59,0,52,7
2013-14,2014-01-19,Montréal Canadiens,0,Atlantic,Eastern,59,2,98,0.6020408163265306,59,0,52,7
2013-14,2014-01-23,Montréal Canadiens,0,Atlantic,Eastern,59,2,100,0.59,59,0,54,5
2013-14,2014-01-25,Montréal Canadiens,0,Atlantic,Eastern,59,2,102,0.5784313725490197,59,0,56,3
2013-14,2014-01-26,Montréal Canadiens,0,Atlantic,Eastern,59,2,104,0.5673076923076923,60,-1,56,3
2013-14,2014-01-29,Montréal Canadiens,2,Atlantic,Eastern,61,2,106,0.5754716981132075,62,-1,57,4
2013-14,2014-01-31,Montréal Canadiens,2,Atlantic,Eastern,63,2,108,0.5833333333333334,64,-1,58,5
2013-14,2014-02-01,Montréal Canadiens,1,Atlantic,Eastern,64,2,110,0.5818181818181818,64,0,59,5
2013-14,2014-02-02,Montréal Canadiens,0,Atlantic,Eastern,64,2,112,0.5714285714285714,66,-2,60,4
2013-14,2014-02-05,Montréal Canadiens,2,Atlantic,Eastern,66,2,114,0.5789473684210527,66,0,62,4
2013-14,2014-02-07,Montréal Canadiens,2,Atlantic,Eastern,68,2,116,0.5862068965517241,68,0,64,4
2013-14,2014-02-08,Montréal Canadiens,2,Atlantic,Eastern,70,2,118,0.5932203389830508,70,0,64,6
2013-14,2014-02-27,Montréal Canadiens,1,Atlantic,Eastern,71,2,120,0.5916666666666667,71,0,66,5
2013-14,2014-02-28,Montréal Canadiens,2,Atlantic,Eastern,73,2,122,0.5983606557377049,71,2,66,7
2013-14,2014-03-02,Montréal Canadiens,2,Atlantic,Eastern,75,2,124,0.6048387096774194,73,2,68,7
2013-14,2014-03-04,Montréal Canadiens,0,Atlantic,Eastern,75,2,126,0.5952380952380952,73,2,68,7
2013-14,2014-03-06,Montréal Canadiens,2,Atlantic,Eastern,77,2,128,0.6015625,74,3,69,8
2013-14,2014-03-07,Montréal Canadiens,0,Atlantic,Eastern,77,2,130,0.5923076923076923,74,3,69,8
2013-14,2014-03-09,Montréal Canadiens,0,Atlantic,Eastern,77,2,132,0.5833333333333334,76,1,71,6
2013-14,2014-03-12,Montréal Canadiens,0,Atlantic,Eastern,77,2,134,0.5746268656716418,77,0,73,4
2013-14,2014-03-15,Montréal Canadiens,2,Atlantic,Eastern,79,2,136,0.5808823529411765,79,0,74,5
2013-14,2014-03-16,Montréal Canadiens,2,Atlantic,Eastern,81,2,138,0.5869565217391305,80,1,76,5
2013-14,2014-03-18,Montréal Canadiens,2,Atlantic,Eastern,83,2,140,0.5928571428571429,81,2,76,7
2013-14,2014-03-20,Montréal Canadiens,0,Atlantic,Eastern,83,2,142,0.5845070422535211,83,0,78,5
2013-14,2014-03-22,Montréal Canadiens,2,Atlantic,Eastern,85,2,144,0.5902777777777778,85,0,79,6
2013-14,2014-03-24,Montréal Canadiens,2,Atlantic,Eastern,87,2,146,0.5958904109589042,87,0,80,7
2013-14,2014-03-25,Montréal Canadiens,2,Atlantic,Eastern,89,2,148,0.6013513513513513,87,2,80,9
2013-14,2014-03-27,Montréal Canadiens,2,Atlantic,Eastern,91,2,150,0.6066666666666667,89,2,80,11
2013-14,2014-03-29,Montréal Canadiens,2,Atlantic,Eastern,93,2,152,0.6118421052631579,91,2,82,11
2013-14,2014-04-01,Montréal Canadiens,0,Atlantic,Eastern,93,2,154,0.6038961038961039,93,0,83,10
2013-14,2014-04-04,Montréal Canadiens,2,Atlantic,Eastern,95,2,156,0.6089743589743589,93,2,85,10
2013-14,2014-04-05,Montréal Canadiens,2,Atlantic,Eastern,97,2,158,0.6139240506329114,93,4,85,12
2013-14,2014-04-09,Montréal Canadiens,1,Atlantic,Eastern,98,2,160,0.6125,95,3,89,9
2013-14,2014-04-10,Montréal Canadiens,0,Atlantic,Eastern,98,2,162,0.6049382716049383,97,1,91,7
2013-14,2014-04-12,Montréal Canadiens,2,Atlantic,Eastern,100,2,164,0.6097560975609756,99,1,91,9
2013-14,2013-10-04,Nashville Predators,0,Central,Western,0,2,2,0.0,2,-2,2,-2
2013-14,2013-10-05,Nashville Predators,0,Central,Western,0,2,4,0.0,2,-2,2,-2
2013-14,2013-10-09,Nashville Predators,2,Central,Western,2,2,6,0.3333333333333333,4,-2,3,-1
2013-14,2013-10-11,Nashville Predators,0,Central,Western,2,2,8,0.25,4,-2,6,-4
2013-14,2013-10-13,Nashville Predators,2,Central,Western,4,2,10,0.4,7,-3,6,-2
2013-14,2013-10-16,Nashville Predators,2,Central,Western,6,2,12,0.5,8,-2,8,-2
2013-14,2013-10-18,Nashville Predators,1,Central,Western,7,2,14,0.5,10,-3,9,-2
2013-14,2013-10-19,Nashville Predators,2,Central,Western,9,2,16,0.5625,11,-2,10,-1
2013-14,2013-10-21,Nashville Predators,2,Central,Western,11,2,18,0.6111111111111112,11,0,11,0
2013-14,2013-10-23,Nashville Predators,0,Central,Western,11,2,20,0.55,11,0,11,0
2013-14,2013-10-25,Nashville Predators,2,Central,Western,13,2,22,0.5909090909090909,13,0,13,0
2013-14,2013-10-27,Nashville Predators,0,Central,Western,13,2,24,0.5416666666666666,15,-2,14,-1
2013-14,2013-11-01,Nashville Predators,1,Central,Western,14,2,26,0.5384615384615384,18,-4,18,-4
2013-14,2013-11-03,Nashville Predators,2,Central,Western,16,2,28,0.5714285714285714,18,-2,18,-2
2013-14,2013-11-07,Nashville Predators,2,Central,Western,18,2,30,0.6,21,-3,20,-2
2013-14,2013-11-09,Nashville Predators,0,Central,Western,18,2,32,0.5625,22,-4,22,-4
2013-14,2013-11-11,Nashville Predators,0,Central,Western,18,2,34,0.5294117647058824,24,-6,24,-6
2013-14,2013-11-13,Nashville Predators,0,Central,Western,18,2,36,0.5,25,-7,24,-6
2013-14,2013-11-16,Nashville Predators,0,Central,Western,18,2,38,0.47368421052631576,28,-10,27,-9
2013-14,2013-11-17,Nashville Predators,2,Central,Western,20,2,40,0.5,28,-8,27,-7
2013-14,2013-11-20,Nashville Predators,2,Central,Western,22,2,42,0.5238095238095238,30,-8,30,-8
2013-14,2013-11-22,Nashville Predators,2,Central,Western,24,2,44,0.5454545454545454,32,-8,32,-8
2013-14,2013-11-24,Nashville Predators,0,Central,Western,24,2,46,0.5217391304347826,34,-10,32,-8
2013-14,2013-11-26,Nashville Predators,2,Central,Western,26,2,48,0.5416666666666666,34,-8,32,-6
2013-14,2013-11-28,Nashville Predators,2,Central,Western,28,2,50,0.56,34,-6,34,-6
2013-14,2013-11-29,Nashville Predators,0,Central,Western,28,2,52,0.5384615384615384,36,-8,34,-6
2013-14,2013-12-01,Nashville Predators,1,Central,Western,29,2,54,0.5370370370370371,38,-9,34,-5
2013-14,2013-12-04,Nashville Predators,0,Central,Western,29,2,56,0.5178571428571429,38,-9,36,-7
2013-14,2013-12-06,Nashville Predators,0,Central,Western,29,2,58,0.5,39,-10,36,-7
2013-14,2013-12-08,Nashville Predators,0,Central,Western,29,2,60,0.48333333333333334,41,-12,37,-8
2013-14,2013-12-11,Nashville Predators,2,Central,Western,31,2,62,0.5,41,-10,40,-9
2013-14,2013-12-13,Nashville Predators,2,Central,Western,33,2,64,0.515625,42,-9,41,-8
2013-14,2013-12-15,Nashville Predators,2,Central,Western,35,2,66,0.5303030303030303,43,-8,43,-8
2013-14,2013-12-18,Nashville Predators,0,Central,Western,35,2,68,0.5147058823529411,45,-10,45,-10
2013-14,2013-12-20,Nashville Predators,0,Central,Western,35,2,70,0.5,47,-12,45,-10
2013-14,2013-12-22,Nashville Predators,1,Central,Western,36,2,72,0.5,48,-12,45,-9
2013-14,2013-12-24,Nashville Predators,0,Central,Western,36,2,74,0.4864864864864865,49,-13,45,-9
2013-14,2013-12-28,Nashville Predators,0,Central,Western,36,2,76,0.47368421052631576,49,-13,46,-10
2013-14,2013-12-29,Nashville Predators,2,Central,Western,38,2,78,0.48717948717948717,49,-11,47,-9
2013-14,2013-12-31,Nashville Predators,2,Central,Western,40,2,80,0.5,50,-10,47,-7
2013-14,2014-01-03,Nashville Predators,1,Central,Western,41,2,82,0.5,54,-13,49,-8
2013-14,2014-01-05,Nashville Predators,1,Central,Western,42,2,84,0.5,56,-14,49,-7
2013-14,2014-01-06,Nashville Predators,0,Central,Western,42,2,86,0.4883720930232558,56,-14,49,-7
2013-14,2014-01-08,Nashville Predators,2,Central,Western,44,2,88,0.5,56,-12,51,-7
2013-14,2014-01-10,Nashville Predators,0,Central,Western,44,2,90,0.4888888888888889,58,-14,53,-9
2013-14,2014-01-12,Nashville Predators,1,Central,Western,45,2,92,0.4891304347826087,61,-16,53,-8
2013-14,2014-01-13,Nashville Predators,0,Central,Western,45,2,94,0.4787234042553192,61,-16,55,-10
2013-14,2014-01-15,Nashville Predators,2,Central,Western,47,2,96,0.4895833333333333,63,-16,55,-8
2013-14,2014-01-17,Nashville Predators,2,Central,Western,49,2,98,0.5,65,-16,57,-8
2013-14,2014-01-19,Nashville Predators,0,Central,Western,49,2,100,0.49,67,-18,59,-10
2013-14,2014-01-21,Nashville Predators,2,Central,Western,51,2,102,0.5,67,-16,59,-8
2013-14,2014-01-24,Nashville Predators,2,Central,Western,53,2,104,0.5096153846153846,67,-14,61,-8
2013-14,2014-01-25,Nashville Predators,1,Central,Western,54,2,106,0.5094339622641509,69,-15,61,-7
2013-14,2014-01-27,Nashville Predators,0,Central,Western,54,2,108,0.5,69,-15,62,-8
2013-14,2014-01-29,Nashville Predators,2,Central,Western,56,2,110,0.509090909090909,71,-15,63,-7
2013-14,2014-02-01,Nashville Predators,2,Central,Western,58,2,112,0.5178571428571429,75,-17,63,-5
2013-14,2014-02-02,Nashville Predators,1,Central,Western,59,2,114,0.5175438596491229,75,-16,63,-4
2013-14,2014-02-07,Nashville Predators,1,Central,Western,60,2,116,0.5172413793103449,77,-17,63,-3
2013-14,2014-02-09,Nashville Predators,0,Central,Western,60,2,118,0.5084745762711864,79,-19,64,-4
2013-14,2014-02-28,Nashville Predators,2,Central,Western,62,2,120,0.5166666666666667,79,-17,66,-4
2013-14,2014-03-01,Nashville Predators,0,Central,Western,62,2,122,0.5081967213114754,81,-19,66,-4
2013-14,2014-03-05,Nashville Predators,0,Central,Western,62,2,124,0.5,85,-23,68,-6
2013-14,2014-03-07,Nashville Predators,0,Central,Western,62,2,126,0.49206349206349204,87,-25,70,-8
2013-14,2014-03-09,Nashville Predators,0,Central,Western,62,2,128,0.484375,87,-25,72,-10
2013-14,2014-03-10,Nashville Predators,2,Central,Western,64,2,130,0.49230769230769234,87,-23,72,-8
2013-14,2014-03-11,Nashville Predators,2,Central,Western,66,2,132,0.5,89,-23,73,-7
2013-14,2014-03-15,Nashville Predators,2,Central,Western,68,2,134,0.5074626865671642,90,-22,75,-7
2013-14,2014-03-16,Nashville Predators,0,Central,Western,68,2,136,0.5,92,-24,75,-7
2013-14,2014-03-19,Nashville Predators,0,Central,Western,68,2,138,0.4927536231884058,93,-25,77,-9
2013-14,2014-03-20,Nashville Predators,0,Central,Western,68,2,140,0.4857142857142857,94,-26,77,-9
2013-14,2014-03-22,Nashville Predators,2,Central,Western,70,2,142,0.49295774647887325,94,-24,79,-9
2013-14,2014-03-23,Nashville Predators,2,Central,Western,72,2,144,0.5,94,-22,79,-7
2013-14,2014-03-26,Nashville Predators,1,Central,Western,73,2,146,0.5,96,-23,82,-9
2013-14,2014-03-28,Nashville Predators,2,Central,Western,75,2,148,0.5067567567567568,98,-23,84,-9
2013-14,2014-03-29,Nashville Predators,0,Central,Western,75,2,150,0.5,99,-24,84,-9
2013-14,2014-03-31,Nashville Predators,2,Central,Western,77,2,152,0.506578947368421,99,-22,84,-7
2013-14,2014-04-05,Nashville Predators,2,Central,Western,79,2,154,0.512987012987013,101,-22,87,-8
2013-14,2014-04-06,Nashville Predators,2,Central,Western,81,2,156,0.5192307692307693,105,-24,87,-6
2013-14,2014-04-09,Nashville Predators,1,Central,Western,82,2,158,0.5189873417721519,107,-25,89,-7
2013-14,2014-04-11,Nashville Predators,2,Central,Western,84,2,160,0.525,107,-23,89,-5
2013-14,2014-04-13,Nashville Predators,2,Central,Western,86,2,162,0.5308641975308642,107,-21,91,-5
2013-14,2014-04-14,Nashville Predators,2,Central,Western,88,2,164,0.5365853658536586,107,-19,91,-3
2013-14,2013-10-03,New Jersey Devils,0,Metropolitan,Eastern,0,2,2,0.0,0,0,0,0
2013-14,2013-10-04,New Jersey Devils,1,Metropolitan,Eastern,1,2,4,0.25,2,-1,2,-1
2013-14,2013-10-08,New Jersey Devils,1,Metropolitan,Eastern,2,2,6,0.3333333333333333,3,-1,3,-1
2013-14,2013-10-09,New Jersey Devils,1,Metropolitan,Eastern,3,2,8,0.375,3,0,3,0
2013-14,2013-10-12,New Jersey Devils,0,Metropolitan,Eastern,3,2,10,0.3,5,-2,4,-1
2013-14,2013-10-14,New Jersey Devils,0,Metropolitan,Eastern,3,2,12,0.25,5,-2,5,-2
2013-14,2013-10-17,New Jersey Devils,0,Metropolitan,Eastern,3,2,14,0.21428571428571427,8,-5,8,-5
2013-14,2013-10-19,New Jersey Devils,2,Metropolitan,Eastern,5,2,16,0.3125,8,-3,8,-3
2013-14,2013-10-22,New Jersey Devils,0,Metropolitan,Eastern,5,2,18,0.2777777777777778,9,-4,9,-4
2013-14,2013-10-24,New Jersey Devils,1,Metropolitan,Eastern,6,2,20,0.3,9,-3,10,-4
2013-14,2013-10-26,New Jersey Devils,2,Metropolitan,Eastern,8,2,22,0.36363636363636365,11,-3,11,-3
2013-14,2013-10-29,New Jersey Devils,2,Metropolitan,Eastern,10,2,24,0.4166666666666667,11,-1,11,-1
2013-14,2013-11-02,New Jersey Devils,0,Metropolitan,Eastern,10,2,26,0.38461538461538464,14,-4,14,-4
2013-14,2013-11-04,New Jersey Devils,0,Metropolitan,Eastern,10,2,28,0.35714285714285715,14,-4,14,-4
2013-14,2013-11-08,New Jersey Devils,2,Metropolitan,Eastern,12,2,30,0.4,16,-4,16,-4
2013-14,2013-11-09,New Jersey Devils,1,Metropolitan,Eastern,13,2,32,0.40625,16,-3,17,-4
2013-14,2013-11-11,New Jersey Devils,2,Metropolitan,Eastern,15,2,34,0.4411764705882353,18,-3,18,-3
2013-14,2013-11-13,New Jersey Devils,2,Metropolitan,Eastern,17,2,36,0.4722222222222222,18,-1,18,-1
2013-14,2013-11-16,New Jersey Devils,0,Metropolitan,Eastern,17,2,38,0.4473684210526316,20,-3,20,-3
2013-14,2013-11-17,New Jersey Devils,2,Metropolitan,Eastern,19,2,40,0.475,20,-1,20,-1
2013-14,2013-11-21,New Jersey Devils,2,Metropolitan,Eastern,21,2,42,0.5,21,0,21,0
2013-14,2013-11-22,New Jersey Devils,2,Metropolitan,Eastern,23,2,44,0.5227272727272727,23,0,23,0
2013-14,2013-11-24,New Jersey Devils,0,Metropolitan,Eastern,23,2,46,0.5,24,-1,24,-1
2013-14,2013-11-26,New Jersey Devils,0,Metropolitan,Eastern,23,2,48,0.4791666666666667,24,-1,24,-1
2013-14,2013-11-28,New Jersey Devils,0,Metropolitan,Eastern,23,2,50,0.46,26,-3,26,-3
2013-14,2013-11-30,New Jersey Devils,2,Metropolitan,Eastern,25,2,52,0.4807692307692308,28,-3,28,-3
2013-14,2013-12-01,New Jersey Devils,2,Metropolitan,Eastern,27,2,54,0.5,28,-1,28,-1
2013-14,2013-12-03,New Jersey Devils,0,Metropolitan,Eastern,27,2,56,0.48214285714285715,28,-1,28,-1
2013-14,2013-12-05,New Jersey Devils,1,Metropolitan,Eastern,28,2,58,0.4827586206896552,28,0,28,0
2013-14,2013-12-07,New Jersey Devils,0,Metropolitan,Eastern,28,2,60,0.4666666666666667,30,-2,30,-2
2013-14,2013-12-08,New Jersey Devils,2,Metropolitan,Eastern,30,2,62,0.4838709677419355,31,-1,31,-1
2013-14,2013-12-11,New Jersey Devils,0,Metropolitan,Eastern,30,2,64,0.46875,32,-2,32,-2
2013-14,2013-12-14,New Jersey Devils,0,Metropolitan,Eastern,30,2,66,0.45454545454545453,33,-3,33,-3
2013-14,2013-12-15,New Jersey Devils,2,Metropolitan,Eastern,32,2,68,0.47058823529411764,35,-3,35,-3
2013-14,2013-12-19,New Jersey Devils,2,Metropolitan,Eastern,34,2,70,0.4857142857142857,35,-1,35,-1
2013-14,2013-12-21,New Jersey Devils,1,Metropolitan,Eastern,35,2,72,0.4861111111111111,36,-1,36,-1
2013-14,2013-12-22,New Jersey Devils,2,Metropolitan,Eastern,37,2,74,0.5,37,0,37,0
2013-14,2013-12-24,New Jersey Devils,0,Metropolitan,Eastern,37,2,76,0.4868421052631579,38,-1,38,-1
2013-14,2013-12-28,New Jersey Devils,1,Metropolitan,Eastern,38,2,78,0.48717948717948717,38,0,38,0
2013-14,2013-12-29,New Jersey Devils,2,Metropolitan,Eastern,40,2,80,0.5,40,0,40,0
2013-14,2013-12-31,New Jersey Devils,2,Metropolitan,Eastern,42,2,82,0.5121951219512195,42,0,42,0
2013-14,2014-01-04,New Jersey Devils,0,Metropolitan,Eastern,42,2,84,0.5,44,-2,44,-2
2013-14,2014-01-05,New Jersey Devils,0,Metropolitan,Eastern,42,2,86,0.4883720930232558,46,-4,46,-4
2013-14,2014-01-08,New Jersey Devils,1,Metropolitan,Eastern,43,2,88,0.48863636363636365,46,-3,46,-3
2013-14,2014-01-10,New Jersey Devils,2,Metropolitan,Eastern,45,2,90,0.5,48,-3,47,-2
2013-14,2014-01-12,New Jersey Devils,2,Metropolitan,Eastern,47,2,92,0.5108695652173914,50,-3,49,-2
2013-14,2014-01-13,New Jersey Devils,1,Metropolitan,Eastern,48,2,94,0.5106382978723404,51,-3,50,-2
2013-14,2014-01-15,New Jersey Devils,2,Metropolitan,Eastern,50,2,96,0.5208333333333334,52,-2,51,-1
2013-14,2014-01-17,New Jersey Devils,1,Metropolitan,Eastern,51,2,98,0.5204081632653061,53,-2,52,-1
2013-14,2014-01-19,New Jersey Devils,0,Metropolitan,Eastern,51,2,100,0.51,55,-4,52,-1
2013-14,2014-01-22,New Jersey Devils,2,Metropolitan,Eastern,53,2,102,0.5196078431372549,56,-3,54,-1
2013-14,2014-01-25,New Jersey Devils,2,Metropolitan,Eastern,55,2,104,0.5288461538461539,56,-1,56,-1
2013-14,2014-01-26,New Jersey Devils,0,Metropolitan,Eastern,55,2,106,0.5188679245283019,56,-1,56,-1
2013-14,2014-01-29,New Jersey Devils,0,Metropolitan,Eastern,55,2,108,0.5092592592592593,58,-3,57,-2
2013-14,2014-01-31,New Jersey Devils,2,Metropolitan,Eastern,57,2,110,0.5181818181818182,58,-1,58,-1
2013-14,2014-02-01,New Jersey Devils,1,Metropolitan,Eastern,58,2,112,0.5178571428571429,60,-2,59,-1
2013-14,2014-02-04,New Jersey Devils,1,Metropolitan,Eastern,59,2,114,0.5175438596491229,62,-3,62,-3
2013-14,2014-02-08,New Jersey Devils,2,Metropolitan,Eastern,61,2,116,0.5258620689655172,66,-5,64,-3
2013-14,2014-02-09,New Jersey Devils,0,Metropolitan,Eastern,61,2,118,0.5169491525423728,66,-5,64,-3
2013-14,2014-02-28,New Jersey Devils,2,Metropolitan,Eastern,63,2,120,0.525,66,-3,66,-3
2013-14,2014-03-01,New Jersey Devils,2,Metropolitan,Eastern,65,2,122,0.5327868852459017,68,-3,68,-3
2013-14,2014-03-02,New Jersey Devils,0,Metropolitan,Eastern,65,2,124,0.5241935483870968,69,-4,68,-3
2013-14,2014-03-05,New Jersey Devils,2,Metropolitan,Eastern,67,2,126,0.5317460317460317,69,-2,69,-2
2013-14,2014-03-08,New Jersey Devils,0,Metropolitan,Eastern,67,2,128,0.5234375,72,-5,71,-4
2013-14,2014-03-09,New Jersey Devils,2,Metropolitan,Eastern,69,2,130,0.5307692307692308,73,-4,71,-2
2013-14,2014-03-11,New Jersey Devils,2,Metropolitan,Eastern,71,2,132,0.5378787878787878,73,-2,73,-2
2013-14,2014-03-14,New Jersey Devils,0,Metropolitan,Eastern,71,2,134,0.5298507462686567,74,-3,73,-2
2013-14,2014-03-15,New Jersey Devils,0,Metropolitan,Eastern,71,2,136,0.5220588235294118,75,-4,74,-3
2013-14,2014-03-18,New Jersey Devils,0,Metropolitan,Eastern,71,2,138,0.5144927536231884,78,-7,76,-5
2013-14,2014-03-20,New Jersey Devils,2,Metropolitan,Eastern,73,2,140,0.5214285714285715,78,-5,78,-5
2013-14,2014-03-22,New Jersey Devils,0,Metropolitan,Eastern,73,2,142,0.5140845070422535,82,-9,79,-6
2013-14,2014-03-23,New Jersey Devils,2,Metropolitan,Eastern,75,2,144,0.5208333333333334,82,-7,80,-5
2013-14,2014-03-27,New Jersey Devils,1,Metropolitan,Eastern,76,2,146,0.5205479452054794,83,-7,80,-4
2013-14,2014-03-29,New Jersey Devils,1,Metropolitan,Eastern,77,2,148,0.5202702702702703,85,-8,82,-5
2013-14,2014-03-31,New Jersey Devils,2,Metropolitan,Eastern,79,2,150,0.5266666666666666,86,-7,82,-3
2013-14,2014-04-01,New Jersey Devils,1,Metropolitan,Eastern,80,2,152,0.5263157894736842,86,-6,83,-3
2013-14,2014-04-04,New Jersey Devils,2,Metropolitan,Eastern,82,2,154,0.5324675324675324,87,-5,85,-3
2013-14,2014-04-05,New Jersey Devils,2,Metropolitan,Eastern,84,2,156,0.5384615384615384,87,-3,85,-1
2013-14,2014-04-07,New Jersey Devils,0,Metropolitan,Eastern,84,2,158,0.5316455696202531,89,-5,87,-3
2013-14,2014-04-10,New Jersey Devils,1,Metropolitan,Eastern,85,2,160,0.53125,91,-6,91,-6
2013-14,2014-04-11,New Jersey Devils,1,Metropolitan,Eastern,86,2,162,0.5308641975308642,91,-5,91,-5
2013-14,2014-04-13,New Jersey Devils,2,Metropolitan,Eastern,88,2,164,0.5365853658536586,94,-6,93,-5
2013-14,2013-10-04,New York Islanders,2,Metropolitan,Eastern,2,2,2,1.0,2,0,2,0
2013-14,2013-10-05,New York Islanders,1,Metropolitan,Eastern,3,2,4,0.75,2,1,2,1
2013-14,2013-10-08,New York Islanders,2,Metropolitan,Eastern,5,2,6,0.8333333333333334,3,2,3,2
2013-14,2013-10-12,New York Islanders,0,Metropolitan,Eastern,5,2,8,0.625,5,0,4,1
2013-14,2013-10-13,New York Islanders,0,Metropolitan,Eastern,5,2,10,0.5,5,0,5,0
2013-14,2013-10-15,New York Islanders,1,Metropolitan,Eastern,6,2,12,0.5,6,0,6,0
2013-14,2013-10-17,New York Islanders,2,Metropolitan,Eastern,8,2,14,0.5714285714285714,8,0,8,0
2013-14,2013-10-19,New York Islanders,0,Metropolitan,Eastern,8,2,16,0.5,8,0,8,0
2013-14,2013-10-22,New York Islanders,1,Metropolitan,Eastern,9,2,18,0.5,9,0,9,0
2013-14,2013-10-25,New York Islanders,2,Metropolitan,Eastern,11,2,20,0.55,11,0,11,0
2013-14,2013-10-26,New York Islanders,0,Metropolitan,Eastern,11,2,22,0.5,11,0,11,0
2013-14,2013-10-29,New York Islanders,0,Metropolitan,Eastern,11,2,24,0.4583333333333333,11,0,11,0
2013-14,2013-11-01,New York Islanders,2,Metropolitan,Eastern,13,2,26,0.5,12,1,12,1
2013-14,2013-11-02,New York Islanders,2,Metropolitan,Eastern,15,2,28,0.5357142857142857,14,1,14,1
2013-14,2013-11-06,New York Islanders,0,Metropolitan,Eastern,15,2,30,0.5,15,0,15,0
2013-14,2013-11-08,New York Islanders,0,Metropolitan,Eastern,15,2,32,0.46875,16,-1,16,-1
2013-14,2013-11-10,New York Islanders,0,Metropolitan,Eastern,15,2,34,0.4411764705882353,16,-1,18,-3
2013-14,2013-11-10,New York Islanders,0,Metropolitan,Eastern,15,2,36,0.4166666666666667,16,-1,18,-3
2013-14,2013-11-13,New York Islanders,2,Metropolitan,Eastern,17,2,38,0.4473684210526316,18,-1,18,-1
2013-14,2013-11-15,New York Islanders,0,Metropolitan,Eastern,17,2,40,0.425,18,-1,18,-1
2013-14,2013-11-17,New York Islanders,2,Metropolitan,Eastern,19,2,42,0.4523809523809524,20,-1,20,-1
2013-14,2013-11-20,New York Islanders,0,Metropolitan,Eastern,19,2,44,0.4318181818181818,20,-1,20,-1
2013-14,2013-11-23,New York Islanders,0,Metropolitan,Eastern,19,2,46,0.41304347826086957,23,-4,23,-4
2013-14,2013-11-24,New York Islanders,0,Metropolitan,Eastern,19,2,48,0.3958333333333333,24,-5,24,-5
2013-14,2013-11-28,New York Islanders,0,Metropolitan,Eastern,19,2,50,0.38,26,-7,26,-7
2013-14,2013-11-29,New York Islanders,0,Metropolitan,Eastern,19,2,52,0.36538461538461536,26,-7,26,-7
2013-14,2013-12-01,New York Islanders,1,Metropolitan,Eastern,20,2,54,0.37037037037037035,28,-8,28,-8
2013-14,2013-12-04,New York Islanders,1,Metropolitan,Eastern,21,2,56,0.375,28,-7,28,-7
2013-14,2013-12-06,New York Islanders,0,Metropolitan,Eastern,21,2,58,0.3620689655172414,30,-9,30,-9
2013-14,2013-12-08,New York Islanders,0,Metropolitan,Eastern,21,2,60,0.35,31,-10,31,-10
2013-14,2013-12-10,New York Islanders,0,Metropolitan,Eastern,21,2,62,0.3387096774193548,31,-10,31,-10
2013-14,2013-12-11,New York Islanders,2,Metropolitan,Eastern,23,2,64,0.359375,32,-9,32,-9
2013-14,2013-12-13,New York Islanders,0,Metropolitan,Eastern,23,2,66,0.3484848484848485,33,-10,33,-10
2013-14,2013-12-15,New York Islanders,1,Metropolitan,Eastern,24,2,68,0.35294117647058826,35,-11,35,-11
2013-14,2013-12-18,New York Islanders,1,Metropolitan,Eastern,25,2,70,0.35714285714285715,35,-10,35,-10
2013-14,2013-12-21,New York Islanders,2,Metropolitan,Eastern,27,2,72,0.375,36,-9,36,-9
2013-14,2013-12-22,New York Islanders,0,Metropolitan,Eastern,27,2,74,0.36486486486486486,37,-10,37,-10
2013-14,2013-12-24,New York Islanders,2,Metropolitan,Eastern,29,2,76,0.3815789473684211,38,-9,38,-9
2013-14,2013-12-29,New York Islanders,0,Metropolitan,Eastern,29,2,78,0.3717948717948718,40,-11,40,-11
2013-14,2013-12-30,New York Islanders,2,Metropolitan,Eastern,31,2,80,0.3875,40,-9,40,-9
2013-14,2014-01-01,New York Islanders,2,Metropolitan,Eastern,33,2,82,0.4024390243902439,44,-11,44,-11
2013-14,2014-01-03,New York Islanders,2,Metropolitan,Eastern,35,2,84,0.4166666666666667,44,-9,44,-9
2013-14,2014-01-05,New York Islanders,0,Metropolitan,Eastern,35,2,86,0.4069767441860465,46,-11,46,-11
2013-14,2014-01-07,New York Islanders,2,Metropolitan,Eastern,37,2,88,0.42045454545454547,46,-9,46,-9
2013-14,2014-01-08,New York Islanders,2,Metropolitan,Eastern,39,2,90,0.43333333333333335,46,-7,46,-7
2013-14,2014-01-11,New York Islanders,2,Metropolitan,Eastern,41,2,92,0.44565217391304346,50,-9,48,-7
2013-14,2014-01-12,New York Islanders,2,Metropolitan,Eastern,43,2,94,0.4574468085106383,50,-7,49,-6
2013-14,2014-01-15,New York Islanders,0,Metropolitan,Eastern,43,2,96,0.4479166666666667,52,-9,51,-8
2013-14,2014-01-17,New York Islanders,2,Metropolitan,Eastern,45,2,98,0.45918367346938777,53,-8,52,-7
2013-14,2014-01-19,New York Islanders,0,Metropolitan,Eastern,45,2,100,0.45,55,-10,52,-7
2013-14,2014-01-20,New York Islanders,2,Metropolitan,Eastern,47,2,102,0.46078431372549017,56,-9,52,-5
2013-14,2014-01-22,New York Islanders,2,Metropolitan,Eastern,49,2,104,0.47115384615384615,56,-7,54,-5
2013-14,2014-01-24,New York Islanders,0,Metropolitan,Eastern,49,2,106,0.46226415094339623,56,-7,56,-7
2013-14,2014-01-25,New York Islanders,1,Metropolitan,Eastern,50,2,108,0.46296296296296297,56,-6,56,-6
2013-14,2014-01-28,New York Islanders,0,Metropolitan,Eastern,50,2,110,0.45454545454545453,57,-7,57,-7
2013-14,2014-01-30,New York Islanders,0,Metropolitan,Eastern,50,2,112,0.44642857142857145,58,-8,57,-7
2013-14,2014-02-01,New York Islanders,0,Metropolitan,Eastern,50,2,114,0.43859649122807015,60,-10,59,-9
2013-14,2014-02-05,New York Islanders,2,Metropolitan,Eastern,52,2,116,0.4482758620689655,62,-10,62,-10
2013-14,2014-02-07,New York Islanders,0,Metropolitan,Eastern,52,2,118,0.4406779661016949,64,-12,64,-12
2013-14,2014-02-09,New York Islanders,0,Metropolitan,Eastern,52,2,120,0.43333333333333335,66,-14,64,-12
2013-14,2014-02-28,New York Islanders,2,Metropolitan,Eastern,54,2,122,0.4426229508196721,66,-12,66,-12
2013-14,2014-03-01,New York Islanders,0,Metropolitan,Eastern,54,2,124,0.43548387096774194,68,-14,68,-14
2013-14,2014-03-02,New York Islanders,0,Metropolitan,Eastern,54,2,126,0.42857142857142855,69,-15,68,-14
2013-14,2014-03-05,New York Islanders,2,Metropolitan,Eastern,56,2,128,0.4375,69,-13,69,-13
2013-14,2014-03-07,New York Islanders,1,Metropolitan,Eastern,57,2,130,0.43846153846153846,70,-13,69,-12
2013-14,2014-03-08,New York Islanders,0,Metropolitan,Eastern,57,2,132,0.4318181818181818,72,-15,71,-14
2013-14,2014-03-11,New York Islanders,2,Metropolitan,Eastern,59,2,134,0.44029850746268656,73,-14,73,-14
2013-14,2014-03-14,New York Islanders,0,Metropolitan,Eastern,59,2,136,0.4338235294117647,74,-15,73,-14
2013-14,2014-03-15,New York Islanders,2,Metropolitan,Eastern,61,2,138,0.4420289855072464,75,-14,74,-13
2013-14,2014-03-18,New York Islanders,0,Metropolitan,Eastern,61,2,140,0.4357142857142857,78,-17,76,-15
2013-14,2014-03-23,New York Islanders,2,Metropolitan,Eastern,63,2,142,0.44366197183098594,82,-19,80,-17
2013-14,2014-03-25,New York Islanders,2,Metropolitan,Eastern,65,2,144,0.4513888888888889,83,-18,80,-15
2013-14,2014-03-27,New York Islanders,1,Metropolitan,Eastern,66,2,146,0.4520547945205479,83,-17,80,-14
2013-14,2014-03-29,New York Islanders,2,Metropolitan,Eastern,68,2,148,0.4594594594594595,85,-17,82,-14
2013-14,2014-04-01,New York Islanders,2,Metropolitan,Eastern,70,2,150,0.4666666666666667,86,-16,83,-13
2013-14,2014-04-02,New York Islanders,2,Metropolitan,Eastern,72,2,152,0.47368421052631576,87,-15,83,-11
2013-14,2014-04-05,New York Islanders,1,Metropolitan,Eastern,73,2,154,0.474025974025974,87,-14,85,-12
2013-14,2014-04-06,New York Islanders,0,Metropolitan,Eastern,73,2,156,0.46794871794871795,89,-16,87,-14
2013-14,2014-04-08,New York Islanders,0,Metropolitan,Eastern,73,2,158,0.4620253164556962,91,-18,89,-16
2013-14,2014-04-10,New York Islanders,2,Metropolitan,Eastern,75,2,160,0.46875,91,-16,91,-16
2013-14,2014-04-11,New York Islanders,2,Metropolitan,Eastern,77,2,162,0.47530864197530864,91,-14,91,-14
2013-14,2014-04-13,New York Islanders,2,Metropolitan,Eastern,79,2,164,0.4817073170731707,94,-15,93,-14
2013-14,2013-10-04,New York Rangers,0,Metropolitan,Eastern,0,2,2,0.0,2,-2,2,-2
2013-14,2013-10-08,New York Rangers,2,Metropolitan,Eastern,2,2,4,0.5,3,-1,3,-1
2013-14,2013-10-09,New York Rangers,0,Metropolitan,Eastern,2,2,6,0.3333333333333333,3,-1,3,-1
2013-14,2013-10-11,New York Rangers,0,Metropolitan,Eastern,2,2,8,0.25,5,-3,4,-2
2013-14,2013-10-13,New York Rangers,0,Metropolitan,Eastern,2,2,10,0.2,5,-3,5,-3
2013-14,2013-10-17,New York Rangers,2,Metropolitan,Eastern,4,2,12,0.3333333333333333,8,-4,8,-4
2013-14,2013-10-19,New York Rangers,0,Metropolitan,Eastern,4,2,14,0.2857142857142857,8,-4,8,-4
2013-14,2013-10-24,New York Rangers,0,Metropolitan,Eastern,4,2,16,0.25,9,-5,10,-6
2013-14,2013-10-26,New York Rangers,2,Metropolitan,Eastern,6,2,18,0.3333333333333333,11,-5,11,-5
2013-14,2013-10-28,New York Rangers,0,Metropolitan,Eastern,6,2,20,0.3,11,-5,11,-5
2013-14,2013-10-29,New York Rangers,2,Metropolitan,Eastern,8,2,22,0.36363636363636365,11,-3,11,-3
2013-14,2013-10-31,New York Rangers,2,Metropolitan,Eastern,10,2,24,0.4166666666666667,11,-1,11,-1
2013-14,2013-11-02,New York Rangers,2,Metropolitan,Eastern,12,2,26,0.46153846153846156,14,-2,14,-2
2013-14,2013-11-05,New York Rangers,0,Metropolitan,Eastern,12,2,28,0.42857142857142855,14,-2,14,-2
2013-14,2013-11-07,New York Rangers,2,Metropolitan,Eastern,14,2,30,0.4666666666666667,15,-1,15,-1
2013-14,2013-11-08,New York Rangers,2,Metropolitan,Eastern,16,2,32,0.5,16,0,16,0
2013-14,2013-11-11,New York Rangers,2,Metropolitan,Eastern,18,2,34,0.5294117647058824,18,0,18,0
2013-14,2013-11-13,New York Rangers,0,Metropolitan,Eastern,18,2,36,0.5,18,0,18,0
2013-14,2013-11-17,New York Rangers,2,Metropolitan,Eastern,20,2,38,0.5263157894736842,20,0,20,0
2013-14,2013-11-18,New York Rangers,0,Metropolitan,Eastern,20,2,40,0.5,20,0,20,0
2013-14,2013-11-20,New York Rangers,0,Metropolitan,Eastern,20,2,42,0.47619047619047616,20,0,20,0
2013-14,2013-11-22,New York Rangers,2,Metropolitan,Eastern,22,2,44,0.5,23,-1,23,-1
2013-14,2013-11-24,New York Rangers,2,Metropolitan,Eastern,24,2,46,0.5217391304347826,24,0,24,0
2013-14,2013-11-26,New York Rangers,0,Metropolitan,Eastern,24,2,48,0.5,24,0,24,0
2013-14,2013-11-28,New York Rangers,2,Metropolitan,Eastern,26,2,50,0.52,26,0,26,0
2013-14,2013-11-29,New York Rangers,0,Metropolitan,Eastern,26,2,52,0.5,26,0,26,0
2013-14,2013-11-30,New York Rangers,2,Metropolitan,Eastern,28,2,54,0.5185185185185185,28,0,28,0
2013-14,2013-12-03,New York Rangers,0,Metropolitan,Eastern,28,2,56,0.5,28,0,28,0
2013-14,2013-12-06,New York Rangers,2,Metropolitan,Eastern,30,2,58,0.5172413793103449,30,0,30,0
2013-14,2013-12-08,New York Rangers,1,Metropolitan,Eastern,31,2,60,0.5166666666666667,31,0,31,0
2013-14,2013-12-09,New York Rangers,0,Metropolitan,Eastern,31,2,62,0.5,31,0,31,0
2013-14,2013-12-11,New York Rangers,0,Metropolitan,Eastern,31,2,64,0.484375,32,-1,32,-1
2013-14,2013-12-13,New York Rangers,0,Metropolitan,Eastern,31,2,66,0.4696969696969697,33,-2,33,-2
2013-14,2013-12-16,New York Rangers,2,Metropolitan,Eastern,33,2,68,0.4852941176470588,35,-2,35,-2
2013-14,2013-12-19,New York Rangers,1,Metropolitan,Eastern,34,2,70,0.4857142857142857,35,-1,35,-1
2013-14,2013-12-21,New York Rangers,0,Metropolitan,Eastern,34,2,72,0.4722222222222222,36,-2,36,-2
2013-14,2013-12-23,New York Rangers,2,Metropolitan,Eastern,36,2,74,0.4864864864864865,37,-1,37,-1
2013-14,2013-12-24,New York Rangers,2,Metropolitan,Eastern,38,2,76,0.5,38,0,38,0
2013-14,2013-12-28,New York Rangers,0,Metropolitan,Eastern,38,2,78,0.48717948717948717,38,0,38,0
2013-14,2013-12-30,New York Rangers,2,Metropolitan,Eastern,40,2,80,0.5,40,0,40,0
2013-14,2013-12-31,New York Rangers,2,Metropolitan,Eastern,42,2,82,0.5121951219512195,42,0,42,0
2013-14,2014-01-04,New York Rangers,0,Metropolitan,Eastern,42,2,84,0.5,44,-2,44,-2
2013-14,2014-01-05,New York Rangers,2,Metropolitan,Eastern,44,2,86,0.5116279069767442,46,-2,46,-2
2013-14,2014-01-07,New York Rangers,1,Metropolitan,Eastern,45,2,88,0.5113636363636364,46,-1,46,-1
2013-14,2014-01-09,New York Rangers,2,Metropolitan,Eastern,47,2,90,0.5222222222222223,47,0,47,0
2013-14,2014-01-11,New York Rangers,2,Metropolitan,Eastern,49,2,92,0.532608695652174,50,-1,48,1
2013-14,2014-01-13,New York Rangers,2,Metropolitan,Eastern,51,2,94,0.5425531914893617,51,0,50,1
2013-14,2014-01-15,New York Rangers,0,Metropolitan,Eastern,51,2,96,0.53125,52,-1,51,0
2013-14,2014-01-17,New York Rangers,2,Metropolitan,Eastern,53,2,98,0.5408163265306123,53,0,52,1
2013-14,2014-01-18,New York Rangers,2,Metropolitan,Eastern,55,2,100,0.55,53,2,52,3
2013-14,2014-01-20,New York Rangers,2,Metropolitan,Eastern,57,2,102,0.5588235294117647,56,1,52,5
2013-14,2014-01-22,New York Rangers,0,Metropolitan,Eastern,57,2,104,0.5480769230769231,56,1,54,3
2013-14,2014-01-24,New York Rangers,0,Metropolitan,Eastern,57,2,106,0.5377358490566038,56,1,56,1
2013-14,2014-01-26,New York Rangers,2,Metropolitan,Eastern,59,2,108,0.5462962962962963,56,3,56,3
2013-14,2014-01-30,New York Rangers,2,Metropolitan,Eastern,61,2,110,0.5545454545454546,58,3,57,4
2013-14,2014-02-01,New York Rangers,2,Metropolitan,Eastern,63,2,112,0.5625,60,3,59,4
2013-14,2014-02-05,New York Rangers,2,Metropolitan,Eastern,65,2,114,0.5701754385964912,62,3,62,3
2013-14,2014-02-07,New York Rangers,0,Metropolitan,Eastern,65,2,116,0.5603448275862069,64,1,64,1
2013-14,2014-02-08,New York Rangers,2,Metropolitan,Eastern,67,2,118,0.5677966101694916,66,1,64,3
2013-14,2014-02-28,New York Rangers,2,Metropolitan,Eastern,69,2,120,0.575,66,3,66,3
2013-14,2014-03-01,New York Rangers,0,Metropolitan,Eastern,69,2,122,0.5655737704918032,68,1,68,1
2013-14,2014-03-03,New York Rangers,0,Metropolitan,Eastern,69,2,124,0.5564516129032258,69,0,68,1
2013-14,2014-03-06,New York Rangers,1,Metropolitan,Eastern,70,2,126,0.5555555555555556,70,0,69,1
2013-14,2014-03-08,New York Rangers,2,Metropolitan,Eastern,72,2,128,0.5625,72,0,71,1
2013-14,2014-03-09,New York Rangers,2,Metropolitan,Eastern,74,2,130,0.5692307692307692,73,1,71,3
2013-14,2014-03-11,New York Rangers,0,Metropolitan,Eastern,74,2,132,0.5606060606060606,73,1,73,1
2013-14,2014-03-14,New York Rangers,0,Metropolitan,Eastern,74,2,134,0.5522388059701493,74,0,73,1
2013-14,2014-03-15,New York Rangers,2,Metropolitan,Eastern,76,2,136,0.5588235294117647,75,1,74,2
2013-14,2014-03-16,New York Rangers,0,Metropolitan,Eastern,76,2,138,0.5507246376811594,76,0,76,0
2013-14,2014-03-18,New York Rangers,2,Metropolitan,Eastern,78,2,140,0.5571428571428572,78,0,76,2
2013-14,2014-03-21,New York Rangers,2,Metropolitan,Eastern,80,2,142,0.5633802816901409,80,0,78,2
2013-14,2014-03-22,New York Rangers,2,Metropolitan,Eastern,82,2,144,0.5694444444444444,82,0,79,3
2013-14,2014-03-24,New York Rangers,2,Metropolitan,Eastern,84,2,146,0.5753424657534246,83,1,80,4
2013-14,2014-03-27,New York Rangers,2,Metropolitan,Eastern,86,2,148,0.581081081081081,83,3,80,6
2013-14,2014-03-29,New York Rangers,0,Metropolitan,Eastern,86,2,150,0.5733333333333334,85,1,82,4
2013-14,2014-03-31,New York Rangers,2,Metropolitan,Eastern,88,2,152,0.5789473684210527,86,2,82,6
2013-14,2014-04-02,New York Rangers,2,Metropolitan,Eastern,90,2,154,0.5844155844155844,87,3,83,7
2013-14,2014-04-04,New York Rangers,1,Metropolitan,Eastern,91,2,156,0.5833333333333334,87,4,85,6
2013-14,2014-04-05,New York Rangers,0,Metropolitan,Eastern,91,2,158,0.5759493670886076,87,4,85,6
2013-14,2014-04-08,New York Rangers,2,Metropolitan,Eastern,93,2,160,0.58125,91,2,89,4
2013-14,2014-04-10,New York Rangers,2,Metropolitan,Eastern,95,2,162,0.5864197530864198,91,4,91,4
2013-14,2014-04-12,New York Rangers,1,Metropolitan,Eastern,96,2,164,0.5853658536585366,93,3,91,5
2013-14,2013-10-04,Ottawa Senators,2,Atlantic,Eastern,2,2,2,1.0,2,0,2,0
2013-14,2013-10-05,Ottawa Senators,1,Atlantic,Eastern,3,2,4,0.75,4,-1,2,1
2013-14,2013-10-10,Ottawa Senators,1,Atlantic,Eastern,4,2,6,0.6666666666666666,4,0,4,0
2013-14,2013-10-13,Ottawa Senators,0,Atlantic,Eastern,4,2,8,0.5,6,-2,5,-1
2013-14,2013-10-14,Ottawa Senators,0,Atlantic,Eastern,4,2,10,0.4,6,-2,5,-1
2013-14,2013-10-16,Ottawa Senators,2,Atlantic,Eastern,6,2,12,0.5,8,-2,6,0
2013-14,2013-10-17,Ottawa Senators,2,Atlantic,Eastern,8,2,14,0.5714285714285714,10,-2,8,0
2013-14,2013-10-19,Ottawa Senators,0,Atlantic,Eastern,8,2,16,0.5,10,-2,8,0
2013-14,2013-10-23,Ottawa Senators,2,Atlantic,Eastern,10,2,18,0.5555555555555556,10,0,10,0
2013-14,2013-10-25,Ottawa Senators,0,Atlantic,Eastern,10,2,20,0.5,12,-2,11,-1
2013-14,2013-10-27,Ottawa Senators,0,Atlantic,Eastern,10,2,22,0.45454545454545453,14,-4,11,-1
2013-14,2013-10-30,Ottawa Senators,0,Atlantic,Eastern,10,2,24,0.4166666666666667,16,-6,11,-1
2013-14,2013-11-01,Ottawa Senators,1,Atlantic,Eastern,11,2,26,0.4230769230769231,16,-5,12,-1
2013-14,2013-11-03,Ottawa Senators,1,Atlantic,Eastern,12,2,28,0.42857142857142855,20,-8,14,-2
2013-14,2013-11-06,Ottawa Senators,2,Atlantic,Eastern,14,2,30,0.4666666666666667,20,-6,15,-1
2013-14,2013-11-08,Ottawa Senators,2,Atlantic,Eastern,16,2,32,0.5,20,-4,16,0
2013-14,2013-11-09,Ottawa Senators,2,Atlantic,Eastern,18,2,34,0.5294117647058824,21,-3,17,1
2013-14,2013-11-13,Ottawa Senators,0,Atlantic,Eastern,18,2,36,0.5,23,-5,18,0
2013-14,2013-11-16,Ottawa Senators,2,Atlantic,Eastern,20,2,38,0.5263157894736842,24,-4,20,0
2013-14,2013-11-17,Ottawa Senators,0,Atlantic,Eastern,20,2,40,0.5,25,-5,20,0
2013-14,2013-11-20,Ottawa Senators,0,Atlantic,Eastern,20,2,42,0.47619047619047616,27,-7,20,0
2013-14,2013-11-21,Ottawa Senators,0,Atlantic,Eastern,20,2,44,0.45454545454545453,27,-7,21,-1
2013-14,2013-11-24,Ottawa Senators,0,Atlantic,Eastern,20,2,46,0.43478260869565216,29,-9,24,-4
2013-14,2013-11-24,Ottawa Senators,2,Atlantic,Eastern,22,2,48,0.4583333333333333,29,-7,24,-2
2013-14,2013-11-28,Ottawa Senators,2,Atlantic,Eastern,24,2,50,0.48,31,-7,26,-2
2013-14,2013-11-29,Ottawa Senators,0,Atlantic,Eastern,24,2,52,0.46153846153846156,33,-9,26,-2
2013-14,2013-12-01,Ottawa Senators,0,Atlantic,Eastern,24,2,54,0.4444444444444444,33,-9,28,-4
2013-14,2013-12-04,Ottawa Senators,2,Atlantic,Eastern,26,2,56,0.4642857142857143,35,-9,28,-2
2013-14,2013-12-06,Ottawa Senators,0,Atlantic,Eastern,26,2,58,0.4482758620689655,35,-9,30,-4
2013-14,2013-12-08,Ottawa Senators,1,Atlantic,Eastern,27,2,60,0.45,37,-10,31,-4
2013-14,2013-12-10,Ottawa Senators,2,Atlantic,Eastern,29,2,62,0.46774193548387094,37,-8,31,-2
2013-14,2013-12-11,Ottawa Senators,1,Atlantic,Eastern,30,2,64,0.46875,38,-8,32,-2
2013-14,2013-12-13,Ottawa Senators,2,Atlantic,Eastern,32,2,66,0.48484848484848486,39,-7,33,-1
2013-14,2013-12-14,Ottawa Senators,0,Atlantic,Eastern,32,2,68,0.47058823529411764,39,-7,33,-1
2013-14,2013-12-17,Ottawa Senators,2,Atlantic,Eastern,34,2,70,0.4857142857142857,41,-7,35,-1
2013-14,2013-12-19,Ottawa Senators,0,Atlantic,Eastern,34,2,72,0.4722222222222222,43,-9,35,-1
2013-14,2013-12-20,Ottawa Senators,0,Atlantic,Eastern,34,2,74,0.4594594594594595,45,-11,36,-2
2013-14,2013-12-21,Ottawa Senators,1,Atlantic,Eastern,35,2,76,0.4605263157894737,45,-10,36,-1
2013-14,2013-12-24,Ottawa Senators,2,Atlantic,Eastern,37,2,78,0.47435897435897434,47,-10,38,-1
2013-14,2013-12-28,Ottawa Senators,0,Atlantic,Eastern,37,2,80,0.4625,47,-10,38,-1
2013-14,2013-12-29,Ottawa Senators,2,Atlantic,Eastern,39,2,82,0.47560975609756095,49,-10,40,-1
2013-14,2013-12-31,Ottawa Senators,2,Atlantic,Eastern,41,2,84,0.4880952380952381,49,-8,42,-1
2013-14,2014-01-03,Ottawa Senators,2,Atlantic,Eastern,43,2,86,0.5,52,-9,44,-1
2013-14,2014-01-05,Ottawa Senators,2,Atlantic,Eastern,45,2,88,0.5113636363636364,53,-8,46,-1
2013-14,2014-01-09,Ottawa Senators,1,Atlantic,Eastern,46,2,90,0.5111111111111111,55,-9,47,-1
2013-14,2014-01-12,Ottawa Senators,2,Atlantic,Eastern,48,2,92,0.5217391304347826,57,-9,49,-1
2013-14,2014-01-15,Ottawa Senators,2,Atlantic,Eastern,50,2,94,0.5319148936170213,57,-7,51,-1
2013-14,2014-01-17,Ottawa Senators,1,Atlantic,Eastern,51,2,96,0.53125,59,-8,52,-1
2013-14,2014-01-18,Ottawa Senators,0,Atlantic,Eastern,51,2,98,0.5204081632653061,59,-8,52,-1
2013-14,2014-01-22,Ottawa Senators,2,Atlantic,Eastern,53,2,100,0.53,59,-6,54,-1
2013-14,2014-01-24,Ottawa Senators,1,Atlantic,Eastern,54,2,102,0.5294117647058824,59,-5,56,-2
2013-14,2014-01-25,Ottawa Senators,0,Atlantic,Eastern,54,2,104,0.5192307692307693,59,-5,56,-2
2013-14,2014-01-29,Ottawa Senators,2,Atlantic,Eastern,56,2,106,0.5283018867924528,62,-6,57,-1
2013-14,2014-01-31,Ottawa Senators,2,Atlantic,Eastern,58,2,108,0.5370370370370371,64,-6,58,0
2013-14,2014-02-02,Ottawa Senators,0,Atlantic,Eastern,58,2,110,0.5272727272727272,66,-8,60,-2
2013-14,2014-02-04,Ottawa Senators,1,Atlantic,Eastern,59,2,112,0.5267857142857143,66,-7,62,-3
2013-14,2014-02-05,Ottawa Senators,2,Atlantic,Eastern,61,2,114,0.5350877192982456,66,-5,62,-1
2013-14,2014-02-07,Ottawa Senators,2,Atlantic,Eastern,63,2,116,0.5431034482758621,68,-5,64,-1
2013-14,2014-02-08,Ottawa Senators,0,Atlantic,Eastern,63,2,118,0.5338983050847458,70,-7,64,-1
2013-14,2014-02-28,Ottawa Senators,0,Atlantic,Eastern,63,2,120,0.525,71,-8,66,-3
2013-14,2014-03-02,Ottawa Senators,2,Atlantic,Eastern,65,2,122,0.5327868852459017,73,-8,68,-3
2013-14,2014-03-05,Ottawa Senators,0,Atlantic,Eastern,65,2,124,0.5241935483870968,73,-8,69,-4
2013-14,2014-03-06,Ottawa Senators,0,Atlantic,Eastern,65,2,126,0.5158730158730159,74,-9,69,-4
2013-14,2014-03-08,Ottawa Senators,2,Atlantic,Eastern,67,2,128,0.5234375,74,-7,71,-4
2013-14,2014-03-10,Ottawa Senators,1,Atlantic,Eastern,68,2,130,0.5230769230769231,76,-8,71,-3
2013-14,2014-03-15,Ottawa Senators,1,Atlantic,Eastern,69,2,132,0.5227272727272727,79,-10,74,-5
2013-14,2014-03-16,Ottawa Senators,0,Atlantic,Eastern,69,2,134,0.5149253731343284,80,-11,76,-7
2013-14,2014-03-18,Ottawa Senators,0,Atlantic,Eastern,69,2,136,0.5073529411764706,81,-12,76,-7
2013-14,2014-03-20,Ottawa Senators,0,Atlantic,Eastern,69,2,138,0.5,83,-14,78,-9
2013-14,2014-03-22,Ottawa Senators,0,Atlantic,Eastern,69,2,140,0.4928571428571429,85,-16,79,-10
2013-14,2014-03-24,Ottawa Senators,2,Atlantic,Eastern,71,2,142,0.5,87,-16,80,-9
2013-14,2014-03-25,Ottawa Senators,1,Atlantic,Eastern,72,2,144,0.5,87,-15,80,-8
2013-14,2014-03-28,Ottawa Senators,2,Atlantic,Eastern,74,2,146,0.5068493150684932,89,-15,80,-6
2013-14,2014-03-30,Ottawa Senators,2,Atlantic,Eastern,76,2,148,0.5135135135135135,91,-15,82,-6
2013-14,2014-03-31,Ottawa Senators,2,Atlantic,Eastern,78,2,150,0.52,91,-13,82,-4
2013-14,2014-04-02,Ottawa Senators,0,Atlantic,Eastern,78,2,152,0.5131578947368421,93,-15,83,-5
2013-14,2014-04-04,Ottawa Senators,0,Atlantic,Eastern,78,2,154,0.5064935064935064,93,-15,85,-7
2013-14,2014-04-05,Ottawa Senators,2,Atlantic,Eastern,80,2,156,0.5128205128205128,93,-13,85,-5
2013-14,2014-04-08,Ottawa Senators,2,Atlantic,Eastern,82,2,158,0.5189873417721519,95,-13,89,-7
2013-14,2014-04-10,Ottawa Senators,2,Atlantic,Eastern,84,2,160,0.525,97,-13,91,-7
2013-14,2014-04-12,Ottawa Senators,2,Atlantic,Eastern,86,2,162,0.5308641975308642,99,-13,91,-5
2013-14,2014-04-13,Ottawa Senators,2,Atlantic,Eastern,88,2,164,0.5365853658536586,100,-12,93,-5
2013-14,2013-10-02,Philadelphia Flyers,0,Metropolitan,Eastern,0,2,2,0.0,0,0,0,0
2013-14,2013-10-05,Philadelphia Flyers,0,Metropolitan,Eastern,0,2,4,0.0,2,-2,2,-2
2013-14,2013-10-06,Philadelphia Flyers,0,Metropolitan,Eastern,0,2,6,0.0,3,-3,2,-2
2013-14,2013-10-08,Philadelphia Flyers,2,Metropolitan,Eastern,2,2,8,0.25,3,-1,3,-1
2013-14,2013-10-11,Philadelphia Flyers,0,Metropolitan,Eastern,2,2,10,0.2,5,-3,4,-2
2013-14,2013-10-12,Philadelphia Flyers,0,Metropolitan,Eastern,2,2,12,0.16666666666666666,5,-3,4,-2
2013-14,2013-10-15,Philadelphia Flyers,0,Metropolitan,Eastern,2,2,14,0.14285714285714285,6,-4,6,-4
2013-14,2013-10-17,Philadelphia Flyers,0,Metropolitan,Eastern,2,2,16,0.125,8,-6,8,-6
2013-14,2013-10-24,Philadelphia Flyers,2,Metropolitan,Eastern,4,2,18,0.2222222222222222,9,-5,10,-6
2013-14,2013-10-26,Philadelphia Flyers,2,Metropolitan,Eastern,6,2,20,0.3,11,-5,11,-5
2013-14,2013-10-29,Philadelphia Flyers,0,Metropolitan,Eastern,6,2,22,0.2727272727272727,11,-5,11,-5
2013-14,2013-11-01,Philadelphia Flyers,0,Metropolitan,Eastern,6,2,24,0.25,12,-6,12,-6
2013-14,2013-11-02,Philadelphia Flyers,2,Metropolitan,Eastern,8,2,26,0.3076923076923077,14,-6,14,-6
2013-14,2013-11-06,Philadelphia Flyers,1,Metropolitan,Eastern,9,2,28,0.32142857142857145,15,-6,15,-6
2013-14,2013-11-08,Philadelphia Flyers,0,Metropolitan,Eastern,9,2,30,0.3,16,-7,16,-7
2013-14,2013-11-09,Philadelphia Flyers,2,Metropolitan,Eastern,11,2,32,0.34375,16,-5,17,-6
2013-14,2013-11-13,Philadelphia Flyers,2,Metropolitan,Eastern,13,2,34,0.38235294117647056,18,-5,18,-5
2013-14,2013-11-14,Philadelphia Flyers,2,Metropolitan,Eastern,15,2,36,0.4166666666666667,18,-3,18,-3
2013-14,2013-11-16,Philadelphia Flyers,1,Metropolitan,Eastern,16,2,38,0.42105263157894735,20,-4,20,-4
2013-14,2013-11-20,Philadelphia Flyers,2,Metropolitan,Eastern,18,2,40,0.45,20,-2,20,-2
2013-14,2013-11-22,Philadelphia Flyers,2,Metropolitan,Eastern,20,2,42,0.47619047619047616,23,-3,23,-3
2013-14,2013-11-24,Philadelphia Flyers,2,Metropolitan,Eastern,22,2,44,0.5,24,-2,24,-2
2013-14,2013-11-26,Philadelphia Flyers,0,Metropolitan,Eastern,22,2,46,0.4782608695652174,24,-2,24,-2
2013-14,2013-11-28,Philadelphia Flyers,0,Metropolitan,Eastern,22,2,48,0.4583333333333333,26,-4,26,-4
2013-14,2013-11-29,Philadelphia Flyers,2,Metropolitan,Eastern,24,2,50,0.48,26,-2,26,-2
2013-14,2013-12-01,Philadelphia Flyers,2,Metropolitan,Eastern,26,2,52,0.5,28,-2,28,-2
2013-14,2013-12-03,Philadelphia Flyers,0,Metropolitan,Eastern,26,2,54,0.48148148148148145,28,-2,28,-2
2013-14,2013-12-05,Philadelphia Flyers,2,Metropolitan,Eastern,28,2,56,0.5,28,0,28,0
2013-14,2013-12-07,Philadelphia Flyers,0,Metropolitan,Eastern,28,2,58,0.4827586206896552,30,-2,30,-2
2013-14,2013-12-10,Philadelphia Flyers,1,Metropolitan,Eastern,29,2,60,0.48333333333333334,31,-2,31,-2
2013-14,2013-12-12,Philadelphia Flyers,0,Metropolitan,Eastern,29,2,62,0.46774193548387094,32,-3,32,-3
2013-14,2013-12-13,Philadelphia Flyers,2,Metropolitan,Eastern,31,2,64,0.484375,33,-2,33,-2
2013-14,2013-12-15,Philadelphia Flyers,1,Metropolitan,Eastern,32,2,66,0.48484848484848486,35,-3,35,-3
2013-14,2013-12-18,Philadelphia Flyers,2,Metropolitan,Eastern,34,2,68,0.5,35,-1,35,-1
2013-14,2013-12-20,Philadelphia Flyers,2,Metropolitan,Eastern,36,2,70,0.5142857142857142,36,0,36,0
2013-14,2013-12-22,Philadelphia Flyers,0,Metropolitan,Eastern,36,2,72,0.5,37,-1,37,-1
2013-14,2013-12-24,Philadelphia Flyers,2,Metropolitan,Eastern,38,2,74,0.5135135135135135,38,0,38,0
2013-14,2013-12-29,Philadelphia Flyers,2,Metropolitan,Eastern,40,2,76,0.5263157894736842,40,0,40,0
2013-14,2013-12-31,Philadelphia Flyers,2,Metropolitan,Eastern,42,2,78,0.5384615384615384,42,0,42,0
2013-14,2014-01-01,Philadelphia Flyers,2,Metropolitan,Eastern,44,2,80,0.55,44,0,44,0
2013-14,2014-01-03,Philadelphia Flyers,0,Metropolitan,Eastern,44,2,82,0.5365853658536586,44,0,44,0
2013-14,2014-01-05,Philadelphia Flyers,2,Metropolitan,Eastern,46,2,84,0.5476190476190477,46,0,46,0
2013-14,2014-01-08,Philadelphia Flyers,2,Metropolitan,Eastern,48,2,86,0.5581395348837209,46,2,46,2
2013-14,2014-01-09,Philadelphia Flyers,2,Metropolitan,Eastern,50,2,88,0.5681818181818182,47,3,47,3
2013-14,2014-01-11,Philadelphia Flyers,0,Metropolitan,Eastern,50,2,90,0.5555555555555556,50,0,48,2
2013-14,2014-01-13,Philadelphia Flyers,0,Metropolitan,Eastern,50,2,92,0.5434782608695652,51,-1,50,0
2013-14,2014-01-15,Philadelphia Flyers,2,Metropolitan,Eastern,52,2,94,0.5531914893617021,52,0,51,1
2013-14,2014-01-17,Philadelphia Flyers,1,Metropolitan,Eastern,53,2,96,0.5520833333333334,53,0,52,1
2013-14,2014-01-19,Philadelphia Flyers,2,Metropolitan,Eastern,55,2,98,0.5612244897959183,55,0,52,3
2013-14,2014-01-20,Philadelphia Flyers,1,Metropolitan,Eastern,56,2,100,0.56,56,0,52,4
2013-14,2014-01-22,Philadelphia Flyers,0,Metropolitan,Eastern,56,2,102,0.5490196078431373,56,0,54,2
2013-14,2014-01-24,Philadelphia Flyers,0,Metropolitan,Eastern,56,2,104,0.5384615384615384,56,0,56,0
2013-14,2014-01-25,Philadelphia Flyers,0,Metropolitan,Eastern,56,2,106,0.5283018867924528,56,0,56,0
2013-14,2014-01-29,Philadelphia Flyers,2,Metropolitan,Eastern,58,2,108,0.5370370370370371,58,0,57,1
2013-14,2014-01-31,Philadelphia Flyers,0,Metropolitan,Eastern,58,2,110,0.5272727272727272,58,0,58,0
2013-14,2014-02-01,Philadelphia Flyers,2,Metropolitan,Eastern,60,2,112,0.5357142857142857,60,0,59,1
2013-14,2014-02-04,Philadelphia Flyers,2,Metropolitan,Eastern,62,2,114,0.543859649122807,62,0,62,0
2013-14,2014-02-07,Philadelphia Flyers,2,Metropolitan,Eastern,64,2,116,0.5517241379310345,64,0,64,0
2013-14,2014-02-08,Philadelphia Flyers,2,Metropolitan,Eastern,66,2,118,0.559322033898305,66,0,64,2
2013-14,2014-02-28,Philadelphia Flyers,0,Metropolitan,Eastern,66,2,120,0.55,66,0,66,0
2013-14,2014-03-01,Philadelphia Flyers,2,Metropolitan,Eastern,68,2,122,0.5573770491803278,68,0,68,0
2013-14,2014-03-02,Philadelphia Flyers,2,Metropolitan,Eastern,70,2,124,0.5645161290322581,69,1,68,2
2013-14,2014-03-06,Philadelphia Flyers,2,Metropolitan,Eastern,72,2,126,0.5714285714285714,70,2,69,3
2013-14,2014-03-09,Philadelphia Flyers,1,Metropolitan,Eastern,73,2,128,0.5703125,73,0,71,2
2013-14,2014-03-11,Philadelphia Flyers,0,Metropolitan,Eastern,73,2,130,0.5615384615384615,73,0,73,0
2013-14,2014-03-15,Philadelphia Flyers,2,Metropolitan,Eastern,75,2,132,0.5681818181818182,75,0,74,1
2013-14,2014-03-16,Philadelphia Flyers,2,Metropolitan,Eastern,77,2,134,0.5746268656716418,76,1,76,1
2013-14,2014-03-18,Philadelphia Flyers,2,Metropolitan,Eastern,79,2,136,0.5808823529411765,78,1,76,3
2013-14,2014-03-20,Philadelphia Flyers,2,Metropolitan,Eastern,81,2,138,0.5869565217391305,78,3,78,3
2013-14,2014-03-22,Philadelphia Flyers,2,Metropolitan,Eastern,83,2,140,0.5928571428571429,82,1,79,4
2013-14,2014-03-24,Philadelphia Flyers,0,Metropolitan,Eastern,83,2,142,0.5845070422535211,83,0,80,3
2013-14,2014-03-27,Philadelphia Flyers,0,Metropolitan,Eastern,83,2,144,0.5763888888888888,83,0,80,3
2013-14,2014-03-28,Philadelphia Flyers,2,Metropolitan,Eastern,85,2,146,0.5821917808219178,85,0,80,5
2013-14,2014-03-30,Philadelphia Flyers,1,Metropolitan,Eastern,86,2,148,0.581081081081081,86,0,82,4
2013-14,2014-04-02,Philadelphia Flyers,1,Metropolitan,Eastern,87,2,150,0.58,87,0,83,4
2013-14,2014-04-03,Philadelphia Flyers,0,Metropolitan,Eastern,87,2,152,0.5723684210526315,87,0,85,2
2013-14,2014-04-05,Philadelphia Flyers,0,Metropolitan,Eastern,87,2,154,0.564935064935065,87,0,85,2
2013-14,2014-04-06,Philadelphia Flyers,2,Metropolitan,Eastern,89,2,156,0.5705128205128205,89,0,87,2
2013-14,2014-04-08,Philadelphia Flyers,2,Metropolitan,Eastern,91,2,158,0.5759493670886076,91,0,89,2
2013-14,2014-04-10,Philadelphia Flyers,0,Metropolitan,Eastern,91,2,160,0.56875,91,0,91,0
2013-14,2014-04-12,Philadelphia Flyers,2,Metropolitan,Eastern,93,2,162,0.5740740740740741,93,0,91,2
2013-14,2014-04-13,Philadelphia Flyers,1,Metropolitan,Eastern,94,2,164,0.573170731707317,94,0,93,1
2013-14,2013-10-04,Phoenix Coyotes,2,Pacific,Western,2,2,2,1.0,2,0,2,0
2013-14,2013-10-06,Phoenix Coyotes,0,Pacific,Western,2,2,4,0.5,2,0,2,0
2013-14,2013-10-08,Phoenix Coyotes,0,Pacific,Western,2,2,6,0.3333333333333333,4,-2,3,-1
2013-14,2013-10-10,Phoenix Coyotes,2,Pacific,Western,4,2,8,0.5,6,-2,4,0
2013-14,2013-10-11,Phoenix Coyotes,2,Pacific,Western,6,2,10,0.6,6,0,6,0
2013-14,2013-10-13,Phoenix Coyotes,2,Pacific,Western,8,2,12,0.6666666666666666,8,0,6,2
2013-14,2013-10-16,Phoenix Coyotes,1,Pacific,Western,9,2,14,0.6428571428571429,8,1,8,1
2013-14,2013-10-19,Phoenix Coyotes,1,Pacific,Western,10,2,16,0.625,11,-1,10,0
2013-14,2013-10-20,Phoenix Coyotes,2,Pacific,Western,12,2,18,0.6666666666666666,12,0,11,1
2013-14,2013-10-23,Phoenix Coyotes,2,Pacific,Western,14,2,20,0.7,14,0,11,3
2013-14,2013-10-25,Phoenix Coyotes,0,Pacific,Western,14,2,22,0.6363636363636364,15,-1,13,1
2013-14,2013-10-26,Phoenix Coyotes,2,Pacific,Western,16,2,24,0.6666666666666666,16,0,13,3
2013-14,2013-10-30,Phoenix Coyotes,2,Pacific,Western,18,2,26,0.6923076923076923,19,-1,16,2
2013-14,2013-11-01,Phoenix Coyotes,2,Pacific,Western,20,2,28,0.7142857142857143,20,0,18,2
2013-14,2013-11-03,Phoenix Coyotes,2,Pacific,Western,22,2,30,0.7333333333333333,22,0,18,4
2013-14,2013-11-06,Phoenix Coyotes,2,Pacific,Western,24,2,32,0.75,24,0,20,4
2013-14,2013-11-07,Phoenix Coyotes,0,Pacific,Western,24,2,34,0.7058823529411765,24,0,20,4
2013-14,2013-11-10,Phoenix Coyotes,2,Pacific,Western,26,2,36,0.7222222222222222,24,2,24,2
2013-14,2013-11-13,Phoenix Coyotes,2,Pacific,Western,28,2,38,0.7368421052631579,27,1,24,4
2013-14,2013-11-15,Phoenix Coyotes,1,Pacific,Western,29,2,40,0.725,29,0,25,4
2013-14,2013-11-17,Phoenix Coyotes,2,Pacific,Western,31,2,42,0.7380952380952381,31,0,27,4
2013-14,2013-11-22,Phoenix Coyotes,1,Pacific,Western,32,2,44,0.7272727272727273,32,0,32,0
2013-14,2013-11-24,Phoenix Coyotes,0,Pacific,Western,32,2,46,0.6956521739130435,33,-1,32,0
2013-14,2013-11-26,Phoenix Coyotes,0,Pacific,Western,32,2,48,0.6666666666666666,35,-3,32,0
2013-14,2013-11-28,Phoenix Coyotes,2,Pacific,Western,34,2,50,0.68,36,-2,34,0
2013-14,2013-12-01,Phoenix Coyotes,0,Pacific,Western,34,2,52,0.6538461538461539,36,-2,34,0
2013-14,2013-12-04,Phoenix Coyotes,2,Pacific,Western,36,2,54,0.6666666666666666,40,-4,36,0
2013-14,2013-12-05,Phoenix Coyotes,0,Pacific,Western,36,2,56,0.6428571428571429,40,-4,36,0
2013-14,2013-12-07,Phoenix Coyotes,1,Pacific,Western,37,2,58,0.6379310344827587,40,-3,37,0
2013-14,2013-12-11,Phoenix Coyotes,2,Pacific,Western,39,2,60,0.65,44,-5,40,-1
2013-14,2013-12-13,Phoenix Coyotes,2,Pacific,Western,41,2,62,0.6612903225806451,46,-5,41,0
2013-14,2013-12-15,Phoenix Coyotes,0,Pacific,Western,41,2,64,0.640625,46,-5,43,-2
2013-14,2013-12-18,Phoenix Coyotes,0,Pacific,Western,41,2,66,0.6212121212121212,48,-7,45,-4
2013-14,2013-12-20,Phoenix Coyotes,1,Pacific,Western,42,2,68,0.6176470588235294,48,-6,45,-3
2013-14,2013-12-21,Phoenix Coyotes,2,Pacific,Western,44,2,70,0.6285714285714286,48,-4,45,-1
2013-14,2013-12-24,Phoenix Coyotes,1,Pacific,Western,45,2,72,0.625,52,-7,45,0
2013-14,2013-12-28,Phoenix Coyotes,1,Pacific,Western,46,2,74,0.6216216216216216,54,-8,46,0
2013-14,2013-12-29,Phoenix Coyotes,1,Pacific,Western,47,2,76,0.618421052631579,54,-7,47,0
2013-14,2014-01-01,Phoenix Coyotes,2,Pacific,Western,49,2,78,0.6282051282051282,54,-5,49,0
2013-14,2014-01-03,Phoenix Coyotes,0,Pacific,Western,49,2,80,0.6125,54,-5,49,0
2013-14,2014-01-05,Phoenix Coyotes,0,Pacific,Western,49,2,82,0.5975609756097561,56,-7,49,0
2013-14,2014-01-08,Phoenix Coyotes,2,Pacific,Western,51,2,84,0.6071428571428571,57,-6,51,0
2013-14,2014-01-10,Phoenix Coyotes,0,Pacific,Western,51,2,86,0.5930232558139535,59,-8,53,-2
2013-14,2014-01-12,Phoenix Coyotes,0,Pacific,Western,51,2,88,0.5795454545454546,59,-8,53,-2
2013-14,2014-01-14,Phoenix Coyotes,0,Pacific,Western,51,2,90,0.5666666666666667,61,-10,55,-4
2013-14,2014-01-15,Phoenix Coyotes,0,Pacific,Western,51,2,92,0.5543478260869565,61,-10,55,-4
2013-14,2014-01-17,Phoenix Coyotes,2,Pacific,Western,53,2,94,0.5638297872340425,63,-10,57,-4
2013-14,2014-01-19,Phoenix Coyotes,2,Pacific,Western,55,2,96,0.5729166666666666,64,-9,59,-4
2013-14,2014-01-21,Phoenix Coyotes,0,Pacific,Western,55,2,98,0.5612244897959183,64,-9,59,-4
2013-14,2014-01-23,Phoenix Coyotes,0,Pacific,Western,55,2,100,0.55,64,-9,59,-4
2013-14,2014-01-25,Phoenix Coyotes,2,Pacific,Western,57,2,102,0.5588235294117647,64,-7,61,-4
2013-14,2014-01-27,Phoenix Coyotes,1,Pacific,Western,58,2,104,0.5576923076923077,64,-6,62,-4
2013-14,2014-01-29,Phoenix Coyotes,2,Pacific,Western,60,2,106,0.5660377358490566,66,-6,63,-3
2013-14,2014-01-31,Phoenix Coyotes,0,Pacific,Western,60,2,108,0.5555555555555556,66,-6,63,-3
2013-14,2014-02-02,Phoenix Coyotes,2,Pacific,Western,62,2,110,0.5636363636363636,66,-4,63,-1
2013-14,2014-02-05,Phoenix Coyotes,0,Pacific,Western,62,2,112,0.5535714285714286,66,-4,63,-1
2013-14,2014-02-08,Phoenix Coyotes,2,Pacific,Western,64,2,114,0.5614035087719298,68,-4,64,0
2013-14,2014-02-09,Phoenix Coyotes,0,Pacific,Western,64,2,116,0.5517241379310345,68,-4,64,0
2013-14,2014-02-28,Phoenix Coyotes,1,Pacific,Western,65,2,118,0.5508474576271186,72,-7,66,-1
2013-14,2014-03-01,Phoenix Coyotes,0,Pacific,Western,65,2,120,0.5416666666666666,74,-9,66,-1
2013-14,2014-03-03,Phoenix Coyotes,0,Pacific,Western,65,2,122,0.5327868852459017,74,-9,66,-1
2013-14,2014-03-05,Phoenix Coyotes,2,Pacific,Western,67,2,124,0.5403225806451613,76,-9,68,-1
2013-14,2014-03-07,Phoenix Coyotes,2,Pacific,Western,69,2,126,0.5476190476190477,78,-9,70,-1
2013-14,2014-03-09,Phoenix Coyotes,0,Pacific,Western,69,2,128,0.5390625,78,-9,72,-3
2013-14,2014-03-10,Phoenix Coyotes,2,Pacific,Western,71,2,130,0.5461538461538461,80,-9,72,-1
2013-14,2014-03-11,Phoenix Coyotes,2,Pacific,Western,73,2,132,0.553030303030303,82,-9,73,0
2013-14,2014-03-13,Phoenix Coyotes,0,Pacific,Western,73,2,134,0.5447761194029851,82,-9,74,-1
2013-14,2014-03-16,Phoenix Coyotes,2,Pacific,Western,75,2,136,0.5514705882352942,82,-7,75,0
2013-14,2014-03-18,Phoenix Coyotes,2,Pacific,Western,77,2,138,0.5579710144927537,82,-5,77,0
2013-14,2014-03-21,Phoenix Coyotes,2,Pacific,Western,79,2,140,0.5642857142857143,84,-5,79,0
2013-14,2014-03-23,Phoenix Coyotes,0,Pacific,Western,79,2,142,0.5563380281690141,86,-7,79,0
2013-14,2014-03-24,Phoenix Coyotes,1,Pacific,Western,80,2,144,0.5555555555555556,88,-8,80,0
2013-14,2014-03-25,Phoenix Coyotes,2,Pacific,Western,82,2,146,0.5616438356164384,90,-8,82,0
2013-14,2014-03-27,Phoenix Coyotes,2,Pacific,Western,84,2,148,0.5675675675675675,92,-8,84,0
2013-14,2014-03-30,Phoenix Coyotes,0,Pacific,Western,84,2,150,0.56,94,-10,84,0
2013-14,2014-04-02,Phoenix Coyotes,1,Pacific,Western,85,2,152,0.5592105263157895,94,-9,85,0
2013-14,2014-04-03,Phoenix Coyotes,0,Pacific,Western,85,2,154,0.551948051948052,96,-11,85,0
2013-14,2014-04-05,Phoenix Coyotes,1,Pacific,Western,86,2,156,0.5512820512820513,96,-10,87,-1
2013-14,2014-04-08,Phoenix Coyotes,1,Pacific,Western,87,2,158,0.5506329113924051,96,-9,87,0
2013-14,2014-04-11,Phoenix Coyotes,0,Pacific,Western,87,2,160,0.54375,99,-12,89,-2
2013-14,2014-04-13,Phoenix Coyotes,0,Pacific,Western,87,2,162,0.5370370370370371,100,-13,91,-4
2013-14,2014-04-14,Phoenix Coyotes,2,Pacific,Western,89,2,164,0.5426829268292683,100,-11,91,-2
2013-14,2013-10-03,Pittsburgh Penguins,2,Metropolitan,Eastern,2,2,2,1.0,0,2,0,2
2013-14,2013-10-05,Pittsburgh Penguins,2,Metropolitan,Eastern,4,2,4,1.0,2,2,2,2
2013-14,2013-10-08,Pittsburgh Penguins,2,Metropolitan,Eastern,6,2,6,1.0,3,3,3,3
2013-14,2013-10-11,Pittsburgh Penguins,0,Metropolitan,Eastern,6,2,8,0.75,5,1,4,2
2013-14,2013-10-12,Pittsburgh Penguins,2,Metropolitan,Eastern,8,2,10,0.8,5,3,4,4
2013-14,2013-10-15,Pittsburgh Penguins,2,Metropolitan,Eastern,10,2,12,0.8333333333333334,6,4,6,4
2013-14,2013-10-17,Pittsburgh Penguins,2,Metropolitan,Eastern,12,2,14,0.8571428571428571,8,4,8,4
2013-14,2013-10-19,Pittsburgh Penguins,2,Metropolitan,Eastern,14,2,16,0.875,8,6,8,6
2013-14,2013-10-21,Pittsburgh Penguins,0,Metropolitan,Eastern,14,2,18,0.7777777777777778,8,6,8,6
2013-14,2013-10-25,Pittsburgh Penguins,0,Metropolitan,Eastern,14,2,20,0.7,11,3,11,3
2013-14,2013-10-26,Pittsburgh Penguins,0,Metropolitan,Eastern,14,2,22,0.6363636363636364,11,3,11,3
2013-14,2013-10-28,Pittsburgh Penguins,2,Metropolitan,Eastern,16,2,24,0.6666666666666666,11,5,11,5
2013-14,2013-10-31,Pittsburgh Penguins,2,Metropolitan,Eastern,18,2,26,0.6923076923076923,11,7,11,7
2013-14,2013-11-01,Pittsburgh Penguins,2,Metropolitan,Eastern,20,2,28,0.7142857142857143,12,8,12,8
2013-14,2013-11-02,Pittsburgh Penguins,2,Metropolitan,Eastern,22,2,30,0.7333333333333333,14,8,14,8
2013-14,2013-11-07,Pittsburgh Penguins,0,Metropolitan,Eastern,22,2,32,0.6875,15,7,15,7
2013-14,2013-11-10,Pittsburgh Penguins,0,Metropolitan,Eastern,22,2,34,0.6470588235294118,16,6,18,4
2013-14,2013-11-14,Pittsburgh Penguins,0,Metropolitan,Eastern,22,2,36,0.6111111111111112,18,4,18,4
2013-14,2013-11-16,Pittsburgh Penguins,2,Metropolitan,Eastern,24,2,38,0.631578947368421,20,4,20,4
2013-14,2013-11-17,Pittsburgh Penguins,0,Metropolitan,Eastern,24,2,40,0.6,20,4,20,4
2013-14,2013-11-19,Pittsburgh Penguins,2,Metropolitan,Eastern,26,2,42,0.6190476190476191,20,6,20,6
2013-14,2013-11-21,Pittsburgh Penguins,2,Metropolitan,Eastern,28,2,44,0.6363636363636364,21,7,21,7
2013-14,2013-11-23,Pittsburgh Penguins,2,Metropolitan,Eastern,30,2,46,0.6521739130434783,23,7,23,7
2013-14,2013-11-24,Pittsburgh Penguins,0,Metropolitan,Eastern,30,2,48,0.625,24,6,24,6
2013-14,2013-11-26,Pittsburgh Penguins,1,Metropolitan,Eastern,31,2,50,0.62,24,7,24,7
2013-14,2013-11-28,Pittsburgh Penguins,2,Metropolitan,Eastern,33,2,52,0.6346153846153846,26,7,26,7
2013-14,2013-11-29,Pittsburgh Penguins,2,Metropolitan,Eastern,35,2,54,0.6481481481481481,26,9,26,9
2013-14,2013-12-01,Pittsburgh Penguins,2,Metropolitan,Eastern,37,2,56,0.6607142857142857,28,9,28,9
2013-14,2013-12-04,Pittsburgh Penguins,2,Metropolitan,Eastern,39,2,58,0.6724137931034483,28,11,28,11
2013-14,2013-12-06,Pittsburgh Penguins,2,Metropolitan,Eastern,41,2,60,0.6833333333333333,30,11,30,11
2013-14,2013-12-08,Pittsburgh Penguins,0,Metropolitan,Eastern,41,2,62,0.6612903225806451,31,10,31,10
2013-14,2013-12-10,Pittsburgh Penguins,2,Metropolitan,Eastern,43,2,64,0.671875,31,12,31,12
2013-14,2013-12-14,Pittsburgh Penguins,2,Metropolitan,Eastern,45,2,66,0.6818181818181818,33,12,33,12
2013-14,2013-12-15,Pittsburgh Penguins,2,Metropolitan,Eastern,47,2,68,0.6911764705882353,35,12,35,12
2013-14,2013-12-17,Pittsburgh Penguins,2,Metropolitan,Eastern,49,2,70,0.7,35,14,35,14
2013-14,2013-12-19,Pittsburgh Penguins,2,Metropolitan,Eastern,51,2,72,0.7083333333333334,35,16,35,16
2013-14,2013-12-20,Pittsburgh Penguins,2,Metropolitan,Eastern,53,2,74,0.7162162162162162,36,17,36,17
2013-14,2013-12-21,Pittsburgh Penguins,2,Metropolitan,Eastern,55,2,76,0.7236842105263158,36,19,36,19
2013-14,2013-12-24,Pittsburgh Penguins,0,Metropolitan,Eastern,55,2,78,0.7051282051282052,38,17,38,17
2013-14,2013-12-28,Pittsburgh Penguins,2,Metropolitan,Eastern,57,2,80,0.7125,38,19,38,19
2013-14,2013-12-29,Pittsburgh Penguins,2,Metropolitan,Eastern,59,2,82,0.7195121951219512,40,19,40,19
2013-14,2013-12-31,Pittsburgh Penguins,0,Metropolitan,Eastern,59,2,84,0.7023809523809523,42,17,42,17
2013-14,2014-01-04,Pittsburgh Penguins,2,Metropolitan,Eastern,61,2,86,0.7093023255813954,44,17,44,17
2013-14,2014-01-05,Pittsburgh Penguins,2,Metropolitan,Eastern,63,2,88,0.7159090909090909,46,17,46,17
2013-14,2014-01-08,Pittsburgh Penguins,2,Metropolitan,Eastern,65,2,90,0.7222222222222222,46,19,46,19
2013-14,2014-01-11,Pittsburgh Penguins,1,Metropolitan,Eastern,66,2,92,0.717391304347826,50,16,48,18
2013-14,2014-01-12,Pittsburgh Penguins,2,Metropolitan,Eastern,68,2,94,0.723404255319149,50,18,49,19
2013-14,2014-01-16,Pittsburgh Penguins,2,Metropolitan,Eastern,70,2,96,0.7291666666666666,52,18,51,19
2013-14,2014-01-21,Pittsburgh Penguins,0,Metropolitan,Eastern,70,2,98,0.7142857142857143,56,14,52,18
2013-14,2014-01-23,Pittsburgh Penguins,2,Metropolitan,Eastern,72,2,100,0.72,56,16,54,18
2013-14,2014-01-24,Pittsburgh Penguins,2,Metropolitan,Eastern,74,2,102,0.7254901960784313,56,18,56,18
2013-14,2014-01-26,Pittsburgh Penguins,0,Metropolitan,Eastern,74,2,104,0.7115384615384616,56,18,56,18
2013-14,2014-01-28,Pittsburgh Penguins,2,Metropolitan,Eastern,76,2,106,0.7169811320754716,57,19,57,19
2013-14,2014-01-31,Pittsburgh Penguins,2,Metropolitan,Eastern,78,2,108,0.7222222222222222,58,20,58,20
2013-14,2014-02-02,Pittsburgh Penguins,0,Metropolitan,Eastern,78,2,110,0.7090909090909091,60,18,60,18
2013-14,2014-02-04,Pittsburgh Penguins,2,Metropolitan,Eastern,80,2,112,0.7142857142857143,62,18,62,18
2013-14,2014-02-06,Pittsburgh Penguins,2,Metropolitan,Eastern,82,2,114,0.7192982456140351,62,20,62,20
2013-14,2014-02-08,Pittsburgh Penguins,1,Metropolitan,Eastern,83,2,116,0.7155172413793104,66,17,64,19
2013-14,2014-02-28,Pittsburgh Penguins,1,Metropolitan,Eastern,84,2,118,0.711864406779661,66,18,66,18
2013-14,2014-03-02,Pittsburgh Penguins,0,Metropolitan,Eastern,84,2,120,0.7,69,15,68,16
2013-14,2014-03-05,Pittsburgh Penguins,2,Metropolitan,Eastern,86,2,122,0.7049180327868853,69,17,69,17
2013-14,2014-03-07,Pittsburgh Penguins,0,Metropolitan,Eastern,86,2,124,0.6935483870967742,70,16,69,17
2013-14,2014-03-08,Pittsburgh Penguins,2,Metropolitan,Eastern,88,2,126,0.6984126984126984,72,16,71,17
2013-14,2014-03-10,Pittsburgh Penguins,2,Metropolitan,Eastern,90,2,128,0.703125,73,17,71,19
2013-14,2014-03-11,Pittsburgh Penguins,2,Metropolitan,Eastern,92,2,130,0.7076923076923077,73,19,73,19
2013-14,2014-03-15,Pittsburgh Penguins,0,Metropolitan,Eastern,92,2,132,0.696969696969697,75,17,74,18
2013-14,2014-03-16,Pittsburgh Penguins,0,Metropolitan,Eastern,92,2,134,0.6865671641791045,76,16,76,16
2013-14,2014-03-18,Pittsburgh Penguins,2,Metropolitan,Eastern,94,2,136,0.6911764705882353,78,16,76,18
2013-14,2014-03-20,Pittsburgh Penguins,1,Metropolitan,Eastern,95,2,138,0.6884057971014492,78,17,78,17
2013-14,2014-03-22,Pittsburgh Penguins,2,Metropolitan,Eastern,97,2,140,0.6928571428571428,82,15,79,18
2013-14,2014-03-23,Pittsburgh Penguins,0,Metropolitan,Eastern,97,2,142,0.6830985915492958,82,15,80,17
2013-14,2014-03-25,Pittsburgh Penguins,0,Metropolitan,Eastern,97,2,144,0.6736111111111112,83,14,80,17
2013-14,2014-03-27,Pittsburgh Penguins,0,Metropolitan,Eastern,97,2,146,0.6643835616438356,83,14,80,17
2013-14,2014-03-28,Pittsburgh Penguins,2,Metropolitan,Eastern,99,2,148,0.668918918918919,85,14,80,19
2013-14,2014-03-30,Pittsburgh Penguins,2,Metropolitan,Eastern,101,2,150,0.6733333333333333,86,15,82,19
2013-14,2014-04-01,Pittsburgh Penguins,0,Metropolitan,Eastern,101,2,152,0.6644736842105263,86,15,83,18
2013-14,2014-04-04,Pittsburgh Penguins,2,Metropolitan,Eastern,103,2,154,0.6688311688311688,87,16,85,18
2013-14,2014-04-06,Pittsburgh Penguins,0,Metropolitan,Eastern,103,2,156,0.6602564102564102,89,14,87,16
2013-14,2014-04-07,Pittsburgh Penguins,2,Metropolitan,Eastern,105,2,158,0.6645569620253164,89,16,87,18
2013-14,2014-04-10,Pittsburgh Penguins,2,Metropolitan,Eastern,107,2,160,0.66875,91,16,91,16
2013-14,2014-04-12,Pittsburgh Penguins,1,Metropolitan,Eastern,108,2,162,0.6666666666666666,93,15,91,17
2013-14,2014-04-13,Pittsburgh Penguins,1,Metropolitan,Eastern,109,2,164,0.6646341463414634,94,15,93,16
2013-14,2013-10-04,San Jose Sharks,2,Pacific,Western,2,2,2,1.0,2,0,2,0
2013-14,2013-10-06,San Jose Sharks,2,Pacific,Western,4,2,4,1.0,2,2,2,2
2013-14,2013-10-09,San Jose Sharks,2,Pacific,Western,6,2,6,1.0,4,2,3,3
2013-14,2013-10-11,San Jose Sharks,2,Pacific,Western,8,2,8,1.0,6,2,6,2
2013-14,2013-10-13,San Jose Sharks,2,Pacific,Western,10,2,10,1.0,8,2,6,4
2013-14,2013-10-16,San Jose Sharks,2,Pacific,Western,12,2,12,1.0,8,4,8,4
2013-14,2013-10-18,San Jose Sharks,1,Pacific,Western,13,2,14,0.9285714285714286,10,3,9,4
2013-14,2013-10-20,San Jose Sharks,2,Pacific,Western,15,2,16,0.9375,12,3,11,4
2013-14,2013-10-21,San Jose Sharks,2,Pacific,Western,17,2,18,0.9444444444444444,12,5,11,6
2013-14,2013-10-24,San Jose Sharks,0,Pacific,Western,17,2,20,0.85,14,3,11,6
2013-14,2013-10-26,San Jose Sharks,2,Pacific,Western,19,2,22,0.8636363636363636,16,3,13,6
2013-14,2013-10-27,San Jose Sharks,2,Pacific,Western,21,2,24,0.875,17,4,14,7
2013-14,2013-10-31,San Jose Sharks,1,Pacific,Western,22,2,26,0.8461538461538461,19,3,16,6
2013-14,2013-11-03,San Jose Sharks,1,Pacific,Western,23,2,28,0.8214285714285714,22,1,18,5
2013-14,2013-11-06,San Jose Sharks,1,Pacific,Western,24,2,30,0.8,24,0,20,4
2013-14,2013-11-08,San Jose Sharks,0,Pacific,Western,24,2,32,0.75,24,0,22,2
2013-14,2013-11-11,San Jose Sharks,1,Pacific,Western,25,2,34,0.7352941176470589,25,0,24,1
2013-14,2013-11-13,San Jose Sharks,2,Pacific,Western,27,2,36,0.75,27,0,24,3
2013-14,2013-11-15,San Jose Sharks,2,Pacific,Western,29,2,38,0.7631578947368421,29,0,25,4
2013-14,2013-11-16,San Jose Sharks,2,Pacific,Western,31,2,40,0.775,29,2,27,4
2013-14,2013-11-18,San Jose Sharks,0,Pacific,Western,31,2,42,0.7380952380952381,31,0,28,3
2013-14,2013-11-22,San Jose Sharks,2,Pacific,Western,33,2,44,0.75,32,1,32,1
2013-14,2013-11-24,San Jose Sharks,2,Pacific,Western,35,2,46,0.7608695652173914,33,2,32,3
2013-14,2013-11-28,San Jose Sharks,2,Pacific,Western,37,2,48,0.7708333333333334,36,1,34,3
2013-14,2013-11-29,San Jose Sharks,2,Pacific,Western,39,2,50,0.78,36,3,34,5
2013-14,2013-12-01,San Jose Sharks,2,Pacific,Western,41,2,52,0.7884615384615384,36,5,34,7
2013-14,2013-12-04,San Jose Sharks,2,Pacific,Western,43,2,54,0.7962962962962963,40,3,36,7
2013-14,2013-12-06,San Jose Sharks,0,Pacific,Western,43,2,56,0.7678571428571429,40,3,36,7
2013-14,2013-12-07,San Jose Sharks,0,Pacific,Western,43,2,58,0.7413793103448276,40,3,37,6
2013-14,2013-12-08,San Jose Sharks,0,Pacific,Western,43,2,60,0.7166666666666667,42,1,37,6
2013-14,2013-12-11,San Jose Sharks,1,Pacific,Western,44,2,62,0.7096774193548387,44,0,40,4
2013-14,2013-12-13,San Jose Sharks,2,Pacific,Western,46,2,64,0.71875,46,0,41,5
2013-14,2013-12-15,San Jose Sharks,0,Pacific,Western,46,2,66,0.696969696969697,46,0,43,3
2013-14,2013-12-18,San Jose Sharks,2,Pacific,Western,48,2,68,0.7058823529411765,48,0,45,3
2013-14,2013-12-20,San Jose Sharks,0,Pacific,Western,48,2,70,0.6857142857142857,48,0,45,3
2013-14,2013-12-22,San Jose Sharks,2,Pacific,Western,50,2,72,0.6944444444444444,50,0,45,5
2013-14,2013-12-24,San Jose Sharks,2,Pacific,Western,52,2,74,0.7027027027027027,52,0,45,7
2013-14,2013-12-28,San Jose Sharks,2,Pacific,Western,54,2,76,0.7105263157894737,54,0,46,8
2013-14,2013-12-30,San Jose Sharks,2,Pacific,Western,56,2,78,0.717948717948718,54,2,47,9
2013-14,2014-01-01,San Jose Sharks,0,Pacific,Western,56,2,80,0.7,54,2,49,7
2013-14,2014-01-03,San Jose Sharks,2,Pacific,Western,58,2,82,0.7073170731707317,54,4,49,9
2013-14,2014-01-04,San Jose Sharks,0,Pacific,Western,58,2,84,0.6904761904761905,54,4,49,9
2013-14,2014-01-06,San Jose Sharks,2,Pacific,Western,60,2,86,0.6976744186046512,56,4,49,11
2013-14,2014-01-08,San Jose Sharks,0,Pacific,Western,60,2,88,0.6818181818181818,57,3,51,9
2013-14,2014-01-10,San Jose Sharks,2,Pacific,Western,62,2,90,0.6888888888888889,59,3,53,9
2013-14,2014-01-12,San Jose Sharks,0,Pacific,Western,62,2,92,0.6739130434782609,59,3,53,9
2013-14,2014-01-15,San Jose Sharks,2,Pacific,Western,64,2,94,0.6808510638297872,61,3,55,9
2013-14,2014-01-17,San Jose Sharks,2,Pacific,Western,66,2,96,0.6875,63,3,57,9
2013-14,2014-01-18,San Jose Sharks,2,Pacific,Western,68,2,98,0.6938775510204082,63,5,57,11
2013-14,2014-01-21,San Jose Sharks,2,Pacific,Western,70,2,100,0.7,64,6,59,11
2013-14,2014-01-24,San Jose Sharks,2,Pacific,Western,72,2,102,0.7058823529411765,64,8,61,11
2013-14,2014-01-26,San Jose Sharks,2,Pacific,Western,74,2,104,0.7115384615384616,64,10,61,13
2013-14,2014-01-28,San Jose Sharks,0,Pacific,Western,74,2,106,0.6981132075471698,66,8,62,12
2013-14,2014-01-30,San Jose Sharks,0,Pacific,Western,74,2,108,0.6851851851851852,66,8,63,11
2013-14,2014-01-31,San Jose Sharks,0,Pacific,Western,74,2,110,0.6727272727272727,66,8,63,11
2013-14,2014-02-02,San Jose Sharks,2,Pacific,Western,76,2,112,0.6785714285714286,66,10,63,13
2013-14,2014-02-04,San Jose Sharks,0,Pacific,Western,76,2,114,0.6666666666666666,66,10,63,13
2013-14,2014-02-06,San Jose Sharks,2,Pacific,Western,78,2,116,0.6724137931034483,66,12,63,15
2013-14,2014-02-08,San Jose Sharks,2,Pacific,Western,80,2,118,0.6779661016949152,68,12,64,16
2013-14,2014-02-28,San Jose Sharks,2,Pacific,Western,82,2,120,0.6833333333333333,72,10,66,16
2013-14,2014-03-01,San Jose Sharks,0,Pacific,Western,82,2,122,0.6721311475409836,74,8,66,16
2013-14,2014-03-02,San Jose Sharks,2,Pacific,Western,84,2,124,0.6774193548387096,74,10,66,18
2013-14,2014-03-05,San Jose Sharks,1,Pacific,Western,85,2,126,0.6746031746031746,76,9,68,17
2013-14,2014-03-07,San Jose Sharks,2,Pacific,Western,87,2,128,0.6796875,78,9,70,17
2013-14,2014-03-09,San Jose Sharks,2,Pacific,Western,89,2,130,0.6846153846153846,78,11,72,17
2013-14,2014-03-12,San Jose Sharks,2,Pacific,Western,91,2,132,0.6893939393939394,82,9,74,17
2013-14,2014-03-13,San Jose Sharks,2,Pacific,Western,93,2,134,0.6940298507462687,82,11,74,19
2013-14,2014-03-14,San Jose Sharks,2,Pacific,Western,95,2,136,0.6985294117647058,82,13,74,21
2013-14,2014-03-16,San Jose Sharks,2,Pacific,Western,97,2,138,0.7028985507246377,82,15,75,22
2013-14,2014-03-19,San Jose Sharks,0,Pacific,Western,97,2,140,0.6928571428571428,82,15,77,20
2013-14,2014-03-21,San Jose Sharks,2,Pacific,Western,99,2,142,0.6971830985915493,84,15,79,20
2013-14,2014-03-23,San Jose Sharks,1,Pacific,Western,100,2,144,0.6944444444444444,86,14,79,21
2013-14,2014-03-25,San Jose Sharks,1,Pacific,Western,101,2,146,0.6917808219178082,90,11,82,19
2013-14,2014-03-26,San Jose Sharks,2,Pacific,Western,103,2,148,0.6959459459459459,90,13,82,21
2013-14,2014-03-28,San Jose Sharks,0,Pacific,Western,103,2,150,0.6866666666666666,92,11,84,19
2013-14,2014-03-29,San Jose Sharks,0,Pacific,Western,103,2,152,0.6776315789473685,92,11,84,19
2013-14,2014-04-02,San Jose Sharks,2,Pacific,Western,105,2,154,0.6818181818181818,94,11,85,20
2013-14,2014-04-04,San Jose Sharks,2,Pacific,Western,107,2,156,0.6858974358974359,96,11,85,22
2013-14,2014-04-06,San Jose Sharks,0,Pacific,Western,107,2,158,0.6772151898734177,96,11,87,20
2013-14,2014-04-10,San Jose Sharks,0,Pacific,Western,107,2,160,0.66875,97,10,89,18
2013-14,2014-04-12,San Jose Sharks,2,Pacific,Western,109,2,162,0.6728395061728395,99,10,91,18
2013-14,2014-04-13,San Jose Sharks,2,Pacific,Western,111,2,164,0.676829268292683,100,11,91,20
2013-14,2013-10-04,St. Louis Blues,2,Central,Western,2,2,2,1.0,2,0,2,0
2013-14,2013-10-06,St. Louis Blues,2,Central,Western,4,2,4,1.0,4,0,2,2
2013-14,2013-10-10,St. Louis Blues,2,Central,Western,6,2,6,1.0,4,2,4,2
2013-14,2013-10-13,St. Louis Blues,2,Central,Western,8,2,8,1.0,7,1,6,2
2013-14,2013-10-16,St. Louis Blues,0,Central,Western,8,2,10,0.8,8,0,8,0
2013-14,2013-10-18,St. Louis Blues,2,Central,Western,10,2,12,0.8333333333333334,10,0,9,1
2013-14,2013-10-19,St. Louis Blues,1,Central,Western,11,2,14,0.7857142857142857,11,0,10,1
2013-14,2013-10-26,St. Louis Blues,1,Central,Western,12,2,16,0.75,13,-1,13,-1
2013-14,2013-10-27,St. Louis Blues,2,Central,Western,14,2,18,0.7777777777777778,15,-1,14,0
2013-14,2013-10-30,St. Louis Blues,2,Central,Western,16,2,20,0.8,16,0,16,0
2013-14,2013-11-01,St. Louis Blues,2,Central,Western,18,2,22,0.8181818181818182,18,0,18,0
2013-14,2013-11-02,St. Louis Blues,0,Central,Western,18,2,24,0.75,18,0,18,0
2013-14,2013-11-06,St. Louis Blues,2,Central,Western,20,2,26,0.7692307692307693,21,-1,20,0
2013-14,2013-11-08,St. Louis Blues,2,Central,Western,22,2,28,0.7857142857142857,22,0,22,0
2013-14,2013-11-10,St. Louis Blues,2,Central,Western,24,2,30,0.8,24,0,24,0
2013-14,2013-11-13,St. Louis Blues,1,Central,Western,25,2,32,0.78125,25,0,24,1
2013-14,2013-11-15,St. Louis Blues,2,Central,Western,27,2,34,0.7941176470588235,27,0,25,2
2013-14,2013-11-17,St. Louis Blues,0,Central,Western,27,2,36,0.75,28,-1,27,0
2013-14,2013-11-17,St. Louis Blues,2,Central,Western,29,2,38,0.7631578947368421,28,1,27,2
2013-14,2013-11-20,St. Louis Blues,2,Central,Western,31,2,40,0.775,30,1,30,1
2013-14,2013-11-22,St. Louis Blues,2,Central,Western,33,2,42,0.7857142857142857,32,1,32,1
2013-14,2013-11-24,St. Louis Blues,2,Central,Western,35,2,44,0.7954545454545454,34,1,32,3
2013-14,2013-11-26,St. Louis Blues,2,Central,Western,37,2,46,0.8043478260869565,34,3,32,5
2013-14,2013-11-28,St. Louis Blues,2,Central,Western,39,2,48,0.8125,34,5,34,5
2013-14,2013-11-29,St. Louis Blues,0,Central,Western,39,2,50,0.78,36,3,34,5
2013-14,2013-12-03,St. Louis Blues,0,Central,Western,39,2,52,0.75,38,1,34,5
2013-14,2013-12-06,St. Louis Blues,2,Central,Western,41,2,54,0.7592592592592593,39,2,36,5
2013-14,2013-12-08,St. Louis Blues,0,Central,Western,41,2,56,0.7321428571428571,41,0,37,4
2013-14,2013-12-11,St. Louis Blues,2,Central,Western,43,2,58,0.7413793103448276,41,2,40,3
2013-14,2013-12-13,St. Louis Blues,2,Central,Western,45,2,60,0.75,42,3,41,4
2013-14,2013-12-15,St. Louis Blues,2,Central,Western,47,2,62,0.7580645161290323,43,4,43,4
2013-14,2013-12-17,St. Louis Blues,1,Central,Western,48,2,64,0.75,45,3,43,5
2013-14,2013-12-18,St. Louis Blues,0,Central,Western,48,2,66,0.7272727272727273,45,3,45,3
2013-14,2013-12-20,St. Louis Blues,2,Central,Western,50,2,68,0.7352941176470589,47,3,45,5
2013-14,2013-12-22,St. Louis Blues,2,Central,Western,52,2,70,0.7428571428571429,48,4,45,7
2013-14,2013-12-24,St. Louis Blues,1,Central,Western,53,2,72,0.7361111111111112,49,4,45,8
2013-14,2013-12-29,St. Louis Blues,2,Central,Western,55,2,74,0.7432432432432432,49,6,47,8
2013-14,2013-12-29,St. Louis Blues,2,Central,Western,57,2,76,0.75,49,8,47,10
2013-14,2013-12-31,St. Louis Blues,2,Central,Western,59,2,78,0.7564102564102564,50,9,47,12
2013-14,2014-01-03,St. Louis Blues,2,Central,Western,61,2,80,0.7625,54,7,49,12
2013-14,2014-01-05,St. Louis Blues,2,Central,Western,63,2,82,0.7682926829268293,56,7,49,14
2013-14,2014-01-08,St. Louis Blues,2,Central,Western,65,2,84,0.7738095238095238,56,9,51,14
2013-14,2014-01-10,St. Louis Blues,2,Central,Western,67,2,86,0.7790697674418605,58,9,53,14
2013-14,2014-01-11,St. Louis Blues,0,Central,Western,67,2,88,0.7613636363636364,59,8,53,14
2013-14,2014-01-15,St. Louis Blues,2,Central,Western,69,2,90,0.7666666666666667,63,6,55,14
2013-14,2014-01-17,St. Louis Blues,0,Central,Western,69,2,92,0.75,65,4,57,12
2013-14,2014-01-19,St. Louis Blues,0,Central,Western,69,2,94,0.7340425531914894,67,2,59,10
2013-14,2014-01-21,St. Louis Blues,2,Central,Western,71,2,96,0.7395833333333334,67,4,59,12
2013-14,2014-01-22,St. Louis Blues,0,Central,Western,71,2,98,0.7244897959183674,67,4,59,12
2013-14,2014-01-24,St. Louis Blues,2,Central,Western,73,2,100,0.73,67,6,61,12
2013-14,2014-01-25,St. Louis Blues,2,Central,Western,75,2,102,0.7352941176470589,69,6,61,14
2013-14,2014-01-29,St. Louis Blues,2,Central,Western,77,2,104,0.7403846153846154,71,6,63,14
2013-14,2014-02-01,St. Louis Blues,0,Central,Western,77,2,106,0.7264150943396226,75,2,63,14
2013-14,2014-02-02,St. Louis Blues,2,Central,Western,79,2,108,0.7314814814814815,75,4,63,16
2013-14,2014-02-05,St. Louis Blues,1,Central,Western,80,2,110,0.7272727272727273,77,3,63,17
2013-14,2014-02-07,St. Louis Blues,2,Central,Western,82,2,112,0.7321428571428571,77,5,63,19
2013-14,2014-02-08,St. Louis Blues,2,Central,Western,84,2,114,0.7368421052631579,77,7,64,20
2013-14,2014-02-27,St. Louis Blues,0,Central,Western,84,2,116,0.7241379310344828,79,5,65,19
2013-14,2014-03-01,St. Louis Blues,0,Central,Western,84,2,118,0.711864406779661,81,3,66,18
2013-14,2014-03-03,St. Louis Blues,2,Central,Western,86,2,120,0.7166666666666667,83,3,66,20
2013-14,2014-03-05,St. Louis Blues,2,Central,Western,88,2,122,0.7213114754098361,85,3,68,20
2013-14,2014-03-07,St. Louis Blues,2,Central,Western,90,2,124,0.7258064516129032,87,3,70,20
2013-14,2014-03-08,St. Louis Blues,2,Central,Western,92,2,126,0.7301587301587301,87,5,70,22
2013-14,2014-03-10,St. Louis Blues,2,Central,Western,94,2,128,0.734375,87,7,72,22
2013-14,2014-03-12,St. Louis Blues,1,Central,Western,95,2,130,0.7307692307692307,89,6,74,21
2013-14,2014-03-14,St. Louis Blues,2,Central,Western,97,2,132,0.7348484848484849,90,7,74,23
2013-14,2014-03-16,St. Louis Blues,2,Central,Western,99,2,134,0.7388059701492538,92,7,75,24
2013-14,2014-03-18,St. Louis Blues,2,Central,Western,101,2,136,0.7426470588235294,93,8,77,24
2013-14,2014-03-20,St. Louis Blues,0,Central,Western,101,2,138,0.7318840579710145,94,7,77,24
2013-14,2014-03-22,St. Louis Blues,0,Central,Western,101,2,140,0.7214285714285714,94,7,79,22
2013-14,2014-03-23,St. Louis Blues,2,Central,Western,103,2,142,0.7253521126760564,94,9,79,24
2013-14,2014-03-25,St. Louis Blues,2,Central,Western,105,2,144,0.7291666666666666,94,11,82,23
2013-14,2014-03-28,St. Louis Blues,2,Central,Western,107,2,146,0.7328767123287672,98,9,84,23
2013-14,2014-03-30,St. Louis Blues,0,Central,Western,107,2,148,0.722972972972973,99,8,84,23
2013-14,2014-04-02,St. Louis Blues,2,Central,Western,109,2,150,0.7266666666666667,99,10,85,24
2013-14,2014-04-04,St. Louis Blues,2,Central,Western,111,2,152,0.7302631578947368,103,8,85,26
2013-14,2014-04-05,St. Louis Blues,0,Central,Western,111,2,154,0.7207792207792207,101,10,87,24
2013-14,2014-04-06,St. Louis Blues,0,Central,Western,111,2,156,0.7115384615384616,105,6,87,24
2013-14,2014-04-09,St. Louis Blues,0,Central,Western,111,2,158,0.7025316455696202,107,4,89,22
2013-14,2014-04-11,St. Louis Blues,0,Central,Western,111,2,160,0.69375,107,4,89,22
2013-14,2014-04-12,St. Louis Blues,0,Central,Western,111,2,162,0.6851851851851852,107,4,91,20
2013-14,2014-04-13,St. Louis Blues,0,Central,Western,111,2,164,0.676829268292683,107,4,91,20
2013-14,2013-10-03,Tampa Bay Lightning,0,Atlantic,Eastern,0,2,2,0.0,2,-2,0,0
2013-14,2013-10-06,Tampa Bay Lightning,2,Atlantic,Eastern,2,2,4,0.5,4,-2,2,0
2013-14,2013-10-08,Tampa Bay Lightning,2,Atlantic,Eastern,4,2,6,0.6666666666666666,4,0,3,1
2013-14,2013-10-10,Tampa Bay Lightning,2,Atlantic,Eastern,6,2,8,0.75,4,2,4,2
2013-14,2013-10-12,Tampa Bay Lightning,0,Atlantic,Eastern,6,2,10,0.6,6,0,4,2
2013-14,2013-10-15,Tampa Bay Lightning,2,Atlantic,Eastern,8,2,12,0.6666666666666666,8,0,6,2
2013-14,2013-10-17,Tampa Bay Lightning,2,Atlantic,Eastern,10,2,14,0.7142857142857143,10,0,8,2
2013-14,2013-10-19,Tampa Bay Lightning,0,Atlantic,Eastern,10,2,16,0.625,10,0,8,2
2013-14,2013-10-24,Tampa Bay Lightning,2,Atlantic,Eastern,12,2,18,0.6666666666666666,13,-1,10,2
2013-14,2013-10-26,Tampa Bay Lightning,2,Atlantic,Eastern,14,2,20,0.7,14,0,11,3
2013-14,2013-10-27,Tampa Bay Lightning,2,Atlantic,Eastern,16,2,22,0.7272727272727273,14,2,11,5
2013-14,2013-10-29,Tampa Bay Lightning,0,Atlantic,Eastern,16,2,24,0.6666666666666666,16,0,11,5
2013-14,2013-11-01,Tampa Bay Lightning,2,Atlantic,Eastern,18,2,26,0.6923076923076923,16,2,12,6
2013-14,2013-11-02,Tampa Bay Lightning,2,Atlantic,Eastern,20,2,28,0.7142857142857143,18,2,14,6
2013-14,2013-11-08,Tampa Bay Lightning,2,Atlantic,Eastern,22,2,30,0.7333333333333333,20,2,16,6
2013-14,2013-11-10,Tampa Bay Lightning,2,Atlantic,Eastern,24,2,32,0.75,22,2,18,6
2013-14,2013-11-11,Tampa Bay Lightning,0,Atlantic,Eastern,24,2,34,0.7058823529411765,22,2,18,6
2013-14,2013-11-13,Tampa Bay Lightning,2,Atlantic,Eastern,26,2,36,0.7222222222222222,23,3,18,8
2013-14,2013-11-15,Tampa Bay Lightning,2,Atlantic,Eastern,28,2,38,0.7368421052631579,23,5,18,10
2013-14,2013-11-17,Tampa Bay Lightning,0,Atlantic,Eastern,28,2,40,0.7,25,3,20,8
2013-14,2013-11-20,Tampa Bay Lightning,0,Atlantic,Eastern,28,2,42,0.6666666666666666,27,1,20,8
2013-14,2013-11-22,Tampa Bay Lightning,0,Atlantic,Eastern,28,2,44,0.6363636363636364,27,1,23,5
2013-14,2013-11-23,Tampa Bay Lightning,1,Atlantic,Eastern,29,2,46,0.6304347826086957,27,2,23,6
2013-14,2013-11-26,Tampa Bay Lightning,2,Atlantic,Eastern,31,2,48,0.6458333333333334,29,2,24,7
2013-14,2013-11-28,Tampa Bay Lightning,2,Atlantic,Eastern,33,2,50,0.66,31,2,26,7
2013-14,2013-11-29,Tampa Bay Lightning,0,Atlantic,Eastern,33,2,52,0.6346153846153846,33,0,26,7
2013-14,2013-12-04,Tampa Bay Lightning,0,Atlantic,Eastern,33,2,54,0.6111111111111112,35,-2,28,5
2013-14,2013-12-06,Tampa Bay Lightning,2,Atlantic,Eastern,35,2,56,0.625,35,0,30,5
2013-14,2013-12-08,Tampa Bay Lightning,1,Atlantic,Eastern,36,2,58,0.6206896551724138,37,-1,31,5
2013-14,2013-12-11,Tampa Bay Lightning,1,Atlantic,Eastern,37,2,60,0.6166666666666667,38,-1,32,5
2013-14,2013-12-13,Tampa Bay Lightning,2,Atlantic,Eastern,39,2,62,0.6290322580645161,39,0,33,6
2013-14,2013-12-15,Tampa Bay Lightning,0,Atlantic,Eastern,39,2,64,0.609375,39,0,35,4
2013-14,2013-12-15,Tampa Bay Lightning,2,Atlantic,Eastern,41,2,66,0.6212121212121212,39,2,35,6
2013-14,2013-12-18,Tampa Bay Lightning,2,Atlantic,Eastern,43,2,68,0.6323529411764706,43,0,35,8
2013-14,2013-12-20,Tampa Bay Lightning,2,Atlantic,Eastern,45,2,70,0.6428571428571429,45,0,36,9
2013-14,2013-12-22,Tampa Bay Lightning,2,Atlantic,Eastern,47,2,72,0.6527777777777778,47,0,37,10
2013-14,2013-12-24,Tampa Bay Lightning,2,Atlantic,Eastern,49,2,74,0.6621621621621622,47,2,38,11
2013-14,2013-12-29,Tampa Bay Lightning,1,Atlantic,Eastern,50,2,76,0.6578947368421053,49,1,40,10
2013-14,2013-12-30,Tampa Bay Lightning,0,Atlantic,Eastern,50,2,78,0.6410256410256411,49,1,40,10
2013-14,2014-01-02,Tampa Bay Lightning,2,Atlantic,Eastern,52,2,80,0.65,50,2,44,8
2013-14,2014-01-04,Tampa Bay Lightning,2,Atlantic,Eastern,54,2,82,0.6585365853658537,52,2,44,10
2013-14,2014-01-06,Tampa Bay Lightning,0,Atlantic,Eastern,54,2,84,0.6428571428571429,53,1,46,8
2013-14,2014-01-08,Tampa Bay Lightning,2,Atlantic,Eastern,56,2,86,0.6511627906976745,55,1,46,10
2013-14,2014-01-10,Tampa Bay Lightning,0,Atlantic,Eastern,56,2,88,0.6363636363636364,55,1,47,9
2013-14,2014-01-11,Tampa Bay Lightning,2,Atlantic,Eastern,58,2,90,0.6444444444444445,55,3,48,10
2013-14,2014-01-14,Tampa Bay Lightning,0,Atlantic,Eastern,58,2,92,0.6304347826086957,57,1,50,8
2013-14,2014-01-15,Tampa Bay Lightning,2,Atlantic,Eastern,60,2,94,0.6382978723404256,57,3,51,9
2013-14,2014-01-17,Tampa Bay Lightning,1,Atlantic,Eastern,61,2,96,0.6354166666666666,59,2,52,9
2013-14,2014-01-18,Tampa Bay Lightning,0,Atlantic,Eastern,61,2,98,0.6224489795918368,59,2,52,9
2013-14,2014-01-19,Tampa Bay Lightning,2,Atlantic,Eastern,63,2,100,0.63,59,4,52,11
2013-14,2014-01-24,Tampa Bay Lightning,2,Atlantic,Eastern,65,2,102,0.6372549019607843,59,6,56,9
2013-14,2014-01-26,Tampa Bay Lightning,2,Atlantic,Eastern,67,2,104,0.6442307692307693,60,7,56,11
2013-14,2014-01-29,Tampa Bay Lightning,0,Atlantic,Eastern,67,2,106,0.6320754716981132,62,5,57,10
2013-14,2014-01-31,Tampa Bay Lightning,0,Atlantic,Eastern,67,2,108,0.6203703703703703,64,3,58,9
2013-14,2014-02-01,Tampa Bay Lightning,2,Atlantic,Eastern,69,2,110,0.6272727272727273,64,5,59,10
2013-14,2014-02-05,Tampa Bay Lightning,0,Atlantic,Eastern,69,2,112,0.6160714285714286,66,3,62,7
2013-14,2014-02-07,Tampa Bay Lightning,0,Atlantic,Eastern,69,2,114,0.6052631578947368,68,1,64,5
2013-14,2014-02-09,Tampa Bay Lightning,2,Atlantic,Eastern,71,2,116,0.6120689655172413,70,1,64,7
2013-14,2014-02-28,Tampa Bay Lightning,0,Atlantic,Eastern,71,2,118,0.6016949152542372,71,0,66,5
2013-14,2014-03-01,Tampa Bay Lightning,2,Atlantic,Eastern,73,2,120,0.6083333333333333,73,0,68,5
2013-14,2014-03-03,Tampa Bay Lightning,0,Atlantic,Eastern,73,2,122,0.5983606557377049,73,0,68,5
2013-14,2014-03-05,Tampa Bay Lightning,0,Atlantic,Eastern,73,2,124,0.5887096774193549,73,0,69,4
2013-14,2014-03-07,Tampa Bay Lightning,0,Atlantic,Eastern,73,2,126,0.5793650793650794,74,-1,69,4
2013-14,2014-03-09,Tampa Bay Lightning,1,Atlantic,Eastern,74,2,128,0.578125,76,-2,71,3
2013-14,2014-03-10,Tampa Bay Lightning,1,Atlantic,Eastern,75,2,130,0.5769230769230769,76,-1,71,4
2013-14,2014-03-13,Tampa Bay Lightning,2,Atlantic,Eastern,77,2,132,0.5833333333333334,77,0,73,4
2013-14,2014-03-15,Tampa Bay Lightning,2,Atlantic,Eastern,79,2,134,0.5895522388059702,79,0,74,5
2013-14,2014-03-17,Tampa Bay Lightning,2,Atlantic,Eastern,81,2,136,0.5955882352941176,81,0,76,5
2013-14,2014-03-19,Tampa Bay Lightning,2,Atlantic,Eastern,83,2,138,0.6014492753623188,83,0,76,7
2013-14,2014-03-20,Tampa Bay Lightning,2,Atlantic,Eastern,85,2,140,0.6071428571428571,83,2,78,7
2013-14,2014-03-22,Tampa Bay Lightning,1,Atlantic,Eastern,86,2,142,0.6056338028169014,85,1,79,7
2013-14,2014-03-24,Tampa Bay Lightning,1,Atlantic,Eastern,87,2,144,0.6041666666666666,87,0,80,7
2013-14,2014-03-27,Tampa Bay Lightning,2,Atlantic,Eastern,89,2,146,0.6095890410958904,89,0,80,9
2013-14,2014-03-29,Tampa Bay Lightning,2,Atlantic,Eastern,91,2,148,0.6148648648648649,91,0,82,9
2013-14,2014-03-30,Tampa Bay Lightning,0,Atlantic,Eastern,91,2,150,0.6066666666666667,91,0,82,9
2013-14,2014-04-01,Tampa Bay Lightning,2,Atlantic,Eastern,93,2,152,0.6118421052631579,93,0,83,10
2013-14,2014-04-03,Tampa Bay Lightning,0,Atlantic,Eastern,93,2,154,0.6038961038961039,93,0,85,8
2013-14,2014-04-05,Tampa Bay Lightning,0,Atlantic,Eastern,93,2,156,0.5961538461538461,93,0,85,8
2013-14,2014-04-08,Tampa Bay Lightning,2,Atlantic,Eastern,95,2,158,0.6012658227848101,95,0,89,6
2013-14,2014-04-10,Tampa Bay Lightning,2,Atlantic,Eastern,97,2,160,0.60625,97,0,91,6
2013-14,2014-04-11,Tampa Bay Lightning,2,Atlantic,Eastern,99,2,162,0.6111111111111112,98,1,91,8
2013-14,2014-04-13,Tampa Bay Lightning,2,Atlantic,Eastern,101,2,164,0.6158536585365854,100,1,93,8
2013-14,2013-10-01,Toronto Maple Leafs,2,Atlantic,Eastern,2,2,2,1.0,0,2,0,2
2013-14,2013-10-02,Toronto Maple Leafs,2,Atlantic,Eastern,4,2,4,1.0,0,4,0,4
2013-14,2013-10-05,Toronto Maple Leafs,2,Atlantic,Eastern,6,2,6,1.0,4,2,2,4
2013-14,2013-10-08,Toronto Maple Leafs,0,Atlantic,Eastern,6,2,8,0.75,4,2,3,3
2013-14,2013-10-11,Toronto Maple Leafs,2,Atlantic,Eastern,8,2,10,0.8,4,4,4,4
2013-14,2013-10-12,Toronto Maple Leafs,2,Atlantic,Eastern,10,2,12,0.8333333333333334,6,4,4,6
2013-14,2013-10-15,Toronto Maple Leafs,2,Atlantic,Eastern,12,2,14,0.8571428571428571,8,4,6,6
2013-14,2013-10-17,Toronto Maple Leafs,0,Atlantic,Eastern,12,2,16,0.75,10,2,8,4
2013-14,2013-10-19,Toronto Maple Leafs,0,Atlantic,Eastern,12,2,18,0.6666666666666666,10,2,8,4
2013-14,2013-10-22,Toronto Maple Leafs,2,Atlantic,Eastern,14,2,20,0.7,10,4,9,5
2013-14,2013-10-25,Toronto Maple Leafs,0,Atlantic,Eastern,14,2,22,0.6363636363636364,12,2,11,3
2013-14,2013-10-26,Toronto Maple Leafs,2,Atlantic,Eastern,16,2,24,0.6666666666666666,14,2,11,5
2013-14,2013-10-30,Toronto Maple Leafs,2,Atlantic,Eastern,18,2,26,0.6923076923076923,16,2,11,7
2013-14,2013-10-31,Toronto Maple Leafs,2,Atlantic,Eastern,20,2,28,0.7142857142857143,16,4,11,9
2013-14,2013-11-02,Toronto Maple Leafs,0,Atlantic,Eastern,20,2,30,0.6666666666666666,18,2,14,6
2013-14,2013-11-09,Toronto Maple Leafs,2,Atlantic,Eastern,22,2,32,0.6875,21,1,17,5
2013-14,2013-11-10,Toronto Maple Leafs,0,Atlantic,Eastern,22,2,34,0.6470588235294118,22,0,18,4
2013-14,2013-11-14,Toronto Maple Leafs,1,Atlantic,Eastern,23,2,36,0.6388888888888888,23,0,18,5
2013-14,2013-11-16,Toronto Maple Leafs,0,Atlantic,Eastern,23,2,38,0.6052631578947368,24,-1,20,3
2013-14,2013-11-17,Toronto Maple Leafs,2,Atlantic,Eastern,25,2,40,0.625,25,0,20,5
2013-14,2013-11-20,Toronto Maple Leafs,2,Atlantic,Eastern,27,2,42,0.6428571428571429,27,0,20,7
2013-14,2013-11-22,Toronto Maple Leafs,0,Atlantic,Eastern,27,2,44,0.6136363636363636,27,0,23,4
2013-14,2013-11-24,Toronto Maple Leafs,2,Atlantic,Eastern,29,2,46,0.6304347826086957,29,0,24,5
2013-14,2013-11-26,Toronto Maple Leafs,0,Atlantic,Eastern,29,2,48,0.6041666666666666,29,0,24,5
2013-14,2013-11-28,Toronto Maple Leafs,1,Atlantic,Eastern,30,2,50,0.6,31,-1,26,4
2013-14,2013-11-30,Toronto Maple Leafs,1,Atlantic,Eastern,31,2,52,0.5961538461538461,33,-2,28,3
2013-14,2013-12-01,Toronto Maple Leafs,0,Atlantic,Eastern,31,2,54,0.5740740740740741,33,-2,28,3
2013-14,2013-12-04,Toronto Maple Leafs,0,Atlantic,Eastern,31,2,56,0.5535714285714286,35,-4,28,3
2013-14,2013-12-06,Toronto Maple Leafs,2,Atlantic,Eastern,33,2,58,0.5689655172413793,35,-2,30,3
2013-14,2013-12-08,Toronto Maple Leafs,2,Atlantic,Eastern,35,2,60,0.5833333333333334,37,-2,31,4
2013-14,2013-12-09,Toronto Maple Leafs,0,Atlantic,Eastern,35,2,62,0.5645161290322581,37,-2,31,4
2013-14,2013-12-12,Toronto Maple Leafs,0,Atlantic,Eastern,35,2,64,0.546875,38,-3,32,3
2013-14,2013-12-13,Toronto Maple Leafs,0,Atlantic,Eastern,35,2,66,0.5303030303030303,39,-4,33,2
2013-14,2013-12-15,Toronto Maple Leafs,2,Atlantic,Eastern,37,2,68,0.5441176470588235,39,-2,35,2
2013-14,2013-12-17,Toronto Maple Leafs,0,Atlantic,Eastern,37,2,70,0.5285714285714286,41,-4,35,2
2013-14,2013-12-18,Toronto Maple Leafs,0,Atlantic,Eastern,37,2,72,0.5138888888888888,43,-6,35,2
2013-14,2013-12-20,Toronto Maple Leafs,2,Atlantic,Eastern,39,2,74,0.527027027027027,45,-6,36,3
2013-14,2013-12-22,Toronto Maple Leafs,1,Atlantic,Eastern,40,2,76,0.5263157894736842,47,-7,37,3
2013-14,2013-12-24,Toronto Maple Leafs,1,Atlantic,Eastern,41,2,78,0.5256410256410257,47,-6,38,3
2013-14,2013-12-28,Toronto Maple Leafs,2,Atlantic,Eastern,43,2,80,0.5375,47,-4,38,5
2013-14,2013-12-30,Toronto Maple Leafs,2,Atlantic,Eastern,45,2,82,0.5487804878048781,49,-4,40,5
2013-14,2014-01-01,Toronto Maple Leafs,2,Atlantic,Eastern,47,2,84,0.5595238095238095,50,-3,44,3
2013-14,2014-01-05,Toronto Maple Leafs,0,Atlantic,Eastern,47,2,86,0.5465116279069767,53,-6,46,1
2013-14,2014-01-08,Toronto Maple Leafs,0,Atlantic,Eastern,47,2,88,0.5340909090909091,55,-8,46,1
2013-14,2014-01-10,Toronto Maple Leafs,0,Atlantic,Eastern,47,2,90,0.5222222222222223,55,-8,47,0
2013-14,2014-01-11,Toronto Maple Leafs,0,Atlantic,Eastern,47,2,92,0.5108695652173914,55,-8,48,-1
2013-14,2014-01-13,Toronto Maple Leafs,2,Atlantic,Eastern,49,2,94,0.5212765957446809,57,-8,50,-1
2013-14,2014-01-15,Toronto Maple Leafs,2,Atlantic,Eastern,51,2,96,0.53125,57,-6,51,0
2013-14,2014-01-16,Toronto Maple Leafs,2,Atlantic,Eastern,53,2,98,0.5408163265306123,57,-4,51,2
2013-14,2014-01-19,Toronto Maple Leafs,2,Atlantic,Eastern,55,2,100,0.55,59,-4,52,3
2013-14,2014-01-21,Toronto Maple Leafs,2,Atlantic,Eastern,57,2,102,0.5588235294117647,59,-2,52,5
2013-14,2014-01-22,Toronto Maple Leafs,2,Atlantic,Eastern,59,2,104,0.5673076923076923,59,0,54,5
2013-14,2014-01-24,Toronto Maple Leafs,0,Atlantic,Eastern,59,2,106,0.5566037735849056,59,0,56,3
2013-14,2014-01-26,Toronto Maple Leafs,1,Atlantic,Eastern,60,2,108,0.5555555555555556,60,0,56,4
2013-14,2014-01-29,Toronto Maple Leafs,2,Atlantic,Eastern,62,2,110,0.5636363636363636,62,0,57,5
2013-14,2014-01-31,Toronto Maple Leafs,2,Atlantic,Eastern,64,2,112,0.5714285714285714,64,0,58,6
2013-14,2014-02-02,Toronto Maple Leafs,2,Atlantic,Eastern,66,2,114,0.5789473684210527,66,0,60,6
2013-14,2014-02-05,Toronto Maple Leafs,0,Atlantic,Eastern,66,2,116,0.5689655172413793,66,0,62,4
2013-14,2014-02-07,Toronto Maple Leafs,2,Atlantic,Eastern,68,2,118,0.576271186440678,68,0,64,4
2013-14,2014-02-08,Toronto Maple Leafs,2,Atlantic,Eastern,70,2,120,0.5833333333333334,70,0,64,6
2013-14,2014-02-28,Toronto Maple Leafs,1,Atlantic,Eastern,71,2,122,0.5819672131147541,71,0,66,5
2013-14,2014-03-02,Toronto Maple Leafs,1,Atlantic,Eastern,72,2,124,0.5806451612903226,73,-1,68,4
2013-14,2014-03-04,Toronto Maple Leafs,0,Atlantic,Eastern,72,2,126,0.5714285714285714,73,-1,68,4
2013-14,2014-03-06,Toronto Maple Leafs,2,Atlantic,Eastern,74,2,128,0.578125,74,0,69,5
2013-14,2014-03-09,Toronto Maple Leafs,2,Atlantic,Eastern,76,2,130,0.5846153846153846,76,0,71,5
2013-14,2014-03-11,Toronto Maple Leafs,2,Atlantic,Eastern,78,2,132,0.5909090909090909,77,1,73,5
2013-14,2014-03-12,Toronto Maple Leafs,0,Atlantic,Eastern,78,2,134,0.582089552238806,77,1,73,5
2013-14,2014-03-14,Toronto Maple Leafs,2,Atlantic,Eastern,80,2,136,0.5882352941176471,77,3,73,7
2013-14,2014-03-16,Toronto Maple Leafs,0,Atlantic,Eastern,80,2,138,0.5797101449275363,80,0,76,4
2013-14,2014-03-18,Toronto Maple Leafs,0,Atlantic,Eastern,80,2,140,0.5714285714285714,81,-1,76,4
2013-14,2014-03-19,Toronto Maple Leafs,0,Atlantic,Eastern,80,2,142,0.5633802816901409,83,-3,76,4
2013-14,2014-03-22,Toronto Maple Leafs,0,Atlantic,Eastern,80,2,144,0.5555555555555556,85,-5,79,1
2013-14,2014-03-23,Toronto Maple Leafs,0,Atlantic,Eastern,80,2,146,0.547945205479452,85,-5,80,0
2013-14,2014-03-25,Toronto Maple Leafs,0,Atlantic,Eastern,80,2,148,0.5405405405405406,87,-7,80,0
2013-14,2014-03-28,Toronto Maple Leafs,0,Atlantic,Eastern,80,2,150,0.5333333333333333,89,-9,80,0
2013-14,2014-03-29,Toronto Maple Leafs,0,Atlantic,Eastern,80,2,152,0.5263157894736842,91,-11,82,-2
2013-14,2014-04-01,Toronto Maple Leafs,2,Atlantic,Eastern,82,2,154,0.5324675324675324,93,-11,83,-1
2013-14,2014-04-03,Toronto Maple Leafs,2,Atlantic,Eastern,84,2,156,0.5384615384615384,93,-9,85,-1
2013-14,2014-04-05,Toronto Maple Leafs,0,Atlantic,Eastern,84,2,158,0.5316455696202531,93,-9,85,-1
2013-14,2014-04-08,Toronto Maple Leafs,0,Atlantic,Eastern,84,2,160,0.525,95,-11,89,-5
2013-14,2014-04-10,Toronto Maple Leafs,0,Atlantic,Eastern,84,2,162,0.5185185185185185,97,-13,91,-7
2013-14,2014-04-12,Toronto Maple Leafs,0,Atlantic,Eastern,84,2,164,0.5121951219512195,99,-15,91,-7
2013-14,2013-10-04,Vancouver Canucks,0,Pacific,Western,0,2,2,0.0,2,-2,2,-2
2013-14,2013-10-06,Vancouver Canucks,2,Pacific,Western,2,2,4,0.5,2,0,2,0
2013-14,2013-10-07,Vancouver Canucks,2,Pacific,Western,4,2,6,0.6666666666666666,4,0,3,1
2013-14,2013-10-09,Vancouver Canucks,2,Pacific,Western,6,2,8,0.75,4,2,3,3
2013-14,2013-10-11,Vancouver Canucks,0,Pacific,Western,6,2,10,0.6,6,0,6,0
2013-14,2013-10-13,Vancouver Canucks,0,Pacific,Western,6,2,12,0.5,8,-2,6,0
2013-14,2013-10-15,Vancouver Canucks,2,Pacific,Western,8,2,14,0.5714285714285714,8,0,8,0
2013-14,2013-10-17,Vancouver Canucks,2,Pacific,Western,10,2,16,0.625,10,0,8,2
2013-14,2013-10-19,Vancouver Canucks,1,Pacific,Western,11,2,18,0.6111111111111112,11,0,10,1
2013-14,2013-10-20,Vancouver Canucks,0,Pacific,Western,11,2,20,0.55,12,-1,11,0
2013-14,2013-10-22,Vancouver Canucks,2,Pacific,Western,13,2,22,0.5909090909090909,13,0,11,2
2013-14,2013-10-24,Vancouver Canucks,2,Pacific,Western,15,2,24,0.625,14,1,11,4
2013-14,2013-10-26,Vancouver Canucks,2,Pacific,Western,17,2,26,0.6538461538461539,16,1,13,4
2013-14,2013-10-29,Vancouver Canucks,2,Pacific,Western,19,2,28,0.6785714285714286,19,0,15,4
2013-14,2013-10-31,Vancouver Canucks,0,Pacific,Western,19,2,30,0.6333333333333333,19,0,16,3
2013-14,2013-11-02,Vancouver Canucks,2,Pacific,Western,21,2,32,0.65625,21,0,18,3
2013-14,2013-11-06,Vancouver Canucks,1,Pacific,Western,22,2,34,0.6470588235294118,24,-2,20,2
2013-14,2013-11-08,Vancouver Canucks,2,Pacific,Western,24,2,36,0.6666666666666666,24,0,22,2
2013-14,2013-11-10,Vancouver Canucks,0,Pacific,Western,24,2,38,0.631578947368421,24,0,24,0
2013-14,2013-11-11,Vancouver Canucks,0,Pacific,Western,24,2,40,0.6,25,-1,24,0
2013-14,2013-11-15,Vancouver Canucks,1,Pacific,Western,25,2,42,0.5952380952380952,29,-4,25,0
2013-14,2013-11-18,Vancouver Canucks,0,Pacific,Western,25,2,44,0.5681818181818182,31,-6,28,-3
2013-14,2013-11-20,Vancouver Canucks,1,Pacific,Western,26,2,46,0.5652173913043478,31,-5,30,-4
2013-14,2013-11-23,Vancouver Canucks,2,Pacific,Western,28,2,48,0.5833333333333334,32,-4,32,-4
2013-14,2013-11-24,Vancouver Canucks,0,Pacific,Western,28,2,50,0.56,33,-5,32,-4
2013-14,2013-11-26,Vancouver Canucks,1,Pacific,Western,29,2,52,0.5576923076923077,35,-6,32,-3
2013-14,2013-11-29,Vancouver Canucks,2,Pacific,Western,31,2,54,0.5740740740740741,36,-5,34,-3
2013-14,2013-11-30,Vancouver Canucks,0,Pacific,Western,31,2,56,0.5535714285714286,36,-5,34,-3
2013-14,2013-12-01,Vancouver Canucks,2,Pacific,Western,33,2,58,0.5689655172413793,36,-3,34,-1
2013-14,2013-12-04,Vancouver Canucks,2,Pacific,Western,35,2,60,0.5833333333333334,40,-5,36,-1
2013-14,2013-12-07,Vancouver Canucks,2,Pacific,Western,37,2,62,0.5967741935483871,40,-3,37,0
2013-14,2013-12-09,Vancouver Canucks,2,Pacific,Western,39,2,64,0.609375,42,-3,39,0
2013-14,2013-12-10,Vancouver Canucks,2,Pacific,Western,41,2,66,0.6212121212121212,42,-1,40,1
2013-14,2013-12-14,Vancouver Canucks,2,Pacific,Western,43,2,68,0.6323529411764706,46,-3,41,2
2013-14,2013-12-15,Vancouver Canucks,2,Pacific,Western,45,2,70,0.6428571428571429,46,-1,43,2
2013-14,2013-12-18,Vancouver Canucks,1,Pacific,Western,46,2,72,0.6388888888888888,48,-2,45,1
2013-14,2013-12-20,Vancouver Canucks,0,Pacific,Western,46,2,74,0.6216216216216216,48,-2,45,1
2013-14,2013-12-21,Vancouver Canucks,2,Pacific,Western,48,2,76,0.631578947368421,48,0,45,3
2013-14,2013-12-23,Vancouver Canucks,2,Pacific,Western,50,2,78,0.6410256410256411,50,0,45,5
2013-14,2013-12-30,Vancouver Canucks,2,Pacific,Western,52,2,80,0.65,54,-2,47,5
2013-14,2013-12-31,Vancouver Canucks,1,Pacific,Western,53,2,82,0.6463414634146342,54,-1,47,6
2013-14,2014-01-02,Vancouver Canucks,0,Pacific,Western,53,2,84,0.6309523809523809,54,-1,49,4
2013-14,2014-01-05,Vancouver Canucks,0,Pacific,Western,53,2,86,0.6162790697674418,56,-3,49,4
2013-14,2014-01-06,Vancouver Canucks,1,Pacific,Western,54,2,88,0.6136363636363636,56,-2,49,5
2013-14,2014-01-08,Vancouver Canucks,1,Pacific,Western,55,2,90,0.6111111111111112,57,-2,51,4
2013-14,2014-01-11,Vancouver Canucks,2,Pacific,Western,57,2,92,0.6195652173913043,59,-2,53,4
2013-14,2014-01-14,Vancouver Canucks,0,Pacific,Western,57,2,94,0.6063829787234043,61,-4,55,2
2013-14,2014-01-16,Vancouver Canucks,0,Pacific,Western,57,2,96,0.59375,61,-4,55,2
2013-14,2014-01-17,Vancouver Canucks,0,Pacific,Western,57,2,98,0.5816326530612245,63,-6,57,0
2013-14,2014-01-19,Vancouver Canucks,2,Pacific,Western,59,2,100,0.59,64,-5,59,0
2013-14,2014-01-22,Vancouver Canucks,2,Pacific,Western,61,2,102,0.5980392156862745,64,-3,59,2
2013-14,2014-01-24,Vancouver Canucks,0,Pacific,Western,61,2,104,0.5865384615384616,64,-3,61,0
2013-14,2014-01-27,Vancouver Canucks,2,Pacific,Western,63,2,106,0.5943396226415094,64,-1,62,1
2013-14,2014-01-28,Vancouver Canucks,0,Pacific,Western,63,2,108,0.5833333333333334,66,-3,62,1
2013-14,2014-01-30,Vancouver Canucks,0,Pacific,Western,63,2,110,0.5727272727272728,66,-3,63,0
2013-14,2014-02-01,Vancouver Canucks,0,Pacific,Western,63,2,112,0.5625,66,-3,63,0
2013-14,2014-02-04,Vancouver Canucks,0,Pacific,Western,63,2,114,0.5526315789473685,66,-3,63,0
2013-14,2014-02-05,Vancouver Canucks,0,Pacific,Western,63,2,116,0.5431034482758621,66,-3,63,0
2013-14,2014-02-07,Vancouver Canucks,0,Pacific,Western,63,2,118,0.5338983050847458,68,-5,63,0
2013-14,2014-02-08,Vancouver Canucks,0,Pacific,Western,63,2,120,0.525,68,-5,64,-1
2013-14,2014-02-27,Vancouver Canucks,2,Pacific,Western,65,2,122,0.5327868852459017,70,-5,65,0
2013-14,2014-03-01,Vancouver Canucks,1,Pacific,Western,66,2,124,0.532258064516129,74,-8,66,0
2013-14,2014-03-02,Vancouver Canucks,0,Pacific,Western,66,2,126,0.5238095238095238,74,-8,66,0
2013-14,2014-03-05,Vancouver Canucks,0,Pacific,Western,66,2,128,0.515625,76,-10,68,-2
2013-14,2014-03-07,Vancouver Canucks,0,Pacific,Western,66,2,130,0.5076923076923077,78,-12,70,-4
2013-14,2014-03-09,Vancouver Canucks,2,Pacific,Western,68,2,132,0.5151515151515151,78,-10,72,-4
2013-14,2014-03-11,Vancouver Canucks,0,Pacific,Western,68,2,134,0.5074626865671642,82,-14,73,-5
2013-14,2014-03-12,Vancouver Canucks,2,Pacific,Western,70,2,136,0.5147058823529411,82,-12,74,-4
2013-14,2014-03-14,Vancouver Canucks,0,Pacific,Western,70,2,138,0.5072463768115942,82,-12,74,-4
2013-14,2014-03-16,Vancouver Canucks,2,Pacific,Western,72,2,140,0.5142857142857142,82,-10,75,-3
2013-14,2014-03-17,Vancouver Canucks,0,Pacific,Western,72,2,142,0.5070422535211268,82,-10,75,-3
2013-14,2014-03-20,Vancouver Canucks,2,Pacific,Western,74,2,144,0.5138888888888888,82,-8,77,-3
2013-14,2014-03-24,Vancouver Canucks,2,Pacific,Western,76,2,146,0.5205479452054794,88,-12,80,-4
2013-14,2014-03-26,Vancouver Canucks,2,Pacific,Western,78,2,148,0.527027027027027,90,-12,82,-4
2013-14,2014-03-28,Vancouver Canucks,1,Pacific,Western,79,2,150,0.5266666666666666,92,-13,84,-5
2013-14,2014-03-30,Vancouver Canucks,0,Pacific,Western,79,2,152,0.5197368421052632,94,-15,84,-5
2013-14,2014-04-02,Vancouver Canucks,0,Pacific,Western,79,2,154,0.512987012987013,94,-15,85,-6
2013-14,2014-04-06,Vancouver Canucks,2,Pacific,Western,81,2,156,0.5192307692307693,96,-15,87,-6
2013-14,2014-04-08,Vancouver Canucks,0,Pacific,Western,81,2,158,0.5126582278481012,96,-15,87,-6
2013-14,2014-04-11,Vancouver Canucks,0,Pacific,Western,81,2,160,0.50625,99,-18,89,-8
2013-14,2014-04-13,Vancouver Canucks,0,Pacific,Western,81,2,162,0.5,100,-19,91,-10
2013-14,2014-04-14,Vancouver Canucks,2,Pacific,Western,83,2,164,0.5060975609756098,100,-17,91,-8
2013-14,2013-10-02,Washington Capitals,0,Metropolitan,Eastern,0,2,2,0.0,0,0,0,0
2013-14,2013-10-03,Washington Capitals,2,Metropolitan,Eastern,2,2,4,0.5,0,2,0,2
2013-14,2013-10-06,Washington Capitals,0,Metropolitan,Eastern,2,2,6,0.3333333333333333,3,-1,2,0
2013-14,2013-10-10,Washington Capitals,0,Metropolitan,Eastern,2,2,8,0.25,5,-3,4,-2
2013-14,2013-10-12,Washington Capitals,0,Metropolitan,Eastern,2,2,10,0.2,5,-3,4,-2
2013-14,2013-10-14,Washington Capitals,2,Metropolitan,Eastern,4,2,12,0.3333333333333333,5,-1,5,-1
2013-14,2013-10-17,Washington Capitals,0,Metropolitan,Eastern,4,2,14,0.2857142857142857,8,-4,8,-4
2013-14,2013-10-19,Washington Capitals,2,Metropolitan,Eastern,6,2,16,0.375,8,-2,8,-2
2013-14,2013-10-23,Washington Capitals,2,Metropolitan,Eastern,8,2,18,0.4444444444444444,9,-1,10,-2
2013-14,2013-10-25,Washington Capitals,2,Metropolitan,Eastern,10,2,20,0.5,11,-1,11,-1
2013-14,2013-10-27,Washington Capitals,0,Metropolitan,Eastern,10,2,22,0.45454545454545453,11,-1,11,-1
2013-14,2013-10-29,Washington Capitals,0,Metropolitan,Eastern,10,2,24,0.4166666666666667,11,-1,11,-1
2013-14,2013-11-01,Washington Capitals,2,Metropolitan,Eastern,12,2,26,0.46153846153846156,12,0,12,0
2013-14,2013-11-02,Washington Capitals,2,Metropolitan,Eastern,14,2,28,0.5,14,0,14,0
2013-14,2013-11-06,Washington Capitals,2,Metropolitan,Eastern,16,2,30,0.5333333333333333,15,1,15,1
2013-14,2013-11-08,Washington Capitals,2,Metropolitan,Eastern,18,2,32,0.5625,16,2,16,2
2013-14,2013-11-10,Washington Capitals,1,Metropolitan,Eastern,19,2,34,0.5588235294117647,16,3,18,1
2013-14,2013-11-11,Washington Capitals,0,Metropolitan,Eastern,19,2,36,0.5277777777777778,18,1,18,1
2013-14,2013-11-13,Washington Capitals,2,Metropolitan,Eastern,21,2,38,0.5526315789473685,18,3,18,3
2013-14,2013-11-16,Washington Capitals,2,Metropolitan,Eastern,23,2,40,0.575,20,3,20,3
2013-14,2013-11-17,Washington Capitals,2,Metropolitan,Eastern,25,2,42,0.5952380952380952,20,5,20,5
2013-14,2013-11-21,Washington Capitals,0,Metropolitan,Eastern,25,2,44,0.5681818181818182,21,4,21,4
2013-14,2013-11-23,Washington Capitals,0,Metropolitan,Eastern,25,2,46,0.5434782608695652,23,2,23,2
2013-14,2013-11-24,Washington Capitals,1,Metropolitan,Eastern,26,2,48,0.5416666666666666,24,2,24,2
2013-14,2013-11-28,Washington Capitals,0,Metropolitan,Eastern,26,2,50,0.52,26,0,26,0
2013-14,2013-11-29,Washington Capitals,2,Metropolitan,Eastern,28,2,52,0.5384615384615384,26,2,26,2
2013-14,2013-12-01,Washington Capitals,2,Metropolitan,Eastern,30,2,54,0.5555555555555556,28,2,28,2
2013-14,2013-12-04,Washington Capitals,0,Metropolitan,Eastern,30,2,56,0.5357142857142857,28,2,28,2
2013-14,2013-12-08,Washington Capitals,2,Metropolitan,Eastern,32,2,58,0.5517241379310345,31,1,31,1
2013-14,2013-12-09,Washington Capitals,2,Metropolitan,Eastern,34,2,60,0.5666666666666667,31,3,31,3
2013-14,2013-12-11,Washington Capitals,2,Metropolitan,Eastern,36,2,62,0.5806451612903226,32,4,32,4
2013-14,2013-12-14,Washington Capitals,1,Metropolitan,Eastern,37,2,64,0.578125,33,4,33,4
2013-14,2013-12-15,Washington Capitals,2,Metropolitan,Eastern,39,2,66,0.5909090909090909,35,4,35,4
2013-14,2013-12-18,Washington Capitals,0,Metropolitan,Eastern,39,2,68,0.5735294117647058,35,4,35,4
2013-14,2013-12-21,Washington Capitals,2,Metropolitan,Eastern,41,2,70,0.5857142857142857,36,5,36,5
2013-14,2013-12-22,Washington Capitals,1,Metropolitan,Eastern,42,2,72,0.5833333333333334,37,5,37,5
2013-14,2013-12-24,Washington Capitals,0,Metropolitan,Eastern,42,2,74,0.5675675675675675,38,4,38,4
2013-14,2013-12-28,Washington Capitals,2,Metropolitan,Eastern,44,2,76,0.5789473684210527,38,6,38,6
2013-14,2013-12-29,Washington Capitals,1,Metropolitan,Eastern,45,2,78,0.5769230769230769,40,5,40,5
2013-14,2013-12-31,Washington Capitals,0,Metropolitan,Eastern,45,2,80,0.5625,42,3,42,3
2013-14,2014-01-03,Washington Capitals,1,Metropolitan,Eastern,46,2,82,0.5609756097560976,44,2,44,2
2013-14,2014-01-05,Washington Capitals,0,Metropolitan,Eastern,46,2,84,0.5476190476190477,46,0,46,0
2013-14,2014-01-10,Washington Capitals,2,Metropolitan,Eastern,48,2,86,0.5581395348837209,48,0,47,1
2013-14,2014-01-11,Washington Capitals,2,Metropolitan,Eastern,50,2,88,0.5681818181818182,50,0,48,2
2013-14,2014-01-12,Washington Capitals,1,Metropolitan,Eastern,51,2,90,0.5666666666666667,50,1,49,2
2013-14,2014-01-15,Washington Capitals,1,Metropolitan,Eastern,52,2,92,0.5652173913043478,52,0,51,1
2013-14,2014-01-16,Washington Capitals,0,Metropolitan,Eastern,52,2,94,0.5531914893617021,52,0,51,1
2013-14,2014-01-18,Washington Capitals,0,Metropolitan,Eastern,52,2,96,0.5416666666666666,53,-1,52,0
2013-14,2014-01-20,Washington Capitals,0,Metropolitan,Eastern,52,2,98,0.5306122448979592,56,-4,52,0
2013-14,2014-01-22,Washington Capitals,0,Metropolitan,Eastern,52,2,100,0.52,56,-4,54,-2
2013-14,2014-01-25,Washington Capitals,0,Metropolitan,Eastern,52,2,102,0.5098039215686274,56,-4,56,-4
2013-14,2014-01-26,Washington Capitals,2,Metropolitan,Eastern,54,2,104,0.5192307692307693,56,-2,56,-2
2013-14,2014-01-29,Washington Capitals,2,Metropolitan,Eastern,56,2,106,0.5283018867924528,58,-2,57,-1
2013-14,2014-01-31,Washington Capitals,0,Metropolitan,Eastern,56,2,108,0.5185185185185185,58,-2,58,-2
2013-14,2014-02-01,Washington Capitals,1,Metropolitan,Eastern,57,2,110,0.5181818181818182,60,-3,59,-2
2013-14,2014-02-02,Washington Capitals,2,Metropolitan,Eastern,59,2,112,0.5267857142857143,60,-1,60,-1
2013-14,2014-02-05,Washington Capitals,0,Metropolitan,Eastern,59,2,114,0.5175438596491229,62,-3,62,-3
2013-14,2014-02-07,Washington Capitals,2,Metropolitan,Eastern,61,2,116,0.5258620689655172,64,-3,64,-3
2013-14,2014-02-09,Washington Capitals,2,Metropolitan,Eastern,63,2,118,0.5338983050847458,66,-3,64,-1
2013-14,2014-02-28,Washington Capitals,2,Metropolitan,Eastern,65,2,120,0.5416666666666666,66,-1,66,-1
2013-14,2014-03-01,Washington Capitals,2,Metropolitan,Eastern,67,2,122,0.5491803278688525,68,-1,68,-1
2013-14,2014-03-02,Washington Capitals,1,Metropolitan,Eastern,68,2,124,0.5483870967741935,69,-1,68,0
2013-14,2014-03-06,Washington Capitals,0,Metropolitan,Eastern,68,2,126,0.5396825396825397,70,-2,69,-1
2013-14,2014-03-07,Washington Capitals,0,Metropolitan,Eastern,68,2,128,0.53125,70,-2,69,-1
2013-14,2014-03-09,Washington Capitals,2,Metropolitan,Eastern,70,2,130,0.5384615384615384,73,-3,71,-1
2013-14,2014-03-10,Washington Capitals,0,Metropolitan,Eastern,70,2,132,0.5303030303030303,73,-3,71,-1
2013-14,2014-03-11,Washington Capitals,0,Metropolitan,Eastern,70,2,134,0.5223880597014925,73,-3,73,-3
2013-14,2014-03-14,Washington Capitals,2,Metropolitan,Eastern,72,2,136,0.5294117647058824,74,-2,73,-1
2013-14,2014-03-16,Washington Capitals,2,Metropolitan,Eastern,74,2,138,0.5362318840579711,76,-2,76,-2
2013-14,2014-03-19,Washington Capitals,2,Metropolitan,Eastern,76,2,140,0.5428571428571428,78,-2,76,0
2013-14,2014-03-21,Washington Capitals,1,Metropolitan,Eastern,77,2,142,0.5422535211267606,80,-3,78,-1
2013-14,2014-03-23,Washington Capitals,2,Metropolitan,Eastern,79,2,144,0.5486111111111112,82,-3,80,-1
2013-14,2014-03-25,Washington Capitals,1,Metropolitan,Eastern,80,2,146,0.547945205479452,83,-3,80,0
2013-14,2014-03-29,Washington Capitals,0,Metropolitan,Eastern,80,2,148,0.5405405405405406,85,-5,82,-2
2013-14,2014-03-31,Washington Capitals,1,Metropolitan,Eastern,81,2,150,0.54,86,-5,82,-1
2013-14,2014-04-01,Washington Capitals,0,Metropolitan,Eastern,81,2,152,0.5328947368421053,86,-5,83,-2
2013-14,2014-04-04,Washington Capitals,0,Metropolitan,Eastern,81,2,154,0.525974025974026,87,-6,85,-4
2013-14,2014-04-05,Washington Capitals,2,Metropolitan,Eastern,83,2,156,0.532051282051282,87,-4,85,-2
2013-14,2014-04-09,Washington Capitals,2,Metropolitan,Eastern,85,2,158,0.5379746835443038,91,-6,89,-4
2013-14,2014-04-10,Washington Capitals,2,Metropolitan,Eastern,87,2,160,0.54375,91,-4,91,-4
2013-14,2014-04-11,Washington Capitals,2,Metropolitan,Eastern,89,2,162,0.5493827160493827,91,-2,91,-2
2013-14,2014-04-13,Washington Capitals,1,Metropolitan,Eastern,90,2,164,0.5487804878048781,94,-4,93,-3
2013-14,2013-10-02,Winnipeg Jets,2,Central,Western,2,2,2,1.0,0,2,0,2
2013-14,2013-10-05,Winnipeg Jets,2,Central,Western,4,2,4,1.0,2,2,2,2
2013-14,2013-10-07,Winnipeg Jets,0,Central,Western,4,2,6,0.6666666666666666,4,0,3,1
2013-14,2013-10-11,Winnipeg Jets,0,Central,Western,4,2,8,0.5,4,0,6,-2
2013-14,2013-10-12,Winnipeg Jets,0,Central,Western,4,2,10,0.4,5,-1,6,-2
2013-14,2013-10-14,Winnipeg Jets,2,Central,Western,6,2,12,0.5,8,-2,8,-2
2013-14,2013-10-16,Winnipeg Jets,0,Central,Western,6,2,14,0.42857142857142855,8,-2,8,-2
2013-14,2013-10-19,Winnipeg Jets,2,Central,Western,8,2,16,0.5,11,-3,10,-2
2013-14,2013-10-21,Winnipeg Jets,0,Central,Western,8,2,18,0.4444444444444444,11,-3,11,-3
2013-14,2013-10-23,Winnipeg Jets,1,Central,Western,9,2,20,0.45,11,-2,11,-2
2013-14,2013-10-25,Winnipeg Jets,1,Central,Western,10,2,22,0.45454545454545453,13,-3,13,-3
2013-14,2013-10-26,Winnipeg Jets,2,Central,Western,12,2,24,0.5,13,-1,13,-1
2013-14,2013-10-28,Winnipeg Jets,0,Central,Western,12,2,26,0.46153846153846156,15,-3,15,-3
2013-14,2013-10-30,Winnipeg Jets,0,Central,Western,12,2,28,0.42857142857142855,16,-4,16,-4
2013-14,2013-11-02,Winnipeg Jets,0,Central,Western,12,2,30,0.4,18,-6,18,-6
2013-14,2013-11-05,Winnipeg Jets,2,Central,Western,14,2,32,0.4375,19,-5,18,-4
2013-14,2013-11-07,Winnipeg Jets,0,Central,Western,14,2,34,0.4117647058823529,21,-7,20,-6
2013-14,2013-11-09,Winnipeg Jets,2,Central,Western,16,2,36,0.4444444444444444,22,-6,22,-6
2013-14,2013-11-11,Winnipeg Jets,2,Central,Western,18,2,38,0.47368421052631576,24,-6,24,-6
2013-14,2013-11-13,Winnipeg Jets,2,Central,Western,20,2,40,0.5,25,-5,24,-4
2013-14,2013-11-16,Winnipeg Jets,2,Central,Western,22,2,42,0.5238095238095238,28,-6,27,-5
2013-14,2013-11-18,Winnipeg Jets,0,Central,Western,22,2,44,0.5,28,-6,28,-6
2013-14,2013-11-19,Winnipeg Jets,1,Central,Western,23,2,46,0.5,28,-5,28,-5
2013-14,2013-11-22,Winnipeg Jets,0,Central,Western,23,2,48,0.4791666666666667,32,-9,32,-9
2013-14,2013-11-23,Winnipeg Jets,1,Central,Western,24,2,50,0.48,33,-9,32,-8
2013-14,2013-11-26,Winnipeg Jets,2,Central,Western,26,2,52,0.5,34,-8,32,-6
2013-14,2013-11-28,Winnipeg Jets,2,Central,Western,28,2,54,0.5185185185185185,34,-6,34,-6
2013-14,2013-11-29,Winnipeg Jets,0,Central,Western,28,2,56,0.5,36,-8,34,-6
2013-14,2013-12-03,Winnipeg Jets,2,Central,Western,30,2,58,0.5172413793103449,38,-8,34,-4
2013-14,2013-12-06,Winnipeg Jets,0,Central,Western,30,2,60,0.5,39,-9,36,-6
2013-14,2013-12-08,Winnipeg Jets,2,Central,Western,32,2,62,0.5161290322580645,41,-9,37,-5
2013-14,2013-12-11,Winnipeg Jets,0,Central,Western,32,2,64,0.5,41,-9,40,-8
2013-14,2013-12-13,Winnipeg Jets,1,Central,Western,33,2,66,0.5,42,-9,41,-8
2013-14,2013-12-14,Winnipeg Jets,0,Central,Western,33,2,68,0.4852941176470588,42,-9,41,-8
2013-14,2013-12-17,Winnipeg Jets,2,Central,Western,35,2,70,0.5,45,-10,43,-8
2013-14,2013-12-18,Winnipeg Jets,0,Central,Western,35,2,72,0.4861111111111111,45,-10,45,-10
2013-14,2013-12-21,Winnipeg Jets,2,Central,Western,37,2,74,0.5,48,-11,45,-8
2013-14,2013-12-23,Winnipeg Jets,0,Central,Western,37,2,76,0.4868421052631579,48,-11,45,-8
2013-14,2013-12-24,Winnipeg Jets,0,Central,Western,37,2,78,0.47435897435897434,49,-12,45,-8
2013-14,2013-12-28,Winnipeg Jets,2,Central,Western,39,2,80,0.4875,49,-10,46,-7
2013-14,2013-12-30,Winnipeg Jets,2,Central,Western,41,2,82,0.5,50,-9,47,-6
2013-14,2014-01-01,Winnipeg Jets,2,Central,Western,43,2,84,0.5119047619047619,52,-9,49,-6
2013-14,2014-01-03,Winnipeg Jets,0,Central,Western,43,2,86,0.5,54,-11,49,-6
2013-14,2014-01-04,Winnipeg Jets,0,Central,Western,43,2,88,0.48863636363636365,56,-13,49,-6
2013-14,2014-01-05,Winnipeg Jets,0,Central,Western,43,2,90,0.4777777777777778,56,-13,49,-6
2013-14,2014-01-08,Winnipeg Jets,0,Central,Western,43,2,92,0.4673913043478261,56,-13,51,-8
2013-14,2014-01-12,Winnipeg Jets,0,Central,Western,43,2,94,0.4574468085106383,61,-18,53,-10
2013-14,2014-01-14,Winnipeg Jets,2,Central,Western,45,2,96,0.46875,61,-16,55,-10
2013-14,2014-01-17,Winnipeg Jets,2,Central,Western,47,2,98,0.47959183673469385,65,-18,57,-10
2013-14,2014-01-18,Winnipeg Jets,2,Central,Western,49,2,100,0.49,65,-16,57,-8
2013-14,2014-01-22,Winnipeg Jets,2,Central,Western,51,2,102,0.5,67,-16,59,-8
2013-14,2014-01-24,Winnipeg Jets,0,Central,Western,51,2,104,0.49038461538461536,67,-16,61,-10
2013-14,2014-01-26,Winnipeg Jets,2,Central,Western,53,2,106,0.5,69,-16,61,-8
2013-14,2014-01-27,Winnipeg Jets,2,Central,Western,55,2,108,0.5092592592592593,69,-14,62,-7
2013-14,2014-01-29,Winnipeg Jets,0,Central,Western,55,2,110,0.5,71,-16,63,-8
2013-14,2014-02-01,Winnipeg Jets,2,Central,Western,57,2,112,0.5089285714285714,75,-18,63,-6
2013-14,2014-02-02,Winnipeg Jets,2,Central,Western,59,2,114,0.5175438596491229,75,-16,63,-4
2013-14,2014-02-05,Winnipeg Jets,2,Central,Western,61,2,116,0.5258620689655172,77,-16,63,-2
2013-14,2014-02-07,Winnipeg Jets,0,Central,Western,61,2,118,0.5169491525423728,77,-16,63,-2
2013-14,2014-02-08,Winnipeg Jets,1,Central,Western,62,2,120,0.5166666666666667,77,-15,64,-2
2013-14,2014-02-28,Winnipeg Jets,2,Central,Western,64,2,122,0.5245901639344263,79,-15,66,-2
2013-14,2014-03-01,Winnipeg Jets,2,Central,Western,66,2,124,0.532258064516129,81,-15,66,0
2013-14,2014-03-05,Winnipeg Jets,1,Central,Western,67,2,126,0.5317460317460317,85,-18,68,-1
2013-14,2014-03-07,Winnipeg Jets,0,Central,Western,67,2,128,0.5234375,87,-20,70,-3
2013-14,2014-03-08,Winnipeg Jets,0,Central,Western,67,2,130,0.5153846153846153,87,-20,70,-3
2013-14,2014-03-11,Winnipeg Jets,1,Central,Western,68,2,132,0.5151515151515151,89,-21,73,-5
2013-14,2014-03-12,Winnipeg Jets,1,Central,Western,69,2,134,0.5149253731343284,89,-20,74,-5
2013-14,2014-03-15,Winnipeg Jets,0,Central,Western,69,2,136,0.5073529411764706,90,-21,75,-6
2013-14,2014-03-17,Winnipeg Jets,2,Central,Western,71,2,138,0.5144927536231884,92,-21,75,-4
2013-14,2014-03-18,Winnipeg Jets,0,Central,Western,71,2,140,0.5071428571428571,93,-22,77,-6
2013-14,2014-03-20,Winnipeg Jets,2,Central,Western,73,2,142,0.5140845070422535,94,-21,77,-4
2013-14,2014-03-22,Winnipeg Jets,0,Central,Western,73,2,144,0.5069444444444444,94,-21,79,-6
2013-14,2014-03-25,Winnipeg Jets,0,Central,Western,73,2,146,0.5,94,-21,82,-9
2013-14,2014-03-28,Winnipeg Jets,2,Central,Western,75,2,148,0.5067567567567568,98,-23,84,-9
2013-14,2014-03-30,Winnipeg Jets,0,Central,Western,75,2,150,0.5,99,-24,84,-9
2013-14,2014-04-01,Winnipeg Jets,1,Central,Western,76,2,152,0.5,99,-23,85,-9
2013-14,2014-04-02,Winnipeg Jets,2,Central,Western,78,2,154,0.5064935064935064,99,-21,85,-7
2013-14,2014-04-04,Winnipeg Jets,0,Central,Western,78,2,156,0.5,103,-25,85,-7
2013-14,2014-04-05,Winnipeg Jets,2,Central,Western,80,2,158,0.5063291139240507,101,-21,87,-7
2013-14,2014-04-08,Winnipeg Jets,0,Central,Western,80,2,160,0.5,105,-25,87,-7
2013-14,2014-04-11,Winnipeg Jets,2,Central,Western,82,2,162,0.5061728395061729,107,-25,89,-7
2013-14,2014-04-12,Winnipeg Jets,2,Central,Western,84,2,164,0.5121951219512195,107,-23,91,-7
2014-15,2014-10-09,Anaheim Ducks,0,Pacific,Western,0,2,2,0.0,0,0,0,0
2014-15,2014-10-11,Anaheim Ducks,2,Pacific,Western,2,2,4,0.5,2,0,2,0
2014-15,2014-10-13,Anaheim Ducks,2,Pacific,Western,4,2,6,0.6666666666666666,4,0,2,2
2014-15,2014-10-14,Anaheim Ducks,2,Pacific,Western,6,2,8,0.75,4,2,3,3
2014-15,2014-10-18,Anaheim Ducks,2,Pacific,Western,8,2,10,0.8,7,1,5,3
2014-15,2014-10-20,Anaheim Ducks,2,Pacific,Western,10,2,12,0.8333333333333334,9,1,6,4
2014-15,2014-10-23,Anaheim Ducks,2,Pacific,Western,12,2,14,0.8571428571428571,9,3,6,6
2014-15,2014-10-25,Anaheim Ducks,2,Pacific,Western,14,2,16,0.875,11,3,8,6
2014-15,2014-10-27,Anaheim Ducks,0,Pacific,Western,14,2,18,0.7777777777777778,11,3,10,4
2014-15,2014-10-29,Anaheim Ducks,2,Pacific,Western,16,2,20,0.8,13,3,11,5
2014-15,2014-10-31,Anaheim Ducks,0,Pacific,Western,16,2,22,0.7272727272727273,14,2,12,4
2014-15,2014-11-01,Anaheim Ducks,2,Pacific,Western,18,2,24,0.75,14,4,12,6
2014-15,2014-11-03,Anaheim Ducks,2,Pacific,Western,20,2,26,0.7692307692307693,16,4,13,7
2014-15,2014-11-06,Anaheim Ducks,1,Pacific,Western,21,2,28,0.75,18,3,15,6
2014-15,2014-11-08,Anaheim Ducks,1,Pacific,Western,22,2,30,0.7333333333333333,20,2,16,6
2014-15,2014-11-10,Anaheim Ducks,1,Pacific,Western,23,2,32,0.71875,20,3,18,5
2014-15,2014-11-13,Anaheim Ducks,2,Pacific,Western,25,2,34,0.7352941176470589,20,5,18,7
2014-15,2014-11-15,Anaheim Ducks,1,Pacific,Western,26,2,36,0.7222222222222222,22,4,20,6
2014-15,2014-11-17,Anaheim Ducks,0,Pacific,Western,26,2,38,0.6842105263157895,24,2,21,5
2014-15,2014-11-19,Anaheim Ducks,1,Pacific,Western,27,2,40,0.675,24,3,22,5
2014-15,2014-11-21,Anaheim Ducks,2,Pacific,Western,29,2,42,0.6904761904761905,26,3,23,6
2014-15,2014-11-24,Anaheim Ducks,2,Pacific,Western,31,2,44,0.7045454545454546,28,3,24,7
2014-15,2014-11-26,Anaheim Ducks,2,Pacific,Western,33,2,46,0.717391304347826,28,5,25,8
2014-15,2014-11-28,Anaheim Ducks,0,Pacific,Western,33,2,48,0.6875,30,3,27,6
2014-15,2014-11-30,Anaheim Ducks,0,Pacific,Western,33,2,50,0.66,32,1,28,5
2014-15,2014-12-02,Anaheim Ducks,2,Pacific,Western,35,2,52,0.6730769230769231,32,3,28,7
2014-15,2014-12-04,Anaheim Ducks,2,Pacific,Western,37,2,54,0.6851851851851852,34,3,30,7
2014-15,2014-12-06,Anaheim Ducks,2,Pacific,Western,39,2,56,0.6964285714285714,36,3,32,7
2014-15,2014-12-07,Anaheim Ducks,2,Pacific,Western,41,2,58,0.7068965517241379,36,5,33,8
2014-15,2014-12-11,Anaheim Ducks,2,Pacific,Western,43,2,60,0.7166666666666667,36,7,34,9
2014-15,2014-12-13,Anaheim Ducks,2,Pacific,Western,45,2,62,0.7258064516129032,36,9,36,9
2014-15,2014-12-14,Anaheim Ducks,2,Pacific,Western,47,2,64,0.734375,38,9,36,11
2014-15,2014-12-17,Anaheim Ducks,0,Pacific,Western,47,2,66,0.7121212121212122,38,9,36,11
2014-15,2014-12-19,Anaheim Ducks,2,Pacific,Western,49,2,68,0.7205882352941176,38,11,38,11
2014-15,2014-12-20,Anaheim Ducks,0,Pacific,Western,49,2,70,0.7,40,9,38,11
2014-15,2014-12-23,Anaheim Ducks,2,Pacific,Western,51,2,72,0.7083333333333334,42,9,41,10
2014-15,2014-12-28,Anaheim Ducks,1,Pacific,Western,52,2,74,0.7027027027027027,43,9,42,10
2014-15,2014-12-29,Anaheim Ducks,2,Pacific,Western,54,2,76,0.7105263157894737,43,11,43,11
2014-15,2015-01-01,Anaheim Ducks,0,Pacific,Western,54,2,78,0.6923076923076923,45,9,45,9
2014-15,2015-01-03,Anaheim Ducks,2,Pacific,Western,56,2,80,0.7,45,11,45,11
2014-15,2015-01-05,Anaheim Ducks,2,Pacific,Western,58,2,82,0.7073170731707317,47,11,45,13
2014-15,2015-01-08,Anaheim Ducks,0,Pacific,Western,58,2,84,0.6904761904761905,49,9,47,11
2014-15,2015-01-12,Anaheim Ducks,2,Pacific,Western,60,2,86,0.6976744186046512,49,11,48,12
2014-15,2015-01-15,Anaheim Ducks,2,Pacific,Western,62,2,88,0.7045454545454546,50,12,49,13
2014-15,2015-01-17,Anaheim Ducks,2,Pacific,Western,64,2,90,0.7111111111111111,53,11,50,14
2014-15,2015-01-18,Anaheim Ducks,2,Pacific,Western,66,2,92,0.717391304347826,53,13,51,15
2014-15,2015-01-22,Anaheim Ducks,2,Pacific,Western,68,2,94,0.723404255319149,55,13,53,15
2014-15,2015-01-28,Anaheim Ducks,2,Pacific,Western,70,2,96,0.7291666666666666,55,15,55,15
2014-15,2015-01-30,Anaheim Ducks,0,Pacific,Western,70,2,98,0.7142857142857143,55,15,55,15
2014-15,2015-01-31,Anaheim Ducks,0,Pacific,Western,70,2,100,0.7,57,13,55,15
2014-15,2015-02-04,Anaheim Ducks,2,Pacific,Western,72,2,102,0.7058823529411765,59,13,59,13
2014-15,2015-02-06,Anaheim Ducks,2,Pacific,Western,74,2,104,0.7115384615384616,61,13,59,15
2014-15,2015-02-07,Anaheim Ducks,1,Pacific,Western,75,2,106,0.7075471698113207,61,14,59,16
2014-15,2015-02-08,Anaheim Ducks,0,Pacific,Western,75,2,108,0.6944444444444444,61,14,61,14
2014-15,2015-02-11,Anaheim Ducks,0,Pacific,Western,75,2,110,0.6818181818181818,63,12,61,14
2014-15,2015-02-13,Anaheim Ducks,2,Pacific,Western,77,2,112,0.6875,63,14,63,14
2014-15,2015-02-16,Anaheim Ducks,0,Pacific,Western,77,2,114,0.6754385964912281,65,12,65,12
2014-15,2015-02-19,Anaheim Ducks,0,Pacific,Western,77,2,116,0.6637931034482759,67,10,66,11
2014-15,2015-02-21,Anaheim Ducks,2,Pacific,Western,79,2,118,0.6694915254237288,68,11,68,11
2014-15,2015-02-22,Anaheim Ducks,2,Pacific,Western,81,2,120,0.675,68,13,68,13
2014-15,2015-02-24,Anaheim Ducks,2,Pacific,Western,83,2,122,0.680327868852459,68,15,68,15
2014-15,2015-02-26,Anaheim Ducks,0,Pacific,Western,83,2,124,0.6693548387096774,70,13,70,13
2014-15,2015-02-28,Anaheim Ducks,2,Pacific,Western,85,2,126,0.6746031746031746,70,15,70,15
2014-15,2015-03-02,Anaheim Ducks,2,Pacific,Western,87,2,128,0.6796875,70,17,70,17
2014-15,2015-03-04,Anaheim Ducks,2,Pacific,Western,89,2,130,0.6846153846153846,72,17,72,17
2014-15,2015-03-05,Anaheim Ducks,2,Pacific,Western,91,2,132,0.6893939393939394,72,19,72,19
2014-15,2015-03-07,Anaheim Ducks,0,Pacific,Western,91,2,134,0.6791044776119403,76,15,76,15
2014-15,2015-03-10,Anaheim Ducks,0,Pacific,Western,91,2,136,0.6691176470588235,77,14,77,14
2014-15,2015-03-12,Anaheim Ducks,0,Pacific,Western,91,2,138,0.6594202898550725,79,12,78,13
2014-15,2015-03-14,Anaheim Ducks,2,Pacific,Western,93,2,140,0.6642857142857143,81,12,80,13
2014-15,2015-03-16,Anaheim Ducks,2,Pacific,Western,95,2,142,0.6690140845070423,81,14,80,15
2014-15,2015-03-19,Anaheim Ducks,2,Pacific,Western,97,2,144,0.6736111111111112,82,15,82,15
2014-15,2015-03-21,Anaheim Ducks,2,Pacific,Western,99,2,146,0.678082191780822,84,15,84,15
2014-15,2015-03-22,Anaheim Ducks,0,Pacific,Western,99,2,148,0.668918918918919,84,15,84,15
2014-15,2015-03-24,Anaheim Ducks,0,Pacific,Western,99,2,150,0.66,86,13,86,13
2014-15,2015-03-26,Anaheim Ducks,2,Pacific,Western,101,2,152,0.6644736842105263,88,13,88,13
2014-15,2015-03-28,Anaheim Ducks,2,Pacific,Western,103,2,154,0.6688311688311688,88,15,88,15
2014-15,2015-03-29,Anaheim Ducks,2,Pacific,Western,105,2,156,0.6730769230769231,89,16,89,16
2014-15,2015-04-02,Anaheim Ducks,2,Pacific,Western,107,2,158,0.6772151898734177,91,16,90,17
2014-15,2015-04-04,Anaheim Ducks,0,Pacific,Western,107,2,160,0.66875,91,16,91,16
2014-15,2015-04-09,Anaheim Ducks,0,Pacific,Western,107,2,162,0.6604938271604939,95,12,95,12
2014-15,2015-04-12,Anaheim Ducks,2,Pacific,Western,109,2,164,0.6646341463414634,97,12,97,12
2014-15,2014-10-10,Arizona Coyotes,0,Pacific,Western,0,2,2,0.0,2,-2,1,-1
2014-15,2014-10-12,Arizona Coyotes,2,Pacific,Western,2,2,4,0.5,2,0,2,0
2014-15,2014-10-16,Arizona Coyotes,2,Pacific,Western,4,2,6,0.6666666666666666,6,-2,4,0
2014-15,2014-10-19,Arizona Coyotes,0,Pacific,Western,4,2,8,0.5,8,-4,6,-2
2014-15,2014-10-22,Arizona Coyotes,1,Pacific,Western,5,2,10,0.5,9,-4,6,-1
2014-15,2014-10-24,Arizona Coyotes,0,Pacific,Western,5,2,12,0.4166666666666667,11,-6,8,-3
2014-15,2014-10-26,Arizona Coyotes,2,Pacific,Western,7,2,14,0.5,11,-4,8,-1
2014-15,2014-10-28,Arizona Coyotes,0,Pacific,Western,7,2,16,0.4375,11,-4,10,-3
2014-15,2014-10-30,Arizona Coyotes,0,Pacific,Western,7,2,18,0.3888888888888889,13,-6,11,-4
2014-15,2014-11-01,Arizona Coyotes,0,Pacific,Western,7,2,20,0.35,14,-7,12,-5
2014-15,2014-11-03,Arizona Coyotes,2,Pacific,Western,9,2,22,0.4090909090909091,16,-7,13,-4
2014-15,2014-11-05,Arizona Coyotes,2,Pacific,Western,11,2,24,0.4583333333333333,18,-7,15,-4
2014-15,2014-11-08,Arizona Coyotes,2,Pacific,Western,13,2,26,0.5,20,-7,16,-3
2014-15,2014-11-09,Arizona Coyotes,0,Pacific,Western,13,2,28,0.4642857142857143,20,-7,18,-5
2014-15,2014-11-12,Arizona Coyotes,0,Pacific,Western,13,2,30,0.43333333333333335,20,-7,18,-5
2014-15,2014-11-14,Arizona Coyotes,0,Pacific,Western,13,2,32,0.40625,22,-9,20,-7
2014-15,2014-11-15,Arizona Coyotes,2,Pacific,Western,15,2,34,0.4411764705882353,22,-7,20,-5
2014-15,2014-11-17,Arizona Coyotes,2,Pacific,Western,17,2,36,0.4722222222222222,24,-7,21,-4
2014-15,2014-11-19,Arizona Coyotes,1,Pacific,Western,18,2,38,0.47368421052631576,24,-6,22,-4
2014-15,2014-11-21,Arizona Coyotes,0,Pacific,Western,18,2,40,0.45,26,-8,23,-5
2014-15,2014-11-23,Arizona Coyotes,2,Pacific,Western,20,2,42,0.47619047619047616,27,-7,24,-4
2014-15,2014-11-24,Arizona Coyotes,0,Pacific,Western,20,2,44,0.45454545454545453,28,-8,24,-4
2014-15,2014-11-26,Arizona Coyotes,1,Pacific,Western,21,2,46,0.45652173913043476,28,-7,25,-4
2014-15,2014-11-30,Arizona Coyotes,0,Pacific,Western,21,2,48,0.4375,32,-11,28,-7
2014-15,2014-12-02,Arizona Coyotes,2,Pacific,Western,23,2,50,0.46,32,-9,28,-5
2014-15,2014-12-03,Arizona Coyotes,0,Pacific,Western,23,2,52,0.4423076923076923,34,-11,28,-5
2014-15,2014-12-05,Arizona Coyotes,0,Pacific,Western,23,2,54,0.42592592592592593,36,-13,30,-7
2014-15,2014-12-07,Arizona Coyotes,0,Pacific,Western,23,2,56,0.4107142857142857,36,-13,33,-10
2014-15,2014-12-12,Arizona Coyotes,0,Pacific,Western,23,2,58,0.39655172413793105,36,-13,36,-13
2014-15,2014-12-14,Arizona Coyotes,1,Pacific,Western,24,2,60,0.4,38,-14,36,-12
2014-15,2014-12-17,Arizona Coyotes,2,Pacific,Western,26,2,62,0.41935483870967744,38,-12,36,-10
2014-15,2014-12-20,Arizona Coyotes,0,Pacific,Western,26,2,64,0.40625,40,-14,38,-12
2014-15,2014-12-23,Arizona Coyotes,0,Pacific,Western,26,2,66,0.3939393939393939,42,-16,41,-15
2014-15,2014-12-24,Arizona Coyotes,2,Pacific,Western,28,2,68,0.4117647058823529,42,-14,41,-13
2014-15,2014-12-28,Arizona Coyotes,2,Pacific,Western,30,2,70,0.42857142857142855,43,-13,42,-12
2014-15,2014-12-30,Arizona Coyotes,2,Pacific,Western,32,2,72,0.4444444444444444,43,-11,43,-11
2014-15,2015-01-01,Arizona Coyotes,0,Pacific,Western,32,2,74,0.43243243243243246,45,-13,45,-13
2014-15,2015-01-04,Arizona Coyotes,2,Pacific,Western,34,2,76,0.4473684210526316,47,-13,45,-11
2014-15,2015-01-07,Arizona Coyotes,0,Pacific,Western,34,2,78,0.4358974358974359,49,-15,47,-13
2014-15,2015-01-09,Arizona Coyotes,2,Pacific,Western,36,2,80,0.45,49,-13,47,-11
2014-15,2015-01-11,Arizona Coyotes,0,Pacific,Western,36,2,82,0.43902439024390244,49,-13,48,-12
2014-15,2015-01-14,Arizona Coyotes,0,Pacific,Western,36,2,84,0.42857142857142855,50,-14,49,-13
2014-15,2015-01-16,Arizona Coyotes,0,Pacific,Western,36,2,86,0.4186046511627907,51,-15,50,-14
2014-15,2015-01-18,Arizona Coyotes,0,Pacific,Western,36,2,88,0.4090909090909091,53,-17,51,-15
2014-15,2015-01-19,Arizona Coyotes,1,Pacific,Western,37,2,90,0.4111111111111111,53,-16,51,-14
2014-15,2015-01-21,Arizona Coyotes,0,Pacific,Western,37,2,92,0.40217391304347827,54,-17,53,-16
2014-15,2015-01-28,Arizona Coyotes,1,Pacific,Western,38,2,94,0.40425531914893614,55,-17,55,-17
2014-15,2015-01-30,Arizona Coyotes,2,Pacific,Western,40,2,96,0.4166666666666667,55,-15,55,-15
2014-15,2015-01-31,Arizona Coyotes,0,Pacific,Western,40,2,98,0.40816326530612246,57,-17,55,-15
2014-15,2015-02-01,Arizona Coyotes,2,Pacific,Western,42,2,100,0.42,57,-15,57,-15
2014-15,2015-02-04,Arizona Coyotes,2,Pacific,Western,44,2,102,0.43137254901960786,59,-15,59,-15
2014-15,2015-02-06,Arizona Coyotes,1,Pacific,Western,45,2,104,0.4326923076923077,61,-16,59,-14
2014-15,2015-02-08,Arizona Coyotes,0,Pacific,Western,45,2,106,0.42452830188679247,61,-16,61,-16
2014-15,2015-02-10,Arizona Coyotes,2,Pacific,Western,47,2,108,0.4351851851851852,63,-16,61,-14
2014-15,2015-02-11,Arizona Coyotes,0,Pacific,Western,47,2,110,0.42727272727272725,63,-16,61,-14
2014-15,2015-02-14,Arizona Coyotes,0,Pacific,Western,47,2,112,0.41964285714285715,65,-18,63,-16
2014-15,2015-02-15,Arizona Coyotes,0,Pacific,Western,47,2,114,0.41228070175438597,65,-18,65,-18
2014-15,2015-02-17,Arizona Coyotes,0,Pacific,Western,47,2,116,0.4051724137931034,67,-20,66,-19
2014-15,2015-02-22,Arizona Coyotes,0,Pacific,Western,47,2,118,0.3983050847457627,68,-21,68,-21
2014-15,2015-02-24,Arizona Coyotes,0,Pacific,Western,47,2,120,0.39166666666666666,68,-21,68,-21
2014-15,2015-02-25,Arizona Coyotes,0,Pacific,Western,47,2,122,0.38524590163934425,70,-23,69,-22
2014-15,2015-02-27,Arizona Coyotes,0,Pacific,Western,47,2,124,0.3790322580645161,70,-23,70,-23
2014-15,2015-02-28,Arizona Coyotes,0,Pacific,Western,47,2,126,0.373015873015873,70,-23,70,-23
2014-15,2015-03-04,Arizona Coyotes,0,Pacific,Western,47,2,128,0.3671875,72,-25,72,-25
2014-15,2015-03-06,Arizona Coyotes,2,Pacific,Western,49,2,130,0.3769230769230769,74,-25,74,-25
2014-15,2015-03-08,Arizona Coyotes,0,Pacific,Western,49,2,132,0.3712121212121212,77,-28,77,-28
2014-15,2015-03-10,Arizona Coyotes,1,Pacific,Western,50,2,134,0.373134328358209,77,-27,77,-27
2014-15,2015-03-13,Arizona Coyotes,0,Pacific,Western,50,2,136,0.36764705882352944,79,-29,79,-29
2014-15,2015-03-15,Arizona Coyotes,0,Pacific,Western,50,2,138,0.36231884057971014,81,-31,80,-30
2014-15,2015-03-17,Arizona Coyotes,0,Pacific,Western,50,2,140,0.35714285714285715,81,-31,81,-31
2014-15,2015-03-20,Arizona Coyotes,0,Pacific,Western,50,2,142,0.352112676056338,83,-33,83,-33
2014-15,2015-03-22,Arizona Coyotes,0,Pacific,Western,50,2,144,0.3472222222222222,84,-34,84,-34
2014-15,2015-03-23,Arizona Coyotes,0,Pacific,Western,50,2,146,0.3424657534246575,84,-34,84,-34
2014-15,2015-03-24,Arizona Coyotes,2,Pacific,Western,52,2,148,0.35135135135135137,86,-34,86,-34
2014-15,2015-03-26,Arizona Coyotes,2,Pacific,Western,54,2,150,0.36,88,-34,88,-34
2014-15,2015-03-28,Arizona Coyotes,0,Pacific,Western,54,2,152,0.35526315789473684,88,-34,88,-34
2014-15,2015-03-31,Arizona Coyotes,0,Pacific,Western,54,2,154,0.35064935064935066,91,-37,90,-36
2014-15,2015-04-04,Arizona Coyotes,0,Pacific,Western,54,2,156,0.34615384615384615,91,-37,91,-37
2014-15,2015-04-05,Arizona Coyotes,2,Pacific,Western,56,2,158,0.35443037974683544,93,-37,92,-36
2014-15,2015-04-08,Arizona Coyotes,0,Pacific,Western,56,2,160,0.35,95,-39,95,-39
2014-15,2015-04-10,Arizona Coyotes,0,Pacific,Western,56,2,162,0.345679012345679,97,-41,97,-41
2014-15,2015-04-12,Arizona Coyotes,0,Pacific,Western,56,2,164,0.34146341463414637,97,-41,97,-41
2014-15,2014-10-08,Boston Bruins,2,Atlantic,Eastern,2,2,2,1.0,0,2,0,2
2014-15,2014-10-09,Boston Bruins,0,Atlantic,Eastern,2,2,4,0.5,2,0,1,1
2014-15,2014-10-11,Boston Bruins,0,Atlantic,Eastern,2,2,6,0.3333333333333333,2,0,2,0
2014-15,2014-10-13,Boston Bruins,0,Atlantic,Eastern,2,2,8,0.25,4,-2,3,-1
2014-15,2014-10-16,Boston Bruins,2,Atlantic,Eastern,4,2,10,0.4,5,-1,4,0
2014-15,2014-10-16,Boston Bruins,0,Atlantic,Eastern,4,2,12,0.3333333333333333,5,-1,4,0
2014-15,2014-10-18,Boston Bruins,2,Atlantic,Eastern,6,2,14,0.42857142857142855,7,-1,6,0
2014-15,2014-10-21,Boston Bruins,2,Atlantic,Eastern,8,2,16,0.5,8,0,7,1
2014-15,2014-10-23,Boston Bruins,0,Atlantic,Eastern,8,2,18,0.4444444444444444,9,-1,8,0
2014-15,2014-10-25,Boston Bruins,2,Atlantic,Eastern,10,2,20,0.5,10,0,8,2
2014-15,2014-10-28,Boston Bruins,0,Atlantic,Eastern,10,2,22,0.45454545454545453,11,-1,10,0
2014-15,2014-10-30,Boston Bruins,2,Atlantic,Eastern,12,2,24,0.5,12,0,12,0
2014-15,2014-11-01,Boston Bruins,2,Atlantic,Eastern,14,2,26,0.5384615384615384,14,0,12,2
2014-15,2014-11-05,Boston Bruins,2,Atlantic,Eastern,16,2,28,0.5714285714285714,16,0,13,3
2014-15,2014-11-07,Boston Bruins,2,Atlantic,Eastern,18,2,30,0.6,18,0,14,4
2014-15,2014-11-11,Boston Bruins,2,Atlantic,Eastern,20,2,32,0.625,20,0,16,4
2014-15,2014-11-13,Boston Bruins,0,Atlantic,Eastern,20,2,34,0.5882352941176471,20,0,18,2
2014-15,2014-11-14,Boston Bruins,0,Atlantic,Eastern,20,2,36,0.5555555555555556,20,0,19,1
2014-15,2014-11-15,Boston Bruins,2,Atlantic,Eastern,22,2,38,0.5789473684210527,22,0,20,2
2014-15,2014-11-19,Boston Bruins,2,Atlantic,Eastern,24,2,40,0.6,24,0,20,4
2014-15,2014-11-22,Boston Bruins,2,Atlantic,Eastern,26,2,42,0.6190476190476191,26,0,22,4
2014-15,2014-11-23,Boston Bruins,0,Atlantic,Eastern,26,2,44,0.5909090909090909,26,0,22,4
2014-15,2014-11-25,Boston Bruins,1,Atlantic,Eastern,27,2,46,0.5869565217391305,27,0,22,5
2014-15,2014-11-29,Boston Bruins,2,Atlantic,Eastern,29,2,48,0.6041666666666666,31,-2,25,4
2014-15,2014-12-02,Boston Bruins,0,Atlantic,Eastern,29,2,50,0.58,33,-4,26,3
2014-15,2014-12-03,Boston Bruins,0,Atlantic,Eastern,29,2,52,0.5576923076923077,33,-4,26,3
2014-15,2014-12-05,Boston Bruins,0,Atlantic,Eastern,29,2,54,0.5370370370370371,35,-6,27,2
2014-15,2014-12-07,Boston Bruins,2,Atlantic,Eastern,31,2,56,0.5535714285714286,36,-5,29,2
2014-15,2014-12-12,Boston Bruins,0,Atlantic,Eastern,31,2,58,0.5344827586206896,38,-7,31,0
2014-15,2014-12-13,Boston Bruins,1,Atlantic,Eastern,32,2,60,0.5333333333333333,40,-8,31,1
2014-15,2014-12-17,Boston Bruins,1,Atlantic,Eastern,33,2,62,0.532258064516129,42,-9,34,-1
2014-15,2014-12-18,Boston Bruins,2,Atlantic,Eastern,35,2,64,0.546875,42,-7,34,1
2014-15,2014-12-20,Boston Bruins,0,Atlantic,Eastern,35,2,66,0.5303030303030303,42,-7,36,-1
2014-15,2014-12-22,Boston Bruins,2,Atlantic,Eastern,37,2,68,0.5441176470588235,43,-6,38,-1
2014-15,2014-12-24,Boston Bruins,2,Atlantic,Eastern,39,2,70,0.5571428571428572,45,-6,40,-1
2014-15,2014-12-28,Boston Bruins,0,Atlantic,Eastern,39,2,72,0.5416666666666666,46,-7,42,-3
2014-15,2014-12-30,Boston Bruins,2,Atlantic,Eastern,41,2,74,0.5540540540540541,47,-6,42,-1
2014-15,2015-01-01,Boston Bruins,1,Atlantic,Eastern,42,2,76,0.5526315789473685,49,-7,44,-2
2014-15,2015-01-03,Boston Bruins,1,Atlantic,Eastern,43,2,78,0.5512820512820513,49,-6,44,-1
2014-15,2015-01-04,Boston Bruins,1,Atlantic,Eastern,44,2,80,0.55,49,-5,45,-1
2014-15,2015-01-08,Boston Bruins,2,Atlantic,Eastern,46,2,82,0.5609756097560976,53,-7,46,0
2014-15,2015-01-09,Boston Bruins,2,Atlantic,Eastern,48,2,84,0.5714285714285714,53,-5,48,0
2014-15,2015-01-10,Boston Bruins,2,Atlantic,Eastern,50,2,86,0.5813953488372093,53,-3,50,0
2014-15,2015-01-14,Boston Bruins,2,Atlantic,Eastern,52,2,88,0.5909090909090909,55,-3,52,0
2014-15,2015-01-16,Boston Bruins,2,Atlantic,Eastern,54,2,90,0.6,57,-3,52,2
2014-15,2015-01-18,Boston Bruins,0,Atlantic,Eastern,54,2,92,0.5869565217391305,59,-5,54,0
2014-15,2015-01-21,Boston Bruins,2,Atlantic,Eastern,56,2,94,0.5957446808510638,61,-5,56,0
2014-15,2015-01-22,Boston Bruins,1,Atlantic,Eastern,57,2,96,0.59375,61,-4,57,0
2014-15,2015-01-30,Boston Bruins,2,Atlantic,Eastern,59,2,98,0.6020408163265306,65,-6,58,1
2014-15,2015-02-01,Boston Bruins,2,Atlantic,Eastern,61,2,100,0.61,67,-6,60,1
2014-15,2015-02-05,Boston Bruins,0,Atlantic,Eastern,61,2,102,0.5980392156862745,67,-6,61,0
2014-15,2015-02-08,Boston Bruins,2,Atlantic,Eastern,63,2,104,0.6057692307692307,69,-6,63,0
2014-15,2015-02-09,Boston Bruins,0,Atlantic,Eastern,63,2,106,0.5943396226415094,71,-8,63,0
2014-15,2015-02-11,Boston Bruins,0,Atlantic,Eastern,63,2,108,0.5833333333333334,71,-8,63,0
2014-15,2015-02-14,Boston Bruins,0,Atlantic,Eastern,63,2,110,0.5727272727272728,71,-8,63,0
2014-15,2015-02-17,Boston Bruins,1,Atlantic,Eastern,64,2,112,0.5714285714285714,72,-8,64,0
2014-15,2015-02-19,Boston Bruins,1,Atlantic,Eastern,65,2,114,0.5701754385964912,74,-9,65,0
2014-15,2015-02-21,Boston Bruins,0,Atlantic,Eastern,65,2,116,0.5603448275862069,74,-9,65,0
2014-15,2015-02-22,Boston Bruins,2,Atlantic,Eastern,67,2,118,0.5677966101694916,76,-9,67,0
2014-15,2015-02-25,Boston Bruins,0,Atlantic,Eastern,67,2,120,0.5583333333333333,77,-10,67,0
2014-15,2015-02-28,Boston Bruins,2,Atlantic,Eastern,69,2,122,0.5655737704918032,81,-12,69,0
2014-15,2015-02-28,Boston Bruins,2,Atlantic,Eastern,71,2,124,0.5725806451612904,81,-10,69,2
2014-15,2015-03-06,Boston Bruins,1,Atlantic,Eastern,72,2,126,0.5714285714285714,83,-11,72,0
2014-15,2015-03-07,Boston Bruins,2,Atlantic,Eastern,74,2,128,0.578125,83,-9,74,0
2014-15,2015-03-08,Boston Bruins,2,Atlantic,Eastern,76,2,130,0.5846153846153846,83,-7,76,0
2014-15,2015-03-10,Boston Bruins,2,Atlantic,Eastern,78,2,132,0.5909090909090909,85,-7,78,0
2014-15,2015-03-12,Boston Bruins,2,Atlantic,Eastern,80,2,134,0.5970149253731343,85,-5,80,0
2014-15,2015-03-14,Boston Bruins,2,Atlantic,Eastern,82,2,136,0.6029411764705882,85,-3,82,0
2014-15,2015-03-15,Boston Bruins,0,Atlantic,Eastern,82,2,138,0.5942028985507246,87,-5,82,0
2014-15,2015-03-17,Boston Bruins,1,Atlantic,Eastern,83,2,140,0.5928571428571429,87,-4,83,0
2014-15,2015-03-19,Boston Bruins,0,Atlantic,Eastern,83,2,142,0.5845070422535211,87,-4,83,0
2014-15,2015-03-21,Boston Bruins,1,Atlantic,Eastern,84,2,144,0.5833333333333334,87,-3,84,0
2014-15,2015-03-22,Boston Bruins,0,Atlantic,Eastern,84,2,146,0.5753424657534246,89,-5,84,0
2014-15,2015-03-26,Boston Bruins,1,Atlantic,Eastern,85,2,148,0.5743243243243243,90,-5,85,0
2014-15,2015-03-28,Boston Bruins,2,Atlantic,Eastern,87,2,150,0.58,92,-5,87,0
2014-15,2015-03-29,Boston Bruins,2,Atlantic,Eastern,89,2,152,0.5855263157894737,92,-3,89,0
2014-15,2015-03-31,Boston Bruins,2,Atlantic,Eastern,91,2,154,0.5909090909090909,93,-2,91,0
2014-15,2015-04-02,Boston Bruins,2,Atlantic,Eastern,93,2,156,0.5961538461538461,93,0,93,0
2014-15,2015-04-04,Boston Bruins,2,Atlantic,Eastern,95,2,158,0.6012658227848101,95,0,95,0
2014-15,2015-04-09,Boston Bruins,0,Atlantic,Eastern,95,2,160,0.59375,98,-3,96,-1
2014-15,2015-04-09,Boston Bruins,0,Atlantic,Eastern,95,2,162,0.5864197530864198,98,-3,96,-1
2014-15,2015-04-11,Boston Bruins,1,Atlantic,Eastern,96,2,164,0.5853658536585366,100,-4,98,-2
2014-15,2014-10-09,Buffalo Sabres,0,Atlantic,Eastern,0,2,2,0.0,2,-2,1,-1
2014-15,2014-10-12,Buffalo Sabres,0,Atlantic,Eastern,0,2,4,0.0,2,-2,2,-2
2014-15,2014-10-13,Buffalo Sabres,0,Atlantic,Eastern,0,2,6,0.0,4,-4,3,-3
2014-15,2014-10-14,Buffalo Sabres,2,Atlantic,Eastern,2,2,8,0.25,4,-2,4,-2
2014-15,2014-10-17,Buffalo Sabres,0,Atlantic,Eastern,2,2,10,0.2,5,-3,5,-3
2014-15,2014-10-18,Buffalo Sabres,0,Atlantic,Eastern,2,2,12,0.16666666666666666,7,-5,6,-4
2014-15,2014-10-23,Buffalo Sabres,0,Atlantic,Eastern,2,2,14,0.14285714285714285,9,-7,8,-6
2014-15,2014-10-24,Buffalo Sabres,0,Atlantic,Eastern,2,2,16,0.125,9,-7,8,-6
2014-15,2014-10-25,Buffalo Sabres,2,Atlantic,Eastern,4,2,18,0.2222222222222222,10,-6,8,-4
2014-15,2014-10-28,Buffalo Sabres,0,Atlantic,Eastern,4,2,20,0.2,11,-7,10,-6
2014-15,2014-10-30,Buffalo Sabres,1,Atlantic,Eastern,5,2,22,0.22727272727272727,12,-7,12,-7
2014-15,2014-11-01,Buffalo Sabres,0,Atlantic,Eastern,5,2,24,0.20833333333333334,14,-9,12,-7
2014-15,2014-11-02,Buffalo Sabres,2,Atlantic,Eastern,7,2,26,0.2692307692307692,15,-8,12,-5
2014-15,2014-11-06,Buffalo Sabres,1,Atlantic,Eastern,8,2,28,0.2857142857142857,16,-8,14,-6
2014-15,2014-11-08,Buffalo Sabres,0,Atlantic,Eastern,8,2,30,0.26666666666666666,18,-10,14,-6
2014-15,2014-11-09,Buffalo Sabres,0,Atlantic,Eastern,8,2,32,0.25,19,-11,16,-8
2014-15,2014-11-12,Buffalo Sabres,0,Atlantic,Eastern,8,2,34,0.23529411764705882,20,-12,18,-10
2014-15,2014-11-14,Buffalo Sabres,0,Atlantic,Eastern,8,2,36,0.2222222222222222,20,-12,19,-11
2014-15,2014-11-16,Buffalo Sabres,2,Atlantic,Eastern,10,2,38,0.2631578947368421,22,-12,20,-10
2014-15,2014-11-19,Buffalo Sabres,2,Atlantic,Eastern,12,2,40,0.3,24,-12,20,-8
2014-15,2014-11-23,Buffalo Sabres,2,Atlantic,Eastern,14,2,42,0.3333333333333333,26,-12,22,-8
2014-15,2014-11-27,Buffalo Sabres,0,Atlantic,Eastern,14,2,44,0.3181818181818182,29,-15,24,-10
2014-15,2014-11-29,Buffalo Sabres,2,Atlantic,Eastern,16,2,46,0.34782608695652173,31,-15,25,-9
2014-15,2014-11-30,Buffalo Sabres,2,Atlantic,Eastern,18,2,48,0.375,33,-15,26,-8
2014-15,2014-12-03,Buffalo Sabres,2,Atlantic,Eastern,20,2,50,0.4,33,-13,26,-6
2014-15,2014-12-05,Buffalo Sabres,0,Atlantic,Eastern,20,2,52,0.38461538461538464,35,-15,27,-7
2014-15,2014-12-07,Buffalo Sabres,0,Atlantic,Eastern,20,2,54,0.37037037037037035,36,-16,29,-9
2014-15,2014-12-10,Buffalo Sabres,2,Atlantic,Eastern,22,2,56,0.39285714285714285,37,-15,30,-8
2014-15,2014-12-12,Buffalo Sabres,2,Atlantic,Eastern,24,2,58,0.41379310344827586,38,-14,31,-7
2014-15,2014-12-14,Buffalo Sabres,2,Atlantic,Eastern,26,2,60,0.43333333333333335,40,-14,32,-6
2014-15,2014-12-16,Buffalo Sabres,2,Atlantic,Eastern,28,2,62,0.45161290322580644,40,-12,32,-4
2014-15,2014-12-17,Buffalo Sabres,0,Atlantic,Eastern,28,2,64,0.4375,42,-14,34,-6
2014-15,2014-12-21,Buffalo Sabres,0,Atlantic,Eastern,28,2,66,0.42424242424242425,43,-15,36,-8
2014-15,2014-12-22,Buffalo Sabres,1,Atlantic,Eastern,29,2,68,0.4264705882352941,43,-14,38,-9
2014-15,2014-12-24,Buffalo Sabres,0,Atlantic,Eastern,29,2,70,0.4142857142857143,45,-16,40,-11
2014-15,2014-12-28,Buffalo Sabres,2,Atlantic,Eastern,31,2,72,0.4305555555555556,46,-15,42,-11
2014-15,2014-12-30,Buffalo Sabres,0,Atlantic,Eastern,31,2,74,0.4189189189189189,47,-16,42,-11
2014-15,2014-12-31,Buffalo Sabres,0,Atlantic,Eastern,31,2,76,0.40789473684210525,47,-16,43,-12
2014-15,2015-01-03,Buffalo Sabres,0,Atlantic,Eastern,31,2,78,0.3974358974358974,49,-18,44,-13
2014-15,2015-01-04,Buffalo Sabres,0,Atlantic,Eastern,31,2,80,0.3875,49,-18,45,-14
2014-15,2015-01-07,Buffalo Sabres,0,Atlantic,Eastern,31,2,82,0.3780487804878049,51,-20,45,-14
2014-15,2015-01-09,Buffalo Sabres,0,Atlantic,Eastern,31,2,84,0.36904761904761907,53,-22,48,-17
2014-15,2015-01-10,Buffalo Sabres,0,Atlantic,Eastern,31,2,86,0.36046511627906974,53,-22,50,-19
2014-15,2015-01-14,Buffalo Sabres,0,Atlantic,Eastern,31,2,88,0.3522727272727273,55,-24,52,-21
2014-15,2015-01-16,Buffalo Sabres,0,Atlantic,Eastern,31,2,90,0.34444444444444444,57,-26,52,-21
2014-15,2015-01-18,Buffalo Sabres,0,Atlantic,Eastern,31,2,92,0.33695652173913043,59,-28,54,-23
2014-15,2015-01-19,Buffalo Sabres,0,Atlantic,Eastern,31,2,94,0.32978723404255317,59,-28,54,-23
2014-15,2015-01-28,Buffalo Sabres,0,Atlantic,Eastern,31,2,96,0.3229166666666667,63,-32,57,-26
2014-15,2015-01-30,Buffalo Sabres,0,Atlantic,Eastern,31,2,98,0.3163265306122449,65,-34,58,-27
2014-15,2015-01-31,Buffalo Sabres,0,Atlantic,Eastern,31,2,100,0.31,66,-35,58,-27
2014-15,2015-02-04,Buffalo Sabres,2,Atlantic,Eastern,33,2,102,0.3235294117647059,67,-34,61,-28
2014-15,2015-02-06,Buffalo Sabres,0,Atlantic,Eastern,33,2,104,0.3173076923076923,67,-34,61,-28
2014-15,2015-02-08,Buffalo Sabres,0,Atlantic,Eastern,33,2,106,0.3113207547169811,69,-36,63,-30
2014-15,2015-02-08,Buffalo Sabres,2,Atlantic,Eastern,35,2,108,0.32407407407407407,69,-34,63,-28
2014-15,2015-02-11,Buffalo Sabres,0,Atlantic,Eastern,35,2,110,0.3181818181818182,71,-36,63,-28
2014-15,2015-02-16,Buffalo Sabres,0,Atlantic,Eastern,35,2,112,0.3125,72,-37,63,-28
2014-15,2015-02-18,Buffalo Sabres,1,Atlantic,Eastern,36,2,114,0.3157894736842105,72,-36,64,-28
2014-15,2015-02-20,Buffalo Sabres,2,Atlantic,Eastern,38,2,116,0.3275862068965517,74,-36,65,-27
2014-15,2015-02-21,Buffalo Sabres,0,Atlantic,Eastern,38,2,118,0.3220338983050847,74,-36,65,-27
2014-15,2015-02-22,Buffalo Sabres,1,Atlantic,Eastern,39,2,120,0.325,76,-37,67,-28
2014-15,2015-02-25,Buffalo Sabres,2,Atlantic,Eastern,41,2,122,0.3360655737704918,77,-36,67,-26
2014-15,2015-02-27,Buffalo Sabres,2,Atlantic,Eastern,43,2,124,0.3467741935483871,79,-36,67,-24
2014-15,2015-02-28,Buffalo Sabres,0,Atlantic,Eastern,43,2,126,0.3412698412698413,81,-38,69,-26
2014-15,2015-03-04,Buffalo Sabres,0,Atlantic,Eastern,43,2,128,0.3359375,81,-38,69,-26
2014-15,2015-03-07,Buffalo Sabres,0,Atlantic,Eastern,43,2,130,0.33076923076923076,83,-40,74,-31
2014-15,2015-03-08,Buffalo Sabres,0,Atlantic,Eastern,43,2,132,0.32575757575757575,83,-40,76,-33
2014-15,2015-03-11,Buffalo Sabres,1,Atlantic,Eastern,44,2,134,0.3283582089552239,85,-41,78,-34
2014-15,2015-03-14,Buffalo Sabres,0,Atlantic,Eastern,44,2,136,0.3235294117647059,85,-41,82,-38
2014-15,2015-03-16,Buffalo Sabres,1,Atlantic,Eastern,45,2,138,0.32608695652173914,87,-42,82,-37
2014-15,2015-03-17,Buffalo Sabres,2,Atlantic,Eastern,47,2,140,0.3357142857142857,87,-40,83,-36
2014-15,2015-03-20,Buffalo Sabres,0,Atlantic,Eastern,47,2,142,0.33098591549295775,87,-40,83,-36
2014-15,2015-03-22,Buffalo Sabres,0,Atlantic,Eastern,47,2,144,0.3263888888888889,89,-42,84,-37
2014-15,2015-03-24,Buffalo Sabres,0,Atlantic,Eastern,47,2,146,0.3219178082191781,90,-43,85,-38
2014-15,2015-03-26,Buffalo Sabres,1,Atlantic,Eastern,48,2,148,0.32432432432432434,90,-42,85,-37
2014-15,2015-03-29,Buffalo Sabres,0,Atlantic,Eastern,48,2,150,0.32,92,-44,89,-41
2014-15,2015-03-31,Buffalo Sabres,2,Atlantic,Eastern,50,2,152,0.32894736842105265,93,-43,91,-41
2014-15,2015-04-01,Buffalo Sabres,2,Atlantic,Eastern,52,2,154,0.33766233766233766,93,-41,91,-39
2014-15,2015-04-03,Buffalo Sabres,0,Atlantic,Eastern,52,2,156,0.3333333333333333,93,-41,93,-41
2014-15,2015-04-04,Buffalo Sabres,0,Atlantic,Eastern,52,2,158,0.3291139240506329,95,-43,95,-43
2014-15,2015-04-06,Buffalo Sabres,2,Atlantic,Eastern,54,2,160,0.3375,95,-41,95,-41
2014-15,2015-04-10,Buffalo Sabres,0,Atlantic,Eastern,54,2,162,0.3333333333333333,98,-44,96,-42
2014-15,2015-04-11,Buffalo Sabres,0,Atlantic,Eastern,54,2,164,0.32926829268292684,100,-46,98,-44
2014-15,2014-10-09,Calgary Flames,0,Pacific,Western,0,2,2,0.0,0,0,0,0
2014-15,2014-10-10,Calgary Flames,2,Pacific,Western,2,2,4,0.5,2,0,1,1
2014-15,2014-10-11,Calgary Flames,0,Pacific,Western,2,2,6,0.3333333333333333,2,0,2,0
2014-15,2014-10-15,Calgary Flames,2,Pacific,Western,4,2,8,0.5,5,-1,4,0
2014-15,2014-10-16,Calgary Flames,2,Pacific,Western,6,2,10,0.6,6,0,4,2
2014-15,2014-10-17,Calgary Flames,0,Pacific,Western,6,2,12,0.5,6,0,4,2
2014-15,2014-10-19,Calgary Flames,2,Pacific,Western,8,2,14,0.5714285714285714,8,0,6,2
2014-15,2014-10-22,Calgary Flames,1,Pacific,Western,9,2,16,0.5625,9,0,6,3
2014-15,2014-10-24,Calgary Flames,2,Pacific,Western,11,2,18,0.6111111111111112,11,0,8,3
2014-15,2014-10-26,Calgary Flames,0,Pacific,Western,11,2,20,0.55,11,0,8,3
2014-15,2014-10-29,Calgary Flames,1,Pacific,Western,12,2,22,0.5454545454545454,13,-1,11,1
2014-15,2014-11-01,Calgary Flames,2,Pacific,Western,14,2,24,0.5833333333333334,14,0,12,2
2014-15,2014-11-03,Calgary Flames,2,Pacific,Western,16,2,26,0.6153846153846154,16,0,13,3
2014-15,2014-11-05,Calgary Flames,2,Pacific,Western,18,2,28,0.6428571428571429,18,0,15,3
2014-15,2014-11-07,Calgary Flames,0,Pacific,Western,18,2,30,0.6,18,0,16,2
2014-15,2014-11-08,Calgary Flames,2,Pacific,Western,20,2,32,0.625,20,0,16,4
2014-15,2014-11-11,Calgary Flames,0,Pacific,Western,20,2,34,0.5882352941176471,20,0,18,2
2014-15,2014-11-14,Calgary Flames,2,Pacific,Western,22,2,36,0.6111111111111112,22,0,20,2
2014-15,2014-11-16,Calgary Flames,2,Pacific,Western,24,2,38,0.631578947368421,24,0,21,3
2014-15,2014-11-19,Calgary Flames,2,Pacific,Western,26,2,40,0.65,24,2,22,4
2014-15,2014-11-21,Calgary Flames,0,Pacific,Western,26,2,42,0.6190476190476191,26,0,23,3
2014-15,2014-11-23,Calgary Flames,2,Pacific,Western,28,2,44,0.6363636363636364,27,1,24,4
2014-15,2014-11-26,Calgary Flames,0,Pacific,Western,28,2,46,0.6086956521739131,28,0,25,3
2014-15,2014-11-27,Calgary Flames,2,Pacific,Western,30,2,48,0.625,30,0,27,3
2014-15,2014-11-30,Calgary Flames,2,Pacific,Western,32,2,50,0.64,32,0,28,4
2014-15,2014-12-03,Calgary Flames,2,Pacific,Western,34,2,52,0.6538461538461539,34,0,28,6
2014-15,2014-12-05,Calgary Flames,2,Pacific,Western,36,2,54,0.6666666666666666,36,0,30,6
2014-15,2014-12-07,Calgary Flames,0,Pacific,Western,36,2,56,0.6428571428571429,36,0,33,3
2014-15,2014-12-10,Calgary Flames,0,Pacific,Western,36,2,58,0.6206896551724138,36,0,34,2
2014-15,2014-12-12,Calgary Flames,0,Pacific,Western,36,2,60,0.6,36,0,36,0
2014-15,2014-12-13,Calgary Flames,0,Pacific,Western,36,2,62,0.5806451612903226,36,0,36,0
2014-15,2014-12-15,Calgary Flames,0,Pacific,Western,36,2,64,0.5625,38,-2,36,0
2014-15,2014-12-17,Calgary Flames,0,Pacific,Western,36,2,66,0.5454545454545454,38,-2,36,0
2014-15,2014-12-20,Calgary Flames,0,Pacific,Western,36,2,68,0.5294117647058824,40,-4,38,-2
2014-15,2014-12-21,Calgary Flames,1,Pacific,Western,37,2,70,0.5285714285714286,40,-3,40,-3
2014-15,2014-12-23,Calgary Flames,2,Pacific,Western,39,2,72,0.5416666666666666,42,-3,41,-2
2014-15,2014-12-28,Calgary Flames,2,Pacific,Western,41,2,74,0.5540540540540541,43,-2,42,-1
2014-15,2014-12-30,Calgary Flames,2,Pacific,Western,43,2,76,0.5657894736842105,43,0,43,0
2014-15,2015-01-01,Calgary Flames,2,Pacific,Western,45,2,78,0.5769230769230769,45,0,45,0
2014-15,2015-01-03,Calgary Flames,0,Pacific,Western,45,2,80,0.5625,45,0,45,0
2014-15,2015-01-08,Calgary Flames,0,Pacific,Western,45,2,82,0.5487804878048781,49,-4,47,-2
2014-15,2015-01-10,Calgary Flames,0,Pacific,Western,45,2,84,0.5357142857142857,49,-4,47,-2
2014-15,2015-01-11,Calgary Flames,2,Pacific,Western,47,2,86,0.5465116279069767,49,-2,48,-1
2014-15,2015-01-16,Calgary Flames,2,Pacific,Western,49,2,88,0.5568181818181818,51,-2,50,-1
2014-15,2015-01-18,Calgary Flames,2,Pacific,Western,51,2,90,0.5666666666666667,53,-2,51,0
2014-15,2015-01-20,Calgary Flames,2,Pacific,Western,53,2,92,0.5760869565217391,54,-1,53,0
2014-15,2015-01-22,Calgary Flames,0,Pacific,Western,53,2,94,0.5638297872340425,55,-2,53,0
2014-15,2015-01-28,Calgary Flames,2,Pacific,Western,55,2,96,0.5729166666666666,55,0,55,0
2014-15,2015-01-30,Calgary Flames,0,Pacific,Western,55,2,98,0.5612244897959183,55,0,55,0
2014-15,2015-02-01,Calgary Flames,2,Pacific,Western,57,2,100,0.57,57,0,57,0
2014-15,2015-02-03,Calgary Flames,2,Pacific,Western,59,2,102,0.5784313725490197,59,0,57,2
2014-15,2015-02-05,Calgary Flames,2,Pacific,Western,61,2,104,0.5865384615384616,61,0,59,2
2014-15,2015-02-07,Calgary Flames,0,Pacific,Western,61,2,106,0.5754716981132075,61,0,59,2
2014-15,2015-02-10,Calgary Flames,2,Pacific,Western,63,2,108,0.5833333333333334,63,0,61,2
2014-15,2015-02-13,Calgary Flames,0,Pacific,Western,63,2,110,0.5727272727272728,63,0,63,0
2014-15,2015-02-15,Calgary Flames,2,Pacific,Western,65,2,112,0.5803571428571429,65,0,65,0
2014-15,2015-02-17,Calgary Flames,2,Pacific,Western,67,2,114,0.5877192982456141,67,0,66,1
2014-15,2015-02-19,Calgary Flames,1,Pacific,Western,68,2,116,0.5862068965517241,67,1,66,2
2014-15,2015-02-21,Calgary Flames,0,Pacific,Western,68,2,118,0.576271186440678,68,0,68,0
2014-15,2015-02-25,Calgary Flames,0,Pacific,Western,68,2,120,0.5666666666666667,70,-2,69,-1
2014-15,2015-02-26,Calgary Flames,2,Pacific,Western,70,2,122,0.5737704918032787,70,0,70,0
2014-15,2015-02-28,Calgary Flames,0,Pacific,Western,70,2,124,0.5645161290322581,70,0,70,0
2014-15,2015-03-04,Calgary Flames,2,Pacific,Western,72,2,126,0.5714285714285714,72,0,72,0
2014-15,2015-03-06,Calgary Flames,2,Pacific,Western,74,2,128,0.578125,74,0,74,0
2014-15,2015-03-07,Calgary Flames,2,Pacific,Western,76,2,130,0.5846153846153846,76,0,76,0
2014-15,2015-03-08,Calgary Flames,1,Pacific,Western,77,2,132,0.5833333333333334,77,0,77,0
2014-15,2015-03-12,Calgary Flames,2,Pacific,Western,79,2,134,0.5895522388059702,79,0,78,1
2014-15,2015-03-14,Calgary Flames,2,Pacific,Western,81,2,136,0.5955882352941176,81,0,80,1
2014-15,2015-03-15,Calgary Flames,0,Pacific,Western,81,2,138,0.5869565217391305,81,0,80,1
2014-15,2015-03-18,Calgary Flames,0,Pacific,Western,81,2,140,0.5785714285714286,81,0,81,0
2014-15,2015-03-20,Calgary Flames,2,Pacific,Western,83,2,142,0.5845070422535211,83,0,83,0
2014-15,2015-03-21,Calgary Flames,1,Pacific,Western,84,2,144,0.5833333333333334,84,0,84,0
2014-15,2015-03-24,Calgary Flames,2,Pacific,Western,86,2,146,0.589041095890411,86,0,86,0
2014-15,2015-03-26,Calgary Flames,1,Pacific,Western,87,2,148,0.5878378378378378,88,-1,88,-1
2014-15,2015-03-28,Calgary Flames,0,Pacific,Western,87,2,150,0.58,88,-1,88,-1
2014-15,2015-03-29,Calgary Flames,2,Pacific,Western,89,2,152,0.5855263157894737,89,0,89,0
2014-15,2015-03-31,Calgary Flames,2,Pacific,Western,91,2,154,0.5909090909090909,91,0,90,1
2014-15,2015-04-03,Calgary Flames,0,Pacific,Western,91,2,156,0.5833333333333334,91,0,90,1
2014-15,2015-04-05,Calgary Flames,2,Pacific,Western,93,2,158,0.5886075949367089,93,0,92,1
2014-15,2015-04-08,Calgary Flames,2,Pacific,Western,95,2,160,0.59375,95,0,95,0
2014-15,2015-04-10,Calgary Flames,2,Pacific,Western,97,2,162,0.5987654320987654,97,0,97,0
2014-15,2015-04-11,Calgary Flames,0,Pacific,Western,97,2,164,0.5914634146341463,97,0,97,0
2014-15,2014-10-10,Carolina Hurricanes,0,Metropolitan,Eastern,0,2,2,0.0,2,-2,2,-2
2014-15,2014-10-11,Carolina Hurricanes,0,Metropolitan,Eastern,0,2,4,0.0,4,-4,2,-2
2014-15,2014-10-14,Carolina Hurricanes,1,Metropolitan,Eastern,1,2,6,0.16666666666666666,4,-3,4,-3
2014-15,2014-10-16,Carolina Hurricanes,1,Metropolitan,Eastern,2,2,8,0.25,6,-4,4,-2
2014-15,2014-10-22,Carolina Hurricanes,0,Metropolitan,Eastern,2,2,10,0.2,8,-6,8,-6
2014-15,2014-10-24,Carolina Hurricanes,0,Metropolitan,Eastern,2,2,12,0.16666666666666666,8,-6,8,-6
2014-15,2014-10-25,Carolina Hurricanes,0,Metropolitan,Eastern,2,2,14,0.14285714285714285,8,-6,8,-6
2014-15,2014-10-29,Carolina Hurricanes,0,Metropolitan,Eastern,2,2,16,0.125,10,-8,10,-8
2014-15,2014-11-01,Carolina Hurricanes,2,Metropolitan,Eastern,4,2,18,0.2222222222222222,12,-8,12,-8
2014-15,2014-11-02,Carolina Hurricanes,2,Metropolitan,Eastern,6,2,20,0.3,12,-6,12,-6
2014-15,2014-11-05,Carolina Hurricanes,2,Metropolitan,Eastern,8,2,22,0.36363636363636365,12,-4,13,-5
2014-15,2014-11-08,Carolina Hurricanes,2,Metropolitan,Eastern,10,2,24,0.4166666666666667,14,-4,14,-4
2014-15,2014-11-09,Carolina Hurricanes,1,Metropolitan,Eastern,11,2,26,0.4230769230769231,16,-5,16,-5
2014-15,2014-11-11,Carolina Hurricanes,2,Metropolitan,Eastern,13,2,28,0.4642857142857143,16,-3,16,-3
2014-15,2014-11-14,Carolina Hurricanes,0,Metropolitan,Eastern,13,2,30,0.43333333333333335,17,-4,19,-6
2014-15,2014-11-15,Carolina Hurricanes,0,Metropolitan,Eastern,13,2,32,0.40625,18,-5,20,-7
2014-15,2014-11-16,Carolina Hurricanes,0,Metropolitan,Eastern,13,2,34,0.38235294117647056,18,-5,20,-7
2014-15,2014-11-19,Carolina Hurricanes,2,Metropolitan,Eastern,15,2,36,0.4166666666666667,19,-4,20,-5
2014-15,2014-11-21,Carolina Hurricanes,0,Metropolitan,Eastern,15,2,38,0.39473684210526316,21,-6,22,-7
2014-15,2014-11-23,Carolina Hurricanes,0,Metropolitan,Eastern,15,2,40,0.375,21,-6,22,-7
2014-15,2014-11-27,Carolina Hurricanes,0,Metropolitan,Eastern,15,2,42,0.35714285714285715,22,-7,24,-9
2014-15,2014-11-29,Carolina Hurricanes,2,Metropolitan,Eastern,17,2,44,0.38636363636363635,26,-9,25,-8
2014-15,2014-11-30,Carolina Hurricanes,0,Metropolitan,Eastern,17,2,46,0.3695652173913043,26,-9,26,-9
2014-15,2014-12-03,Carolina Hurricanes,2,Metropolitan,Eastern,19,2,48,0.3958333333333333,26,-7,26,-7
2014-15,2014-12-05,Carolina Hurricanes,0,Metropolitan,Eastern,19,2,50,0.38,26,-7,27,-8
2014-15,2014-12-07,Carolina Hurricanes,0,Metropolitan,Eastern,19,2,52,0.36538461538461536,28,-9,29,-10
2014-15,2014-12-09,Carolina Hurricanes,0,Metropolitan,Eastern,19,2,54,0.35185185185185186,28,-9,29,-10
2014-15,2014-12-12,Carolina Hurricanes,0,Metropolitan,Eastern,19,2,56,0.3392857142857143,31,-12,31,-12
2014-15,2014-12-13,Carolina Hurricanes,0,Metropolitan,Eastern,19,2,58,0.3275862068965517,31,-12,31,-12
2014-15,2014-12-17,Carolina Hurricanes,0,Metropolitan,Eastern,19,2,60,0.31666666666666665,34,-15,34,-15
2014-15,2014-12-19,Carolina Hurricanes,2,Metropolitan,Eastern,21,2,62,0.3387096774193548,36,-15,36,-15
2014-15,2014-12-21,Carolina Hurricanes,1,Metropolitan,Eastern,22,2,64,0.34375,38,-16,36,-14
2014-15,2014-12-22,Carolina Hurricanes,0,Metropolitan,Eastern,22,2,66,0.3333333333333333,38,-16,38,-16
2014-15,2014-12-24,Carolina Hurricanes,2,Metropolitan,Eastern,24,2,68,0.35294117647058826,40,-16,40,-16
2014-15,2014-12-28,Carolina Hurricanes,0,Metropolitan,Eastern,24,2,70,0.34285714285714286,42,-18,42,-18
2014-15,2014-12-30,Carolina Hurricanes,0,Metropolitan,Eastern,24,2,72,0.3333333333333333,43,-19,42,-18
2014-15,2015-01-01,Carolina Hurricanes,0,Metropolitan,Eastern,24,2,74,0.32432432432432434,45,-21,44,-20
2014-15,2015-01-03,Carolina Hurricanes,2,Metropolitan,Eastern,26,2,76,0.34210526315789475,45,-19,44,-18
2014-15,2015-01-04,Carolina Hurricanes,2,Metropolitan,Eastern,28,2,78,0.358974358974359,47,-19,45,-17
2014-15,2015-01-07,Carolina Hurricanes,0,Metropolitan,Eastern,28,2,80,0.35,47,-19,45,-17
2014-15,2015-01-09,Carolina Hurricanes,2,Metropolitan,Eastern,30,2,82,0.36585365853658536,50,-20,48,-18
2014-15,2015-01-11,Carolina Hurricanes,1,Metropolitan,Eastern,31,2,84,0.36904761904761907,52,-21,50,-19
2014-15,2015-01-14,Carolina Hurricanes,2,Metropolitan,Eastern,33,2,86,0.38372093023255816,54,-21,52,-19
2014-15,2015-01-17,Carolina Hurricanes,0,Metropolitan,Eastern,33,2,88,0.375,56,-23,54,-21
2014-15,2015-01-18,Carolina Hurricanes,2,Metropolitan,Eastern,35,2,90,0.3888888888888889,56,-21,54,-19
2014-15,2015-01-20,Carolina Hurricanes,2,Metropolitan,Eastern,37,2,92,0.40217391304347827,56,-19,54,-17
2014-15,2015-01-28,Carolina Hurricanes,2,Metropolitan,Eastern,39,2,94,0.4148936170212766,58,-19,57,-18
2014-15,2015-01-31,Carolina Hurricanes,1,Metropolitan,Eastern,40,2,96,0.4166666666666667,60,-20,58,-18
2014-15,2015-02-01,Carolina Hurricanes,0,Metropolitan,Eastern,40,2,98,0.40816326530612246,60,-20,60,-20
2014-15,2015-02-04,Carolina Hurricanes,1,Metropolitan,Eastern,41,2,100,0.41,62,-21,61,-20
2014-15,2015-02-06,Carolina Hurricanes,2,Metropolitan,Eastern,43,2,102,0.4215686274509804,64,-21,61,-18
2014-15,2015-02-08,Carolina Hurricanes,2,Metropolitan,Eastern,45,2,104,0.4326923076923077,66,-21,63,-18
2014-15,2015-02-13,Carolina Hurricanes,0,Metropolitan,Eastern,45,2,106,0.42452830188679247,69,-24,63,-18
2014-15,2015-02-15,Carolina Hurricanes,0,Metropolitan,Eastern,45,2,108,0.4166666666666667,71,-26,63,-18
2014-15,2015-02-17,Carolina Hurricanes,2,Metropolitan,Eastern,47,2,110,0.42727272727272725,73,-26,64,-17
2014-15,2015-02-18,Carolina Hurricanes,0,Metropolitan,Eastern,47,2,112,0.41964285714285715,73,-26,64,-17
2014-15,2015-02-21,Carolina Hurricanes,2,Metropolitan,Eastern,49,2,114,0.4298245614035088,76,-27,65,-16
2014-15,2015-02-22,Carolina Hurricanes,0,Metropolitan,Eastern,49,2,116,0.4224137931034483,76,-27,67,-18
2014-15,2015-02-25,Carolina Hurricanes,2,Metropolitan,Eastern,51,2,118,0.4322033898305085,76,-25,67,-16
2014-15,2015-02-28,Carolina Hurricanes,2,Metropolitan,Eastern,53,2,120,0.44166666666666665,79,-26,69,-16
2014-15,2015-02-28,Carolina Hurricanes,2,Metropolitan,Eastern,55,2,122,0.45081967213114754,79,-24,69,-14
2014-15,2015-03-03,Carolina Hurricanes,0,Metropolitan,Eastern,55,2,124,0.4435483870967742,81,-26,71,-16
2014-15,2015-03-07,Carolina Hurricanes,0,Metropolitan,Eastern,55,2,126,0.4365079365079365,83,-28,74,-19
2014-15,2015-03-08,Carolina Hurricanes,2,Metropolitan,Eastern,57,2,128,0.4453125,85,-28,76,-19
2014-15,2015-03-10,Carolina Hurricanes,1,Metropolitan,Eastern,58,2,130,0.4461538461538462,86,-28,78,-20
2014-15,2015-03-12,Carolina Hurricanes,0,Metropolitan,Eastern,58,2,132,0.4393939393939394,88,-30,80,-22
2014-15,2015-03-14,Carolina Hurricanes,0,Metropolitan,Eastern,58,2,134,0.43283582089552236,88,-30,82,-24
2014-15,2015-03-15,Carolina Hurricanes,2,Metropolitan,Eastern,60,2,136,0.4411764705882353,88,-28,82,-22
2014-15,2015-03-17,Carolina Hurricanes,1,Metropolitan,Eastern,61,2,138,0.4420289855072464,88,-27,83,-22
2014-15,2015-03-19,Carolina Hurricanes,0,Metropolitan,Eastern,61,2,140,0.4357142857142857,88,-27,83,-22
2014-15,2015-03-21,Carolina Hurricanes,1,Metropolitan,Eastern,62,2,142,0.43661971830985913,88,-26,84,-22
2014-15,2015-03-23,Carolina Hurricanes,0,Metropolitan,Eastern,62,2,144,0.4305555555555556,90,-28,85,-23
2014-15,2015-03-26,Carolina Hurricanes,2,Metropolitan,Eastern,64,2,146,0.4383561643835616,91,-27,85,-21
2014-15,2015-03-28,Carolina Hurricanes,2,Metropolitan,Eastern,66,2,148,0.44594594594594594,93,-27,87,-21
2014-15,2015-03-29,Carolina Hurricanes,1,Metropolitan,Eastern,67,2,150,0.44666666666666666,95,-28,89,-22
2014-15,2015-03-31,Carolina Hurricanes,0,Metropolitan,Eastern,67,2,152,0.4407894736842105,95,-28,91,-24
2014-15,2015-04-02,Carolina Hurricanes,0,Metropolitan,Eastern,67,2,154,0.43506493506493504,96,-29,93,-26
2014-15,2015-04-04,Carolina Hurricanes,2,Metropolitan,Eastern,69,2,156,0.4423076923076923,97,-28,95,-26
2014-15,2015-04-06,Carolina Hurricanes,0,Metropolitan,Eastern,69,2,158,0.43670886075949367,98,-29,95,-26
2014-15,2015-04-07,Carolina Hurricanes,0,Metropolitan,Eastern,69,2,160,0.43125,98,-29,95,-26
2014-15,2015-04-09,Carolina Hurricanes,2,Metropolitan,Eastern,71,2,162,0.4382716049382716,98,-27,96,-25
2014-15,2015-04-11,Carolina Hurricanes,0,Metropolitan,Eastern,71,2,164,0.4329268292682927,101,-30,98,-27
2014-15,2014-10-10,Chicago Blackhawks,2,Central,Western,2,2,2,1.0,2,0,1,1
2014-15,2014-10-12,Chicago Blackhawks,2,Central,Western,4,2,4,1.0,4,0,2,2
2014-15,2014-10-16,Chicago Blackhawks,1,Central,Western,5,2,6,0.8333333333333334,5,0,4,1
2014-15,2014-10-19,Chicago Blackhawks,2,Central,Western,7,2,8,0.875,6,1,6,1
2014-15,2014-10-22,Chicago Blackhawks,2,Central,Western,9,2,10,0.9,8,1,6,3
2014-15,2014-10-24,Chicago Blackhawks,0,Central,Western,9,2,12,0.75,9,0,8,1
2014-15,2014-10-26,Chicago Blackhawks,0,Central,Western,9,2,14,0.6428571428571429,9,0,8,1
2014-15,2014-10-26,Chicago Blackhawks,2,Central,Western,11,2,16,0.6875,9,2,8,3
2014-15,2014-10-29,Chicago Blackhawks,0,Central,Western,11,2,18,0.6111111111111112,11,0,11,0
2014-15,2014-10-30,Chicago Blackhawks,2,Central,Western,13,2,20,0.65,11,2,11,2
2014-15,2014-11-01,Chicago Blackhawks,0,Central,Western,13,2,22,0.5909090909090909,12,1,12,1
2014-15,2014-11-03,Chicago Blackhawks,0,Central,Western,13,2,24,0.5416666666666666,13,0,13,0
2014-15,2014-11-05,Chicago Blackhawks,2,Central,Western,15,2,26,0.5769230769230769,15,0,15,0
2014-15,2014-11-08,Chicago Blackhawks,0,Central,Western,15,2,28,0.5357142857142857,16,-1,16,-1
2014-15,2014-11-10,Chicago Blackhawks,2,Central,Western,17,2,30,0.5666666666666667,18,-1,18,-1
2014-15,2014-11-12,Chicago Blackhawks,2,Central,Western,19,2,32,0.59375,19,0,18,1
2014-15,2014-11-15,Chicago Blackhawks,0,Central,Western,19,2,34,0.5588235294117647,20,-1,20,-1
2014-15,2014-11-17,Chicago Blackhawks,2,Central,Western,21,2,36,0.5833333333333334,21,0,21,0
2014-15,2014-11-21,Chicago Blackhawks,2,Central,Western,23,2,38,0.6052631578947368,23,0,23,0
2014-15,2014-11-23,Chicago Blackhawks,2,Central,Western,25,2,40,0.625,25,0,24,1
2014-15,2014-11-24,Chicago Blackhawks,0,Central,Western,25,2,42,0.5952380952380952,25,0,24,1
2014-15,2014-11-27,Chicago Blackhawks,2,Central,Western,27,2,44,0.6136363636363636,27,0,27,0
2014-15,2014-11-28,Chicago Blackhawks,2,Central,Western,29,2,46,0.6304347826086957,29,0,27,2
2014-15,2014-11-30,Chicago Blackhawks,2,Central,Western,31,2,48,0.6458333333333334,31,0,28,3
2014-15,2014-12-04,Chicago Blackhawks,2,Central,Western,33,2,50,0.66,33,0,30,3
2014-15,2014-12-06,Chicago Blackhawks,2,Central,Western,35,2,52,0.6730769230769231,35,0,32,3
2014-15,2014-12-07,Chicago Blackhawks,2,Central,Western,37,2,54,0.6851851851851852,36,1,33,4
2014-15,2014-12-10,Chicago Blackhawks,2,Central,Western,39,2,56,0.6964285714285714,38,1,34,5
2014-15,2014-12-12,Chicago Blackhawks,2,Central,Western,41,2,58,0.7068965517241379,40,1,36,5
2014-15,2014-12-14,Chicago Blackhawks,0,Central,Western,41,2,60,0.6833333333333333,40,1,36,5
2014-15,2014-12-15,Chicago Blackhawks,2,Central,Western,43,2,62,0.6935483870967742,40,3,36,7
2014-15,2014-12-17,Chicago Blackhawks,2,Central,Western,45,2,64,0.703125,42,3,36,9
2014-15,2014-12-21,Chicago Blackhawks,1,Central,Western,46,2,66,0.696969696969697,44,2,40,6
2014-15,2014-12-22,Chicago Blackhawks,2,Central,Western,48,2,68,0.7058823529411765,44,4,40,8
2014-15,2014-12-24,Chicago Blackhawks,0,Central,Western,48,2,70,0.6857142857142857,45,3,41,7
2014-15,2014-12-28,Chicago Blackhawks,2,Central,Western,50,2,72,0.6944444444444444,45,5,42,8
2014-15,2014-12-30,Chicago Blackhawks,2,Central,Western,52,2,74,0.7027027027027027,47,5,43,9
2014-15,2015-01-01,Chicago Blackhawks,0,Central,Western,52,2,76,0.6842105263157895,47,5,45,7
2014-15,2015-01-05,Chicago Blackhawks,2,Central,Western,54,2,78,0.6923076923076923,49,5,45,9
2014-15,2015-01-07,Chicago Blackhawks,0,Central,Western,54,2,80,0.675,51,3,47,7
2014-15,2015-01-09,Chicago Blackhawks,2,Central,Western,56,2,82,0.6829268292682927,53,3,47,9
2014-15,2015-01-10,Chicago Blackhawks,0,Central,Western,56,2,84,0.6666666666666666,53,3,47,9
2014-15,2015-01-12,Chicago Blackhawks,2,Central,Western,58,2,86,0.6744186046511628,55,3,48,10
2014-15,2015-01-17,Chicago Blackhawks,0,Central,Western,58,2,88,0.6590909090909091,58,0,50,8
2014-15,2015-01-18,Chicago Blackhawks,0,Central,Western,58,2,90,0.6444444444444445,58,0,51,7
2014-15,2015-01-21,Chicago Blackhawks,2,Central,Western,60,2,92,0.6521739130434783,60,0,53,7
2014-15,2015-01-22,Chicago Blackhawks,2,Central,Western,62,2,94,0.6595744680851063,62,0,53,9
2014-15,2015-01-29,Chicago Blackhawks,0,Central,Western,62,2,96,0.6458333333333334,62,0,55,7
2014-15,2015-01-31,Chicago Blackhawks,2,Central,Western,64,2,98,0.6530612244897959,64,0,55,9
2014-15,2015-02-01,Chicago Blackhawks,0,Central,Western,64,2,100,0.64,64,0,57,7
2014-15,2015-02-04,Chicago Blackhawks,0,Central,Western,64,2,102,0.6274509803921569,64,0,59,5
2014-15,2015-02-07,Chicago Blackhawks,2,Central,Western,66,2,104,0.6346153846153846,66,0,59,7
2014-15,2015-02-08,Chicago Blackhawks,2,Central,Western,68,2,106,0.6415094339622641,68,0,61,7
2014-15,2015-02-10,Chicago Blackhawks,1,Central,Western,69,2,108,0.6388888888888888,69,0,61,8
2014-15,2015-02-12,Chicago Blackhawks,1,Central,Western,70,2,110,0.6363636363636364,70,0,63,7
2014-15,2015-02-14,Chicago Blackhawks,2,Central,Western,72,2,112,0.6428571428571429,72,0,63,9
2014-15,2015-02-15,Chicago Blackhawks,2,Central,Western,74,2,114,0.6491228070175439,74,0,65,9
2014-15,2015-02-19,Chicago Blackhawks,1,Central,Western,75,2,116,0.646551724137931,75,0,66,9
2014-15,2015-02-21,Chicago Blackhawks,0,Central,Western,75,2,118,0.635593220338983,75,0,68,7
2014-15,2015-02-22,Chicago Blackhawks,0,Central,Western,75,2,120,0.625,75,0,68,7
2014-15,2015-02-25,Chicago Blackhawks,2,Central,Western,77,2,122,0.6311475409836066,77,0,69,8
2014-15,2015-02-27,Chicago Blackhawks,2,Central,Western,79,2,124,0.6370967741935484,79,0,70,9
2014-15,2015-02-28,Chicago Blackhawks,0,Central,Western,79,2,126,0.626984126984127,79,0,70,9
2014-15,2015-03-03,Chicago Blackhawks,2,Central,Western,81,2,128,0.6328125,81,0,70,11
2014-15,2015-03-07,Chicago Blackhawks,2,Central,Western,83,2,130,0.6384615384615384,83,0,76,7
2014-15,2015-03-08,Chicago Blackhawks,1,Central,Western,84,2,132,0.6363636363636364,84,0,77,7
2014-15,2015-03-13,Chicago Blackhawks,2,Central,Western,86,2,134,0.6417910447761194,86,0,79,7
2014-15,2015-03-14,Chicago Blackhawks,2,Central,Western,88,2,136,0.6470588235294118,88,0,80,8
2014-15,2015-03-18,Chicago Blackhawks,2,Central,Western,90,2,138,0.6521739130434783,90,0,81,9
2014-15,2015-03-19,Chicago Blackhawks,2,Central,Western,92,2,140,0.6571428571428571,92,0,82,10
2014-15,2015-03-22,Chicago Blackhawks,0,Central,Western,92,2,142,0.647887323943662,92,0,84,8
2014-15,2015-03-23,Chicago Blackhawks,2,Central,Western,94,2,144,0.6527777777777778,94,0,84,10
2014-15,2015-03-26,Chicago Blackhawks,0,Central,Western,94,2,146,0.6438356164383562,94,0,88,6
2014-15,2015-03-28,Chicago Blackhawks,0,Central,Western,94,2,148,0.6351351351351351,94,0,88,6
2014-15,2015-03-29,Chicago Blackhawks,2,Central,Western,96,2,150,0.64,96,0,89,7
2014-15,2015-03-31,Chicago Blackhawks,2,Central,Western,98,2,152,0.6447368421052632,98,0,90,8
2014-15,2015-04-03,Chicago Blackhawks,2,Central,Western,100,2,154,0.6493506493506493,100,0,90,10
2014-15,2015-04-03,Chicago Blackhawks,2,Central,Western,102,2,156,0.6538461538461539,100,2,90,12
2014-15,2015-04-05,Chicago Blackhawks,0,Central,Western,102,2,158,0.6455696202531646,102,0,92,10
2014-15,2015-04-08,Chicago Blackhawks,0,Central,Western,102,2,160,0.6375,102,0,95,7
2014-15,2015-04-10,Chicago Blackhawks,0,Central,Western,102,2,162,0.6296296296296297,102,0,97,5
2014-15,2015-04-12,Chicago Blackhawks,0,Central,Western,102,2,164,0.6219512195121951,102,0,97,5
2014-15,2014-10-10,Colorado Avalanche,0,Central,Western,0,2,2,0.0,2,-2,1,-1
2014-15,2014-10-12,Colorado Avalanche,0,Central,Western,0,2,4,0.0,4,-4,2,-2
2014-15,2014-10-13,Colorado Avalanche,2,Central,Western,2,2,6,0.3333333333333333,4,-2,2,0
2014-15,2014-10-14,Colorado Avalanche,1,Central,Western,3,2,8,0.375,4,-1,3,0
2014-15,2014-10-16,Colorado Avalanche,0,Central,Western,3,2,10,0.3,5,-2,4,-1
2014-15,2014-10-18,Colorado Avalanche,0,Central,Western,3,2,12,0.25,5,-2,5,-2
2014-15,2014-10-22,Colorado Avalanche,1,Central,Western,4,2,14,0.2857142857142857,8,-4,6,-2
2014-15,2014-10-25,Colorado Avalanche,2,Central,Western,6,2,16,0.375,9,-3,8,-2
2014-15,2014-10-26,Colorado Avalanche,1,Central,Western,7,2,18,0.3888888888888889,9,-2,8,-1
2014-15,2014-10-29,Colorado Avalanche,1,Central,Western,8,2,20,0.4,11,-3,11,-3
2014-15,2014-10-31,Colorado Avalanche,2,Central,Western,10,2,22,0.45454545454545453,12,-2,12,-2
2014-15,2014-11-02,Colorado Avalanche,1,Central,Western,11,2,24,0.4583333333333333,13,-2,13,-2
2014-15,2014-11-03,Colorado Avalanche,0,Central,Western,11,2,26,0.4230769230769231,13,-2,13,-2
2014-15,2014-11-05,Colorado Avalanche,0,Central,Western,11,2,28,0.39285714285714285,15,-4,15,-4
2014-15,2014-11-07,Colorado Avalanche,2,Central,Western,13,2,30,0.43333333333333335,16,-3,16,-3
2014-15,2014-11-09,Colorado Avalanche,0,Central,Western,13,2,32,0.40625,18,-5,18,-5
2014-15,2014-11-12,Colorado Avalanche,0,Central,Western,13,2,34,0.38235294117647056,19,-6,18,-5
2014-15,2014-11-14,Colorado Avalanche,2,Central,Western,15,2,36,0.4166666666666667,20,-5,20,-5
2014-15,2014-11-16,Colorado Avalanche,2,Central,Western,17,2,38,0.4473684210526316,21,-4,21,-4
2014-15,2014-11-21,Colorado Avalanche,0,Central,Western,17,2,40,0.425,23,-6,23,-6
2014-15,2014-11-23,Colorado Avalanche,2,Central,Western,19,2,42,0.4523809523809524,25,-6,24,-5
2014-15,2014-11-26,Colorado Avalanche,2,Central,Western,21,2,44,0.4772727272727273,25,-4,25,-4
2014-15,2014-11-27,Colorado Avalanche,0,Central,Western,21,2,46,0.45652173913043476,27,-6,27,-6
2014-15,2014-11-30,Colorado Avalanche,2,Central,Western,23,2,48,0.4791666666666667,31,-8,28,-5
2014-15,2014-12-02,Colorado Avalanche,0,Central,Western,23,2,50,0.46,31,-8,28,-5
2014-15,2014-12-05,Colorado Avalanche,1,Central,Western,24,2,52,0.46153846153846156,33,-9,30,-6
2014-15,2014-12-06,Colorado Avalanche,0,Central,Western,24,2,54,0.4444444444444444,35,-11,32,-8
2014-15,2014-12-10,Colorado Avalanche,0,Central,Western,24,2,56,0.42857142857142855,38,-14,34,-10
2014-15,2014-12-12,Colorado Avalanche,2,Central,Western,26,2,58,0.4482758620689655,40,-14,36,-10
2014-15,2014-12-14,Colorado Avalanche,1,Central,Western,27,2,60,0.45,40,-13,36,-9
2014-15,2014-12-19,Colorado Avalanche,1,Central,Western,28,2,62,0.45161290322580644,42,-14,38,-10
2014-15,2014-12-21,Colorado Avalanche,2,Central,Western,30,2,64,0.46875,44,-14,40,-10
2014-15,2014-12-21,Colorado Avalanche,2,Central,Western,32,2,66,0.48484848484848486,44,-12,40,-8
2014-15,2014-12-24,Colorado Avalanche,2,Central,Western,34,2,68,0.5,45,-11,41,-7
2014-15,2014-12-28,Colorado Avalanche,0,Central,Western,34,2,70,0.4857142857142857,45,-11,42,-8
2014-15,2014-12-30,Colorado Avalanche,0,Central,Western,34,2,72,0.4722222222222222,47,-13,43,-9
2014-15,2015-01-01,Colorado Avalanche,2,Central,Western,36,2,74,0.4864864864864865,47,-11,45,-9
2014-15,2015-01-03,Colorado Avalanche,2,Central,Western,38,2,76,0.5,47,-9,45,-7
2014-15,2015-01-05,Colorado Avalanche,0,Central,Western,38,2,78,0.48717948717948717,49,-11,45,-7
2014-15,2015-01-07,Colorado Avalanche,2,Central,Western,40,2,80,0.5,51,-11,47,-7
2014-15,2015-01-09,Colorado Avalanche,2,Central,Western,42,2,82,0.5121951219512195,53,-11,47,-5
2014-15,2015-01-10,Colorado Avalanche,2,Central,Western,44,2,84,0.5238095238095238,53,-9,47,-3
2014-15,2015-01-13,Colorado Avalanche,0,Central,Western,44,2,86,0.5116279069767442,55,-11,49,-5
2014-15,2015-01-14,Colorado Avalanche,1,Central,Western,45,2,88,0.5113636363636364,57,-12,49,-4
2014-15,2015-01-16,Colorado Avalanche,2,Central,Western,47,2,90,0.5222222222222223,58,-11,50,-3
2014-15,2015-01-18,Colorado Avalanche,1,Central,Western,48,2,92,0.5217391304347826,58,-10,51,-3
2014-15,2015-01-20,Colorado Avalanche,0,Central,Western,48,2,94,0.5106382978723404,58,-10,53,-5
2014-15,2015-01-22,Colorado Avalanche,2,Central,Western,50,2,96,0.5208333333333334,62,-12,53,-3
2014-15,2015-01-28,Colorado Avalanche,1,Central,Western,51,2,98,0.5204081632653061,62,-11,55,-4
2014-15,2015-01-31,Colorado Avalanche,2,Central,Western,53,2,100,0.53,64,-11,55,-2
2014-15,2015-02-04,Colorado Avalanche,2,Central,Western,55,2,102,0.5392156862745098,64,-9,59,-4
2014-15,2015-02-06,Colorado Avalanche,0,Central,Western,55,2,104,0.5288461538461539,64,-9,59,-4
2014-15,2015-02-08,Colorado Avalanche,0,Central,Western,55,2,106,0.5188679245283019,68,-13,61,-6
2014-15,2015-02-08,Colorado Avalanche,0,Central,Western,55,2,108,0.5092592592592593,68,-13,61,-6
2014-15,2015-02-13,Colorado Avalanche,0,Central,Western,55,2,110,0.5,70,-15,63,-8
2014-15,2015-02-15,Colorado Avalanche,2,Central,Western,57,2,112,0.5089285714285714,74,-17,65,-8
2014-15,2015-02-17,Colorado Avalanche,2,Central,Western,59,2,114,0.5175438596491229,74,-15,66,-7
2014-15,2015-02-19,Colorado Avalanche,0,Central,Western,59,2,116,0.5086206896551724,75,-16,66,-7
2014-15,2015-02-21,Colorado Avalanche,2,Central,Western,61,2,118,0.5169491525423728,75,-14,68,-7
2014-15,2015-02-23,Colorado Avalanche,2,Central,Western,63,2,120,0.525,75,-12,68,-5
2014-15,2015-02-25,Colorado Avalanche,0,Central,Western,63,2,122,0.5163934426229508,77,-14,69,-6
2014-15,2015-02-28,Colorado Avalanche,2,Central,Western,65,2,124,0.5241935483870968,79,-14,70,-5
2014-15,2015-03-01,Colorado Avalanche,0,Central,Western,65,2,126,0.5158730158730159,79,-14,70,-5
2014-15,2015-03-05,Colorado Avalanche,2,Central,Western,67,2,128,0.5234375,81,-14,72,-5
2014-15,2015-03-08,Colorado Avalanche,2,Central,Western,69,2,130,0.5307692307692308,84,-15,77,-8
2014-15,2015-03-08,Colorado Avalanche,2,Central,Western,71,2,132,0.5378787878787878,84,-13,77,-6
2014-15,2015-03-11,Colorado Avalanche,0,Central,Western,71,2,134,0.5298507462686567,84,-13,77,-6
2014-15,2015-03-13,Colorado Avalanche,2,Central,Western,73,2,136,0.5367647058823529,86,-13,79,-6
2014-15,2015-03-15,Colorado Avalanche,2,Central,Western,75,2,138,0.5434782608695652,88,-13,80,-5
2014-15,2015-03-20,Colorado Avalanche,2,Central,Western,77,2,140,0.55,92,-15,83,-6
2014-15,2015-03-21,Colorado Avalanche,1,Central,Western,78,2,142,0.5492957746478874,92,-14,84,-6
2014-15,2015-03-24,Colorado Avalanche,0,Central,Western,78,2,144,0.5416666666666666,94,-16,86,-8
2014-15,2015-03-26,Colorado Avalanche,0,Central,Western,78,2,146,0.5342465753424658,94,-16,88,-10
2014-15,2015-03-27,Colorado Avalanche,2,Central,Western,80,2,148,0.5405405405405406,94,-14,88,-8
2014-15,2015-03-29,Colorado Avalanche,2,Central,Western,82,2,150,0.5466666666666666,96,-14,89,-7
2014-15,2015-03-31,Colorado Avalanche,0,Central,Western,82,2,152,0.5394736842105263,98,-16,90,-8
2014-15,2015-04-02,Colorado Avalanche,0,Central,Western,82,2,154,0.5324675324675324,98,-16,90,-8
2014-15,2015-04-04,Colorado Avalanche,2,Central,Western,84,2,156,0.5384615384615384,100,-16,91,-7
2014-15,2015-04-05,Colorado Avalanche,0,Central,Western,84,2,158,0.5316455696202531,102,-18,92,-8
2014-15,2015-04-08,Colorado Avalanche,2,Central,Western,86,2,160,0.5375,102,-16,95,-9
2014-15,2015-04-10,Colorado Avalanche,2,Central,Western,88,2,162,0.5432098765432098,102,-14,97,-9
2014-15,2015-04-12,Colorado Avalanche,2,Central,Western,90,2,164,0.5487804878048781,102,-12,97,-7
2014-15,2014-10-09,Columbus Blue Jackets,2,Metropolitan,Eastern,2,2,2,1.0,2,0,1,1
2014-15,2014-10-11,Columbus Blue Jackets,2,Metropolitan,Eastern,4,2,4,1.0,4,0,2,2
2014-15,2014-10-14,Columbus Blue Jackets,0,Metropolitan,Eastern,4,2,6,0.6666666666666666,4,0,4,0
2014-15,2014-10-17,Columbus Blue Jackets,2,Metropolitan,Eastern,6,2,8,0.75,6,0,5,1
2014-15,2014-10-18,Columbus Blue Jackets,0,Metropolitan,Eastern,6,2,10,0.6,6,0,6,0
2014-15,2014-10-24,Columbus Blue Jackets,2,Metropolitan,Eastern,8,2,12,0.6666666666666666,8,0,8,0
2014-15,2014-10-25,Columbus Blue Jackets,0,Metropolitan,Eastern,8,2,14,0.5714285714285714,8,0,8,0
2014-15,2014-10-26,Columbus Blue Jackets,0,Metropolitan,Eastern,8,2,16,0.5,10,-2,9,-1
2014-15,2014-10-28,Columbus Blue Jackets,0,Metropolitan,Eastern,8,2,18,0.4444444444444444,10,-2,10,-2
2014-15,2014-10-31,Columbus Blue Jackets,0,Metropolitan,Eastern,8,2,20,0.4,12,-4,12,-4
2014-15,2014-11-01,Columbus Blue Jackets,0,Metropolitan,Eastern,8,2,22,0.36363636363636365,12,-4,12,-4
2014-15,2014-11-05,Columbus Blue Jackets,0,Metropolitan,Eastern,8,2,24,0.3333333333333333,12,-4,13,-5
2014-15,2014-11-08,Columbus Blue Jackets,1,Metropolitan,Eastern,9,2,26,0.34615384615384615,14,-5,14,-5
2014-15,2014-11-09,Columbus Blue Jackets,0,Metropolitan,Eastern,9,2,28,0.32142857142857145,16,-7,16,-7
2014-15,2014-11-12,Columbus Blue Jackets,0,Metropolitan,Eastern,9,2,30,0.3,17,-8,18,-9
2014-15,2014-11-15,Columbus Blue Jackets,2,Metropolitan,Eastern,11,2,32,0.34375,18,-7,20,-9
2014-15,2014-11-16,Columbus Blue Jackets,2,Metropolitan,Eastern,13,2,34,0.38235294117647056,18,-5,20,-7
2014-15,2014-11-19,Columbus Blue Jackets,0,Metropolitan,Eastern,13,2,36,0.3611111111111111,19,-6,20,-7
2014-15,2014-11-22,Columbus Blue Jackets,1,Metropolitan,Eastern,14,2,38,0.3684210526315789,21,-7,22,-8
2014-15,2014-11-23,Columbus Blue Jackets,0,Metropolitan,Eastern,14,2,40,0.35,21,-7,22,-8
2014-15,2014-11-26,Columbus Blue Jackets,0,Metropolitan,Eastern,14,2,42,0.3333333333333333,22,-8,24,-10
2014-15,2014-11-29,Columbus Blue Jackets,0,Metropolitan,Eastern,14,2,44,0.3181818181818182,26,-12,25,-11
2014-15,2014-11-30,Columbus Blue Jackets,0,Metropolitan,Eastern,14,2,46,0.30434782608695654,26,-12,26,-12
2014-15,2014-12-02,Columbus Blue Jackets,2,Metropolitan,Eastern,16,2,48,0.3333333333333333,26,-10,26,-10
2014-15,2014-12-05,Columbus Blue Jackets,2,Metropolitan,Eastern,18,2,50,0.36,26,-8,27,-9
2014-15,2014-12-07,Columbus Blue Jackets,2,Metropolitan,Eastern,20,2,52,0.38461538461538464,28,-8,29,-9
2014-15,2014-12-10,Columbus Blue Jackets,2,Metropolitan,Eastern,22,2,54,0.4074074074074074,30,-8,30,-8
2014-15,2014-12-12,Columbus Blue Jackets,2,Metropolitan,Eastern,24,2,56,0.42857142857142855,31,-7,31,-7
2014-15,2014-12-14,Columbus Blue Jackets,2,Metropolitan,Eastern,26,2,58,0.4482758620689655,33,-7,32,-6
2014-15,2014-12-17,Columbus Blue Jackets,2,Metropolitan,Eastern,28,2,60,0.4666666666666667,34,-6,34,-6
2014-15,2014-12-19,Columbus Blue Jackets,1,Metropolitan,Eastern,29,2,62,0.46774193548387094,36,-7,36,-7
2014-15,2014-12-21,Columbus Blue Jackets,2,Metropolitan,Eastern,31,2,64,0.484375,38,-7,36,-5
2014-15,2014-12-23,Columbus Blue Jackets,0,Metropolitan,Eastern,31,2,66,0.4696969696969697,40,-9,38,-7
2014-15,2014-12-28,Columbus Blue Jackets,2,Metropolitan,Eastern,33,2,68,0.4852941176470588,42,-9,42,-9
2014-15,2015-01-01,Columbus Blue Jackets,2,Metropolitan,Eastern,35,2,70,0.5,45,-10,44,-9
2014-15,2015-01-04,Columbus Blue Jackets,0,Metropolitan,Eastern,35,2,72,0.4861111111111111,47,-12,45,-10
2014-15,2015-01-05,Columbus Blue Jackets,2,Metropolitan,Eastern,37,2,74,0.5,47,-10,45,-8
2014-15,2015-01-07,Columbus Blue Jackets,2,Metropolitan,Eastern,39,2,76,0.5131578947368421,47,-8,45,-6
2014-15,2015-01-10,Columbus Blue Jackets,0,Metropolitan,Eastern,39,2,78,0.5,50,-11,50,-11
2014-15,2015-01-11,Columbus Blue Jackets,0,Metropolitan,Eastern,39,2,80,0.4875,52,-13,50,-11
2014-15,2015-01-15,Columbus Blue Jackets,0,Metropolitan,Eastern,39,2,82,0.47560975609756095,56,-17,52,-13
2014-15,2015-01-17,Columbus Blue Jackets,0,Metropolitan,Eastern,39,2,84,0.4642857142857143,56,-17,54,-15
2014-15,2015-01-18,Columbus Blue Jackets,2,Metropolitan,Eastern,41,2,86,0.47674418604651164,56,-15,54,-13
2014-15,2015-01-20,Columbus Blue Jackets,2,Metropolitan,Eastern,43,2,88,0.48863636363636365,56,-13,54,-11
2014-15,2015-01-22,Columbus Blue Jackets,0,Metropolitan,Eastern,43,2,90,0.4777777777777778,58,-15,57,-14
2014-15,2015-01-28,Columbus Blue Jackets,2,Metropolitan,Eastern,45,2,92,0.4891304347826087,58,-13,57,-12
2014-15,2015-01-30,Columbus Blue Jackets,0,Metropolitan,Eastern,45,2,94,0.4787234042553192,59,-14,58,-13
2014-15,2015-02-01,Columbus Blue Jackets,0,Metropolitan,Eastern,45,2,96,0.46875,60,-15,60,-15
2014-15,2015-02-04,Columbus Blue Jackets,0,Metropolitan,Eastern,45,2,98,0.45918367346938777,62,-17,61,-16
2014-15,2015-02-07,Columbus Blue Jackets,2,Metropolitan,Eastern,47,2,100,0.47,66,-19,61,-14
2014-15,2015-02-08,Columbus Blue Jackets,2,Metropolitan,Eastern,49,2,102,0.4803921568627451,66,-17,63,-14
2014-15,2015-02-10,Columbus Blue Jackets,0,Metropolitan,Eastern,49,2,104,0.47115384615384615,66,-17,63,-14
2014-15,2015-02-14,Columbus Blue Jackets,2,Metropolitan,Eastern,51,2,106,0.4811320754716981,69,-18,63,-12
2014-15,2015-02-15,Columbus Blue Jackets,0,Metropolitan,Eastern,51,2,108,0.4722222222222222,71,-20,63,-12
2014-15,2015-02-18,Columbus Blue Jackets,2,Metropolitan,Eastern,53,2,110,0.4818181818181818,73,-20,64,-11
2014-15,2015-02-20,Columbus Blue Jackets,2,Metropolitan,Eastern,55,2,112,0.49107142857142855,74,-19,65,-10
2014-15,2015-02-22,Columbus Blue Jackets,0,Metropolitan,Eastern,55,2,114,0.4824561403508772,76,-21,67,-12
2014-15,2015-02-23,Columbus Blue Jackets,1,Metropolitan,Eastern,56,2,116,0.4827586206896552,77,-21,67,-11
2014-15,2015-02-25,Columbus Blue Jackets,0,Metropolitan,Eastern,56,2,118,0.4745762711864407,76,-20,67,-11
2014-15,2015-02-27,Columbus Blue Jackets,0,Metropolitan,Eastern,56,2,120,0.4666666666666667,79,-23,67,-11
2014-15,2015-02-28,Columbus Blue Jackets,0,Metropolitan,Eastern,56,2,122,0.45901639344262296,79,-23,69,-13
2014-15,2015-03-01,Columbus Blue Jackets,0,Metropolitan,Eastern,56,2,124,0.45161290322580644,81,-25,69,-13
2014-15,2015-03-04,Columbus Blue Jackets,0,Metropolitan,Eastern,56,2,126,0.4444444444444444,81,-25,69,-13
2014-15,2015-03-07,Columbus Blue Jackets,2,Metropolitan,Eastern,58,2,128,0.453125,83,-25,74,-16
2014-15,2015-03-08,Columbus Blue Jackets,0,Metropolitan,Eastern,58,2,130,0.4461538461538462,85,-27,76,-18
2014-15,2015-03-10,Columbus Blue Jackets,2,Metropolitan,Eastern,60,2,132,0.45454545454545453,86,-26,78,-18
2014-15,2015-03-12,Columbus Blue Jackets,2,Metropolitan,Eastern,62,2,134,0.4626865671641791,88,-26,80,-18
2014-15,2015-03-13,Columbus Blue Jackets,2,Metropolitan,Eastern,64,2,136,0.47058823529411764,88,-24,80,-16
2014-15,2015-03-15,Columbus Blue Jackets,0,Metropolitan,Eastern,64,2,138,0.463768115942029,88,-24,82,-18
2014-15,2015-03-19,Columbus Blue Jackets,2,Metropolitan,Eastern,66,2,140,0.4714285714285714,88,-22,83,-17
2014-15,2015-03-20,Columbus Blue Jackets,2,Metropolitan,Eastern,68,2,142,0.4788732394366197,88,-20,83,-15
2014-15,2015-03-21,Columbus Blue Jackets,2,Metropolitan,Eastern,70,2,144,0.4861111111111111,88,-18,84,-14
2014-15,2015-03-24,Columbus Blue Jackets,2,Metropolitan,Eastern,72,2,146,0.4931506849315068,91,-19,85,-13
2014-15,2015-03-28,Columbus Blue Jackets,2,Metropolitan,Eastern,74,2,148,0.5,93,-19,87,-13
2014-15,2015-03-29,Columbus Blue Jackets,2,Metropolitan,Eastern,76,2,150,0.5066666666666667,95,-19,89,-13
2014-15,2015-03-31,Columbus Blue Jackets,2,Metropolitan,Eastern,78,2,152,0.5131578947368421,95,-17,91,-13
2014-15,2015-04-02,Columbus Blue Jackets,2,Metropolitan,Eastern,80,2,154,0.5194805194805194,96,-16,93,-13
2014-15,2015-04-04,Columbus Blue Jackets,2,Metropolitan,Eastern,82,2,156,0.5256410256410257,97,-15,95,-13
2014-15,2015-04-06,Columbus Blue Jackets,1,Metropolitan,Eastern,83,2,158,0.5253164556962026,98,-15,95,-12
2014-15,2015-04-08,Columbus Blue Jackets,2,Metropolitan,Eastern,85,2,160,0.53125,98,-13,95,-10
2014-15,2015-04-10,Columbus Blue Jackets,2,Metropolitan,Eastern,87,2,162,0.5370370370370371,100,-13,96,-9
2014-15,2015-04-11,Columbus Blue Jackets,2,Metropolitan,Eastern,89,2,164,0.5426829268292683,101,-12,98,-9
2014-15,2014-10-10,Dallas Stars,1,Central,Western,1,2,2,0.5,2,-1,1,0
2014-15,2014-10-12,Dallas Stars,0,Central,Western,1,2,4,0.25,4,-3,2,-1
2014-15,2014-10-14,Dallas Stars,2,Central,Western,3,2,6,0.5,4,-1,3,0
2014-15,2014-10-16,Dallas Stars,2,Central,Western,5,2,8,0.625,5,0,4,1
2014-15,2014-10-19,Dallas Stars,1,Central,Western,6,2,10,0.6,6,0,6,0
2014-15,2014-10-22,Dallas Stars,2,Central,Western,8,2,12,0.6666666666666666,8,0,6,2
2014-15,2014-10-24,Dallas Stars,2,Central,Western,10,2,14,0.7142857142857143,9,1,8,2
2014-15,2014-10-25,Dallas Stars,0,Central,Western,10,2,16,0.625,9,1,8,2
2014-15,2014-10-29,Dallas Stars,1,Central,Western,11,2,18,0.6111111111111112,11,0,11,0
2014-15,2014-11-01,Dallas Stars,1,Central,Western,12,2,20,0.6,12,0,12,0
2014-15,2014-11-02,Dallas Stars,0,Central,Western,12,2,22,0.5454545454545454,13,-1,13,-1
2014-15,2014-11-05,Dallas Stars,0,Central,Western,12,2,24,0.5,15,-3,15,-3
2014-15,2014-11-07,Dallas Stars,0,Central,Western,12,2,26,0.46153846153846156,16,-4,16,-4
2014-15,2014-11-09,Dallas Stars,0,Central,Western,12,2,28,0.42857142857142855,18,-6,18,-6
2014-15,2014-11-12,Dallas Stars,2,Central,Western,14,2,30,0.4666666666666667,19,-5,18,-4
2014-15,2014-11-14,Dallas Stars,2,Central,Western,16,2,32,0.5,20,-4,20,-4
2014-15,2014-11-15,Dallas Stars,0,Central,Western,16,2,34,0.47058823529411764,20,-4,20,-4
2014-15,2014-11-17,Dallas Stars,0,Central,Western,16,2,36,0.4444444444444444,21,-5,21,-5
2014-15,2014-11-19,Dallas Stars,0,Central,Western,16,2,38,0.42105263157894735,23,-7,22,-6
2014-15,2014-11-21,Dallas Stars,2,Central,Western,18,2,40,0.45,23,-5,23,-5
2014-15,2014-11-23,Dallas Stars,2,Central,Western,20,2,42,0.47619047619047616,25,-5,24,-4
2014-15,2014-11-26,Dallas Stars,2,Central,Western,22,2,44,0.5,25,-3,25,-3
2014-15,2014-11-29,Dallas Stars,1,Central,Western,23,2,46,0.5,29,-6,28,-5
2014-15,2014-11-30,Dallas Stars,0,Central,Western,23,2,48,0.4791666666666667,31,-8,28,-5
2014-15,2014-12-03,Dallas Stars,0,Central,Western,23,2,50,0.46,31,-8,28,-5
2014-15,2014-12-05,Dallas Stars,0,Central,Western,23,2,52,0.4423076923076923,33,-10,30,-7
2014-15,2014-12-07,Dallas Stars,2,Central,Western,25,2,54,0.46296296296296297,36,-11,33,-8
2014-15,2014-12-10,Dallas Stars,0,Central,Western,25,2,56,0.44642857142857145,38,-13,34,-9
2014-15,2014-12-14,Dallas Stars,2,Central,Western,27,2,58,0.46551724137931033,40,-13,36,-9
2014-15,2014-12-18,Dallas Stars,2,Central,Western,29,2,60,0.48333333333333334,42,-13,36,-7
2014-15,2014-12-20,Dallas Stars,2,Central,Western,31,2,62,0.5,42,-11,38,-7
2014-15,2014-12-21,Dallas Stars,2,Central,Western,33,2,64,0.515625,44,-11,40,-7
2014-15,2014-12-24,Dallas Stars,0,Central,Western,33,2,66,0.5,45,-12,41,-8
2014-15,2014-12-28,Dallas Stars,2,Central,Western,35,2,68,0.5147058823529411,45,-10,42,-7
2014-15,2014-12-30,Dallas Stars,2,Central,Western,37,2,70,0.5285714285714286,47,-10,43,-6
2014-15,2015-01-01,Dallas Stars,2,Central,Western,39,2,72,0.5416666666666666,47,-8,45,-6
2014-15,2015-01-04,Dallas Stars,2,Central,Western,41,2,74,0.5540540540540541,49,-8,45,-4
2014-15,2015-01-05,Dallas Stars,1,Central,Western,42,2,76,0.5526315789473685,49,-7,45,-3
2014-15,2015-01-07,Dallas Stars,0,Central,Western,42,2,78,0.5384615384615384,51,-9,47,-5
2014-15,2015-01-09,Dallas Stars,1,Central,Western,43,2,80,0.5375,53,-10,47,-4
2014-15,2015-01-10,Dallas Stars,0,Central,Western,43,2,82,0.524390243902439,53,-10,47,-4
2014-15,2015-01-14,Dallas Stars,2,Central,Western,45,2,84,0.5357142857142857,57,-12,49,-4
2014-15,2015-01-16,Dallas Stars,0,Central,Western,45,2,86,0.5232558139534884,58,-13,50,-5
2014-15,2015-01-18,Dallas Stars,2,Central,Western,47,2,88,0.5340909090909091,58,-11,51,-4
2014-15,2015-01-18,Dallas Stars,2,Central,Western,49,2,90,0.5444444444444444,58,-9,51,-2
2014-15,2015-01-21,Dallas Stars,0,Central,Western,49,2,92,0.532608695652174,60,-11,53,-4
2014-15,2015-01-28,Dallas Stars,0,Central,Western,49,2,94,0.5212765957446809,62,-13,55,-6
2014-15,2015-01-30,Dallas Stars,2,Central,Western,51,2,96,0.53125,62,-11,55,-4
2014-15,2015-02-01,Dallas Stars,2,Central,Western,53,2,98,0.5408163265306123,64,-11,57,-4
2014-15,2015-02-04,Dallas Stars,1,Central,Western,54,2,100,0.54,64,-10,59,-5
2014-15,2015-02-06,Dallas Stars,0,Central,Western,54,2,102,0.5294117647058824,64,-10,59,-5
2014-15,2015-02-08,Dallas Stars,0,Central,Western,54,2,104,0.5192307692307693,68,-14,61,-7
2014-15,2015-02-08,Dallas Stars,2,Central,Western,56,2,106,0.5283018867924528,68,-12,61,-5
2014-15,2015-02-11,Dallas Stars,2,Central,Western,58,2,108,0.5370370370370371,69,-11,61,-3
2014-15,2015-02-14,Dallas Stars,2,Central,Western,60,2,110,0.5454545454545454,72,-12,63,-3
2014-15,2015-02-15,Dallas Stars,0,Central,Western,60,2,112,0.5357142857142857,74,-14,65,-5
2014-15,2015-02-18,Dallas Stars,2,Central,Western,62,2,114,0.543859649122807,74,-12,66,-4
2014-15,2015-02-20,Dallas Stars,0,Central,Western,62,2,116,0.5344827586206896,75,-13,68,-6
2014-15,2015-02-22,Dallas Stars,1,Central,Western,63,2,118,0.5338983050847458,75,-12,68,-5
2014-15,2015-02-23,Dallas Stars,0,Central,Western,63,2,120,0.525,75,-12,68,-5
2014-15,2015-02-25,Dallas Stars,0,Central,Western,63,2,122,0.5163934426229508,77,-14,69,-6
2014-15,2015-02-28,Dallas Stars,1,Central,Western,64,2,124,0.5161290322580645,79,-15,70,-6
2014-15,2015-03-02,Dallas Stars,0,Central,Western,64,2,126,0.5079365079365079,79,-15,70,-6
2014-15,2015-03-04,Dallas Stars,2,Central,Western,66,2,128,0.515625,81,-15,72,-6
2014-15,2015-03-06,Dallas Stars,2,Central,Western,68,2,130,0.5230769230769231,81,-13,74,-6
2014-15,2015-03-08,Dallas Stars,0,Central,Western,68,2,132,0.5151515151515151,84,-16,77,-9
2014-15,2015-03-10,Dallas Stars,2,Central,Western,70,2,134,0.5223880597014925,84,-14,77,-7
2014-15,2015-03-12,Dallas Stars,2,Central,Western,72,2,136,0.5294117647058824,84,-12,78,-6
2014-15,2015-03-13,Dallas Stars,2,Central,Western,74,2,138,0.5362318840579711,86,-12,79,-5
2014-15,2015-03-15,Dallas Stars,0,Central,Western,74,2,140,0.5285714285714286,88,-14,80,-6
2014-15,2015-03-20,Dallas Stars,2,Central,Western,76,2,142,0.5352112676056338,92,-16,83,-7
2014-15,2015-03-22,Dallas Stars,2,Central,Western,78,2,144,0.5416666666666666,92,-14,84,-6
2014-15,2015-03-24,Dallas Stars,2,Central,Western,80,2,146,0.547945205479452,94,-14,86,-6
2014-15,2015-03-26,Dallas Stars,2,Central,Western,82,2,148,0.5540540540540541,94,-12,88,-6
2014-15,2015-03-28,Dallas Stars,0,Central,Western,82,2,150,0.5466666666666666,94,-12,88,-6
2014-15,2015-03-29,Dallas Stars,2,Central,Western,84,2,152,0.5526315789473685,96,-12,89,-5
2014-15,2015-03-31,Dallas Stars,0,Central,Western,84,2,154,0.5454545454545454,98,-14,90,-6
2014-15,2015-04-04,Dallas Stars,0,Central,Western,84,2,156,0.5384615384615384,100,-16,91,-7
2014-15,2015-04-05,Dallas Stars,2,Central,Western,86,2,158,0.5443037974683544,102,-16,92,-6
2014-15,2015-04-07,Dallas Stars,2,Central,Western,88,2,160,0.55,102,-14,93,-5
2014-15,2015-04-09,Dallas Stars,2,Central,Western,90,2,162,0.5555555555555556,102,-12,95,-5
2014-15,2015-04-12,Dallas Stars,2,Central,Western,92,2,164,0.5609756097560976,102,-10,97,-5
2014-15,2014-10-09,Detroit Red Wings,2,Atlantic,Eastern,2,2,2,1.0,2,0,1,1
2014-15,2014-10-11,Detroit Red Wings,0,Atlantic,Eastern,2,2,4,0.5,2,0,2,0
2014-15,2014-10-16,Detroit Red Wings,1,Atlantic,Eastern,3,2,6,0.5,5,-2,4,-1
2014-15,2014-10-17,Detroit Red Wings,2,Atlantic,Eastern,5,2,8,0.625,5,0,5,0
2014-15,2014-10-18,Detroit Red Wings,2,Atlantic,Eastern,7,2,10,0.7,7,0,6,1
2014-15,2014-10-21,Detroit Red Wings,1,Atlantic,Eastern,8,2,12,0.6666666666666666,8,0,7,1
2014-15,2014-10-23,Detroit Red Wings,2,Atlantic,Eastern,10,2,14,0.7142857142857143,9,1,8,2
2014-15,2014-10-25,Detroit Red Wings,0,Atlantic,Eastern,10,2,16,0.625,10,0,8,2
2014-15,2014-10-29,Detroit Red Wings,2,Atlantic,Eastern,12,2,18,0.6666666666666666,12,0,10,2
2014-15,2014-10-31,Detroit Red Wings,2,Atlantic,Eastern,14,2,20,0.7,14,0,12,2
2014-15,2014-11-02,Detroit Red Wings,1,Atlantic,Eastern,15,2,22,0.6818181818181818,15,0,12,3
2014-15,2014-11-05,Detroit Red Wings,0,Atlantic,Eastern,15,2,24,0.625,16,-1,13,2
2014-15,2014-11-06,Detroit Red Wings,1,Atlantic,Eastern,16,2,26,0.6153846153846154,16,0,14,2
2014-15,2014-11-08,Detroit Red Wings,2,Atlantic,Eastern,18,2,28,0.6428571428571429,18,0,14,4
2014-15,2014-11-09,Detroit Red Wings,1,Atlantic,Eastern,19,2,30,0.6333333333333333,19,0,16,3
2014-15,2014-11-15,Detroit Red Wings,2,Atlantic,Eastern,21,2,32,0.65625,22,-1,20,1
2014-15,2014-11-17,Detroit Red Wings,0,Atlantic,Eastern,21,2,34,0.6176470588235294,22,-1,20,1
2014-15,2014-11-19,Detroit Red Wings,2,Atlantic,Eastern,23,2,36,0.6388888888888888,24,-1,20,3
2014-15,2014-11-21,Detroit Red Wings,2,Atlantic,Eastern,25,2,38,0.6578947368421053,25,0,22,3
2014-15,2014-11-23,Detroit Red Wings,0,Atlantic,Eastern,25,2,40,0.625,26,-1,22,3
2014-15,2014-11-25,Detroit Red Wings,2,Atlantic,Eastern,27,2,42,0.6428571428571429,27,0,22,5
2014-15,2014-11-27,Detroit Red Wings,2,Atlantic,Eastern,29,2,44,0.6590909090909091,29,0,24,5
2014-15,2014-11-29,Detroit Red Wings,2,Atlantic,Eastern,31,2,46,0.6739130434782609,31,0,25,6
2014-15,2014-11-30,Detroit Red Wings,2,Atlantic,Eastern,33,2,48,0.6875,33,0,26,7
2014-15,2014-12-03,Detroit Red Wings,0,Atlantic,Eastern,33,2,50,0.66,33,0,26,7
2014-15,2014-12-05,Detroit Red Wings,2,Atlantic,Eastern,35,2,52,0.6730769230769231,35,0,27,8
2014-15,2014-12-07,Detroit Red Wings,2,Atlantic,Eastern,37,2,54,0.6851851851851852,36,1,29,8
2014-15,2014-12-07,Detroit Red Wings,2,Atlantic,Eastern,39,2,56,0.6964285714285714,36,3,29,10
2014-15,2014-12-11,Detroit Red Wings,1,Atlantic,Eastern,40,2,58,0.6896551724137931,38,2,30,10
2014-15,2014-12-13,Detroit Red Wings,1,Atlantic,Eastern,41,2,60,0.6833333333333333,40,1,31,10
2014-15,2014-12-14,Detroit Red Wings,0,Atlantic,Eastern,41,2,62,0.6612903225806451,40,1,32,9
2014-15,2014-12-17,Detroit Red Wings,1,Atlantic,Eastern,42,2,64,0.65625,42,0,34,8
2014-15,2014-12-20,Detroit Red Wings,0,Atlantic,Eastern,42,2,66,0.6363636363636364,42,0,36,6
2014-15,2014-12-21,Detroit Red Wings,1,Atlantic,Eastern,43,2,68,0.6323529411764706,43,0,36,7
2014-15,2014-12-24,Detroit Red Wings,2,Atlantic,Eastern,45,2,70,0.6428571428571429,45,0,40,5
2014-15,2014-12-28,Detroit Red Wings,2,Atlantic,Eastern,47,2,72,0.6527777777777778,46,1,42,5
2014-15,2014-12-30,Detroit Red Wings,0,Atlantic,Eastern,47,2,74,0.6351351351351351,47,0,42,5
2014-15,2015-01-01,Detroit Red Wings,2,Atlantic,Eastern,49,2,76,0.6447368421052632,49,0,44,5
2014-15,2015-01-04,Detroit Red Wings,0,Atlantic,Eastern,49,2,78,0.6282051282051282,49,0,45,4
2014-15,2015-01-07,Detroit Red Wings,2,Atlantic,Eastern,51,2,80,0.6375,51,0,45,6
2014-15,2015-01-08,Detroit Red Wings,2,Atlantic,Eastern,53,2,82,0.6463414634146342,53,0,46,7
2014-15,2015-01-11,Detroit Red Wings,0,Atlantic,Eastern,53,2,84,0.6309523809523809,53,0,50,3
2014-15,2015-01-14,Detroit Red Wings,2,Atlantic,Eastern,55,2,86,0.6395348837209303,55,0,52,3
2014-15,2015-01-16,Detroit Red Wings,2,Atlantic,Eastern,57,2,88,0.6477272727272727,57,0,52,5
2014-15,2015-01-18,Detroit Red Wings,2,Atlantic,Eastern,59,2,90,0.6555555555555556,59,0,54,5
2014-15,2015-01-19,Detroit Red Wings,2,Atlantic,Eastern,61,2,92,0.6630434782608695,59,2,54,7
2014-15,2015-01-21,Detroit Red Wings,2,Atlantic,Eastern,63,2,94,0.6702127659574468,61,2,56,7
2014-15,2015-01-28,Detroit Red Wings,2,Atlantic,Eastern,65,2,96,0.6770833333333334,63,2,57,8
2014-15,2015-01-30,Detroit Red Wings,0,Atlantic,Eastern,65,2,98,0.6632653061224489,65,0,58,7
2014-15,2015-01-31,Detroit Red Wings,2,Atlantic,Eastern,67,2,100,0.67,66,1,58,9
2014-15,2015-02-06,Detroit Red Wings,2,Atlantic,Eastern,69,2,102,0.6764705882352942,67,2,61,8
2014-15,2015-02-08,Detroit Red Wings,2,Atlantic,Eastern,71,2,104,0.6826923076923077,69,2,63,8
2014-15,2015-02-12,Detroit Red Wings,0,Atlantic,Eastern,71,2,106,0.6698113207547169,71,0,63,8
2014-15,2015-02-15,Detroit Red Wings,1,Atlantic,Eastern,72,2,108,0.6666666666666666,72,0,63,9
2014-15,2015-02-17,Detroit Red Wings,0,Atlantic,Eastern,72,2,110,0.6545454545454545,72,0,64,8
2014-15,2015-02-19,Detroit Red Wings,2,Atlantic,Eastern,74,2,112,0.6607142857142857,74,0,65,9
2014-15,2015-02-22,Detroit Red Wings,2,Atlantic,Eastern,76,2,114,0.6666666666666666,76,0,67,9
2014-15,2015-02-24,Detroit Red Wings,1,Atlantic,Eastern,77,2,116,0.6637931034482759,77,0,67,10
2014-15,2015-02-25,Detroit Red Wings,0,Atlantic,Eastern,77,2,118,0.652542372881356,77,0,67,10
2014-15,2015-02-27,Detroit Red Wings,2,Atlantic,Eastern,79,2,120,0.6583333333333333,79,0,67,12
2014-15,2015-02-28,Detroit Red Wings,2,Atlantic,Eastern,81,2,122,0.6639344262295082,81,0,69,12
2014-15,2015-03-05,Detroit Red Wings,2,Atlantic,Eastern,83,2,124,0.6693548387096774,83,0,69,14
2014-15,2015-03-07,Detroit Red Wings,0,Atlantic,Eastern,83,2,126,0.6587301587301587,83,0,74,9
2014-15,2015-03-08,Detroit Red Wings,0,Atlantic,Eastern,83,2,128,0.6484375,83,0,76,7
2014-15,2015-03-09,Detroit Red Wings,2,Atlantic,Eastern,85,2,130,0.6538461538461539,85,0,76,9
2014-15,2015-03-12,Detroit Red Wings,0,Atlantic,Eastern,85,2,132,0.6439393939393939,85,0,80,5
2014-15,2015-03-14,Detroit Red Wings,0,Atlantic,Eastern,85,2,134,0.6343283582089553,85,0,82,3
2014-15,2015-03-15,Detroit Red Wings,2,Atlantic,Eastern,87,2,136,0.6397058823529411,87,0,82,5
2014-15,2015-03-19,Detroit Red Wings,0,Atlantic,Eastern,87,2,138,0.6304347826086957,87,0,83,4
2014-15,2015-03-20,Detroit Red Wings,0,Atlantic,Eastern,87,2,140,0.6214285714285714,87,0,83,4
2014-15,2015-03-22,Detroit Red Wings,2,Atlantic,Eastern,89,2,142,0.6267605633802817,89,0,84,5
2014-15,2015-03-24,Detroit Red Wings,1,Atlantic,Eastern,90,2,144,0.625,90,0,85,5
2014-15,2015-03-26,Detroit Red Wings,0,Atlantic,Eastern,90,2,146,0.6164383561643836,90,0,85,5
2014-15,2015-03-28,Detroit Red Wings,2,Atlantic,Eastern,92,2,148,0.6216216216216216,92,0,87,5
2014-15,2015-03-29,Detroit Red Wings,0,Atlantic,Eastern,92,2,150,0.6133333333333333,92,0,89,3
2014-15,2015-03-31,Detroit Red Wings,1,Atlantic,Eastern,93,2,152,0.6118421052631579,93,0,91,2
2014-15,2015-04-02,Detroit Red Wings,0,Atlantic,Eastern,93,2,154,0.6038961038961039,93,0,93,0
2014-15,2015-04-04,Detroit Red Wings,2,Atlantic,Eastern,95,2,156,0.6089743589743589,95,0,95,0
2014-15,2015-04-05,Detroit Red Wings,0,Atlantic,Eastern,95,2,158,0.6012658227848101,95,0,95,0
2014-15,2015-04-07,Detroit Red Wings,2,Atlantic,Eastern,97,2,160,0.60625,97,0,95,2
2014-15,2015-04-09,Detroit Red Wings,1,Atlantic,Eastern,98,2,162,0.6049382716049383,98,0,96,2
2014-15,2015-04-11,Detroit Red Wings,2,Atlantic,Eastern,100,2,164,0.6097560975609756,100,0,98,2
2014-15,2014-10-10,Edmonton Oilers,0,Pacific,Western,0,2,2,0.0,2,-2,1,-1
2014-15,2014-10-12,Edmonton Oilers,1,Pacific,Western,1,2,4,0.25,2,-1,2,-1
2014-15,2014-10-15,Edmonton Oilers,0,Pacific,Western,1,2,6,0.16666666666666666,5,-4,4,-3
2014-15,2014-10-16,Edmonton Oilers,0,Pacific,Western,1,2,8,0.125,6,-5,4,-3
2014-15,2014-10-18,Edmonton Oilers,0,Pacific,Western,1,2,10,0.1,7,-6,5,-4
2014-15,2014-10-21,Edmonton Oilers,2,Pacific,Western,3,2,12,0.25,9,-6,6,-3
2014-15,2014-10-23,Edmonton Oilers,2,Pacific,Western,5,2,14,0.35714285714285715,9,-4,6,-1
2014-15,2014-10-25,Edmonton Oilers,2,Pacific,Western,7,2,16,0.4375,11,-4,8,-1
2014-15,2014-10-28,Edmonton Oilers,2,Pacific,Western,9,2,18,0.5,11,-2,10,-1
2014-15,2014-10-30,Edmonton Oilers,0,Pacific,Western,9,2,20,0.45,13,-4,11,-2
2014-15,2014-11-02,Edmonton Oilers,0,Pacific,Western,9,2,22,0.4090909090909091,16,-7,13,-4
2014-15,2014-11-05,Edmonton Oilers,0,Pacific,Western,9,2,24,0.375,18,-9,15,-6
2014-15,2014-11-07,Edmonton Oilers,0,Pacific,Western,9,2,26,0.34615384615384615,18,-9,16,-7
2014-15,2014-11-08,Edmonton Oilers,2,Pacific,Western,11,2,28,0.39285714285714285,20,-9,16,-5
2014-15,2014-11-09,Edmonton Oilers,2,Pacific,Western,13,2,30,0.43333333333333335,20,-7,18,-5
2014-15,2014-11-12,Edmonton Oilers,0,Pacific,Western,13,2,32,0.40625,20,-7,18,-5
2014-15,2014-11-14,Edmonton Oilers,1,Pacific,Western,14,2,34,0.4117647058823529,22,-8,20,-6
2014-15,2014-11-17,Edmonton Oilers,0,Pacific,Western,14,2,36,0.3888888888888889,24,-10,21,-7
2014-15,2014-11-20,Edmonton Oilers,0,Pacific,Western,14,2,38,0.3684210526315789,26,-12,22,-8
2014-15,2014-11-22,Edmonton Oilers,0,Pacific,Western,14,2,40,0.35,26,-12,23,-9
2014-15,2014-11-23,Edmonton Oilers,0,Pacific,Western,14,2,42,0.3333333333333333,27,-13,24,-10
2014-15,2014-11-26,Edmonton Oilers,0,Pacific,Western,14,2,44,0.3181818181818182,28,-14,25,-11
2014-15,2014-11-28,Edmonton Oilers,1,Pacific,Western,15,2,46,0.32608695652173914,30,-15,27,-12
2014-15,2014-11-29,Edmonton Oilers,1,Pacific,Western,16,2,48,0.3333333333333333,30,-14,28,-12
2014-15,2014-12-02,Edmonton Oilers,0,Pacific,Western,16,2,50,0.32,32,-16,28,-12
2014-15,2014-12-04,Edmonton Oilers,1,Pacific,Western,17,2,52,0.3269230769230769,34,-17,30,-13
2014-15,2014-12-08,Edmonton Oilers,2,Pacific,Western,19,2,54,0.35185185185185186,36,-17,33,-14
2014-15,2014-12-10,Edmonton Oilers,0,Pacific,Western,19,2,56,0.3392857142857143,36,-17,34,-15
2014-15,2014-12-11,Edmonton Oilers,0,Pacific,Western,19,2,58,0.3275862068965517,36,-17,34,-15
2014-15,2014-12-13,Edmonton Oilers,0,Pacific,Western,19,2,60,0.31666666666666665,36,-17,36,-17
2014-15,2014-12-15,Edmonton Oilers,0,Pacific,Western,19,2,62,0.3064516129032258,38,-19,36,-17
2014-15,2014-12-17,Edmonton Oilers,1,Pacific,Western,20,2,64,0.3125,38,-18,36,-16
2014-15,2014-12-19,Edmonton Oilers,0,Pacific,Western,20,2,66,0.30303030303030304,38,-18,38,-18
2014-15,2014-12-21,Edmonton Oilers,1,Pacific,Western,21,2,68,0.3088235294117647,40,-19,40,-19
2014-15,2014-12-24,Edmonton Oilers,0,Pacific,Western,21,2,70,0.3,42,-21,41,-20
2014-15,2014-12-28,Edmonton Oilers,0,Pacific,Western,21,2,72,0.2916666666666667,43,-22,42,-21
2014-15,2014-12-31,Edmonton Oilers,2,Pacific,Western,23,2,74,0.3108108108108108,44,-21,43,-20
2014-15,2015-01-01,Edmonton Oilers,1,Pacific,Western,24,2,76,0.3157894736842105,45,-21,45,-21
2014-15,2015-01-03,Edmonton Oilers,1,Pacific,Western,25,2,78,0.32051282051282054,45,-20,45,-20
2014-15,2015-01-05,Edmonton Oilers,2,Pacific,Western,27,2,80,0.3375,47,-20,45,-18
2014-15,2015-01-07,Edmonton Oilers,0,Pacific,Western,27,2,82,0.32926829268292684,49,-22,47,-20
2014-15,2015-01-10,Edmonton Oilers,2,Pacific,Western,29,2,84,0.34523809523809523,49,-20,47,-18
2014-15,2015-01-12,Edmonton Oilers,0,Pacific,Western,29,2,86,0.3372093023255814,49,-20,48,-19
2014-15,2015-01-14,Edmonton Oilers,0,Pacific,Western,29,2,88,0.32954545454545453,50,-21,49,-20
2014-15,2015-01-16,Edmonton Oilers,0,Pacific,Western,29,2,90,0.32222222222222224,51,-22,50,-21
2014-15,2015-01-18,Edmonton Oilers,2,Pacific,Western,31,2,92,0.33695652173913043,53,-22,51,-20
2014-15,2015-01-21,Edmonton Oilers,2,Pacific,Western,33,2,94,0.35106382978723405,54,-21,53,-20
2014-15,2015-01-28,Edmonton Oilers,0,Pacific,Western,33,2,96,0.34375,55,-22,55,-22
2014-15,2015-01-30,Edmonton Oilers,2,Pacific,Western,35,2,98,0.35714285714285715,55,-20,55,-20
2014-15,2015-02-01,Edmonton Oilers,0,Pacific,Western,35,2,100,0.35,57,-22,57,-22
2014-15,2015-02-03,Edmonton Oilers,2,Pacific,Western,37,2,102,0.3627450980392157,59,-22,57,-20
2014-15,2015-02-05,Edmonton Oilers,0,Pacific,Western,37,2,104,0.3557692307692308,61,-24,59,-22
2014-15,2015-02-08,Edmonton Oilers,0,Pacific,Western,37,2,106,0.3490566037735849,61,-24,61,-24
2014-15,2015-02-10,Edmonton Oilers,2,Pacific,Western,39,2,108,0.3611111111111111,63,-24,61,-22
2014-15,2015-02-11,Edmonton Oilers,0,Pacific,Western,39,2,110,0.35454545454545455,63,-24,61,-22
2014-15,2015-02-13,Edmonton Oilers,2,Pacific,Western,41,2,112,0.36607142857142855,63,-22,63,-22
2014-15,2015-02-14,Edmonton Oilers,0,Pacific,Western,41,2,114,0.35964912280701755,65,-24,63,-22
2014-15,2015-02-17,Edmonton Oilers,1,Pacific,Western,42,2,116,0.3620689655172414,67,-25,66,-24
2014-15,2015-02-19,Edmonton Oilers,2,Pacific,Western,44,2,118,0.3728813559322034,67,-23,66,-22
2014-15,2015-02-21,Edmonton Oilers,0,Pacific,Western,44,2,120,0.36666666666666664,68,-24,68,-24
2014-15,2015-02-22,Edmonton Oilers,0,Pacific,Western,44,2,122,0.36065573770491804,68,-24,68,-24
2014-15,2015-02-25,Edmonton Oilers,2,Pacific,Western,46,2,124,0.3709677419354839,70,-24,69,-23
2014-15,2015-03-01,Edmonton Oilers,0,Pacific,Western,46,2,126,0.36507936507936506,70,-24,70,-24
2014-15,2015-03-04,Edmonton Oilers,0,Pacific,Western,46,2,128,0.359375,72,-26,72,-26
2014-15,2015-03-07,Edmonton Oilers,1,Pacific,Western,47,2,130,0.36153846153846153,76,-29,76,-29
2014-15,2015-03-08,Edmonton Oilers,0,Pacific,Western,47,2,132,0.3560606060606061,77,-30,77,-30
2014-15,2015-03-09,Edmonton Oilers,0,Pacific,Western,47,2,134,0.35074626865671643,77,-30,77,-30
2014-15,2015-03-12,Edmonton Oilers,0,Pacific,Western,47,2,136,0.34558823529411764,79,-32,78,-31
2014-15,2015-03-13,Edmonton Oilers,1,Pacific,Western,48,2,138,0.34782608695652173,79,-31,79,-31
2014-15,2015-03-17,Edmonton Oilers,2,Pacific,Western,50,2,140,0.35714285714285715,81,-31,81,-31
2014-15,2015-03-19,Edmonton Oilers,1,Pacific,Western,51,2,142,0.3591549295774648,82,-31,82,-31
2014-15,2015-03-22,Edmonton Oilers,2,Pacific,Western,53,2,144,0.3680555555555556,84,-31,84,-31
2014-15,2015-03-24,Edmonton Oilers,0,Pacific,Western,53,2,146,0.363013698630137,86,-33,86,-33
2014-15,2015-03-26,Edmonton Oilers,2,Pacific,Western,55,2,148,0.3716216216216216,88,-33,88,-33
2014-15,2015-03-28,Edmonton Oilers,2,Pacific,Western,57,2,150,0.38,88,-31,88,-31
2014-15,2015-03-31,Edmonton Oilers,2,Pacific,Western,59,2,152,0.3881578947368421,91,-32,90,-31
2014-15,2015-04-02,Edmonton Oilers,0,Pacific,Western,59,2,154,0.38311688311688313,91,-32,90,-31
2014-15,2015-04-03,Edmonton Oilers,0,Pacific,Western,59,2,156,0.3782051282051282,91,-32,90,-31
2014-15,2015-04-05,Edmonton Oilers,0,Pacific,Western,59,2,158,0.37341772151898733,93,-34,92,-33
2014-15,2015-04-08,Edmonton Oilers,2,Pacific,Western,61,2,160,0.38125,95,-34,95,-34
2014-15,2015-04-10,Edmonton Oilers,0,Pacific,Western,61,2,162,0.3765432098765432,97,-36,97,-36
2014-15,2015-04-12,Edmonton Oilers,1,Pacific,Western,62,2,164,0.3780487804878049,97,-35,97,-35
2014-15,2014-10-09,Florida Panthers,1,Atlantic,Eastern,1,2,2,0.5,2,-1,1,0
2014-15,2014-10-11,Florida Panthers,0,Atlantic,Eastern,1,2,4,0.25,2,-1,2,-1
2014-15,2014-10-13,Florida Panthers,0,Atlantic,Eastern,1,2,6,0.16666666666666666,4,-3,3,-2
2014-15,2014-10-17,Florida Panthers,2,Atlantic,Eastern,3,2,8,0.375,5,-2,5,-2
2014-15,2014-10-18,Florida Panthers,1,Atlantic,Eastern,4,2,10,0.4,7,-3,6,-2
2014-15,2014-10-22,Florida Panthers,2,Atlantic,Eastern,6,2,12,0.5,8,-2,8,-2
2014-15,2014-10-26,Florida Panthers,1,Atlantic,Eastern,7,2,14,0.5,10,-3,9,-2
2014-15,2014-10-30,Florida Panthers,2,Atlantic,Eastern,9,2,16,0.5625,12,-3,12,-3
2014-15,2014-11-01,Florida Panthers,2,Atlantic,Eastern,11,2,18,0.6111111111111112,14,-3,12,-1
2014-15,2014-11-05,Florida Panthers,1,Atlantic,Eastern,12,2,20,0.6,16,-4,13,-1
2014-15,2014-11-07,Florida Panthers,0,Atlantic,Eastern,12,2,22,0.5454545454545454,18,-6,14,-2
2014-15,2014-11-08,Florida Panthers,0,Atlantic,Eastern,12,2,24,0.5,18,-6,14,-2
2014-15,2014-11-12,Florida Panthers,2,Atlantic,Eastern,14,2,26,0.5384615384615384,20,-6,18,-4
2014-15,2014-11-15,Florida Panthers,1,Atlantic,Eastern,15,2,28,0.5357142857142857,22,-7,20,-5
2014-15,2014-11-17,Florida Panthers,2,Atlantic,Eastern,17,2,30,0.5666666666666667,22,-5,20,-3
2014-15,2014-11-19,Florida Panthers,0,Atlantic,Eastern,17,2,32,0.53125,24,-7,20,-3
2014-15,2014-11-21,Florida Panthers,2,Atlantic,Eastern,19,2,34,0.5588235294117647,25,-6,22,-3
2014-15,2014-11-23,Florida Panthers,1,Atlantic,Eastern,20,2,36,0.5555555555555556,26,-6,22,-2
2014-15,2014-11-25,Florida Panthers,0,Atlantic,Eastern,20,2,38,0.5263157894736842,27,-7,22,-2
2014-15,2014-11-27,Florida Panthers,2,Atlantic,Eastern,22,2,40,0.55,29,-7,24,-2
2014-15,2014-11-29,Florida Panthers,2,Atlantic,Eastern,24,2,42,0.5714285714285714,31,-7,25,-1
2014-15,2014-12-02,Florida Panthers,0,Atlantic,Eastern,24,2,44,0.5454545454545454,33,-9,26,-2
2014-15,2014-12-03,Florida Panthers,2,Atlantic,Eastern,26,2,46,0.5652173913043478,33,-7,26,0
2014-15,2014-12-05,Florida Panthers,1,Atlantic,Eastern,27,2,48,0.5625,35,-8,27,0
2014-15,2014-12-07,Florida Panthers,2,Atlantic,Eastern,29,2,50,0.58,36,-7,29,0
2014-15,2014-12-09,Florida Panthers,0,Atlantic,Eastern,29,2,52,0.5576923076923077,36,-7,29,0
2014-15,2014-12-13,Florida Panthers,2,Atlantic,Eastern,31,2,54,0.5740740740740741,40,-9,31,0
2014-15,2014-12-14,Florida Panthers,1,Atlantic,Eastern,32,2,56,0.5714285714285714,40,-8,32,0
2014-15,2014-12-17,Florida Panthers,2,Atlantic,Eastern,34,2,58,0.5862068965517241,42,-8,34,0
2014-15,2014-12-19,Florida Panthers,2,Atlantic,Eastern,36,2,60,0.6,42,-6,36,0
2014-15,2014-12-21,Florida Panthers,0,Atlantic,Eastern,36,2,62,0.5806451612903226,43,-7,36,0
2014-15,2014-12-23,Florida Panthers,2,Atlantic,Eastern,38,2,64,0.59375,43,-5,38,0
2014-15,2014-12-28,Florida Panthers,2,Atlantic,Eastern,40,2,66,0.6060606060606061,46,-6,42,-2
2014-15,2014-12-31,Florida Panthers,1,Atlantic,Eastern,41,2,68,0.6029411764705882,47,-6,43,-2
2014-15,2014-12-31,Florida Panthers,0,Atlantic,Eastern,41,2,70,0.5857142857142857,47,-6,43,-2
2014-15,2015-01-03,Florida Panthers,2,Atlantic,Eastern,43,2,72,0.5972222222222222,49,-6,44,-1
2014-15,2015-01-04,Florida Panthers,0,Atlantic,Eastern,43,2,74,0.581081081081081,49,-6,45,-2
2014-15,2015-01-09,Florida Panthers,2,Atlantic,Eastern,45,2,76,0.5921052631578947,53,-8,48,-3
2014-15,2015-01-10,Florida Panthers,2,Atlantic,Eastern,47,2,78,0.6025641025641025,53,-6,50,-3
2014-15,2015-01-12,Florida Panthers,2,Atlantic,Eastern,49,2,80,0.6125,53,-4,50,-1
2014-15,2015-01-14,Florida Panthers,0,Atlantic,Eastern,49,2,82,0.5975609756097561,55,-6,52,-3
2014-15,2015-01-16,Florida Panthers,0,Atlantic,Eastern,49,2,84,0.5833333333333334,57,-8,52,-3
2014-15,2015-01-18,Florida Panthers,1,Atlantic,Eastern,50,2,86,0.5813953488372093,59,-9,54,-4
2014-15,2015-01-20,Florida Panthers,0,Atlantic,Eastern,50,2,88,0.5681818181818182,59,-9,54,-4
2014-15,2015-01-28,Florida Panthers,0,Atlantic,Eastern,50,2,90,0.5555555555555556,63,-13,57,-7
2014-15,2015-01-30,Florida Panthers,2,Atlantic,Eastern,52,2,92,0.5652173913043478,65,-13,58,-6
2014-15,2015-02-01,Florida Panthers,0,Atlantic,Eastern,52,2,94,0.5531914893617021,67,-15,60,-8
2014-15,2015-02-03,Florida Panthers,0,Atlantic,Eastern,52,2,96,0.5416666666666666,67,-15,60,-8
2014-15,2015-02-04,Florida Panthers,2,Atlantic,Eastern,54,2,98,0.5510204081632653,67,-13,61,-7
2014-15,2015-02-06,Florida Panthers,2,Atlantic,Eastern,56,2,100,0.56,67,-11,61,-5
2014-15,2015-02-08,Florida Panthers,1,Atlantic,Eastern,57,2,102,0.5588235294117647,69,-12,63,-6
2014-15,2015-02-11,Florida Panthers,2,Atlantic,Eastern,59,2,104,0.5673076923076923,71,-12,63,-4
2014-15,2015-02-13,Florida Panthers,0,Atlantic,Eastern,59,2,106,0.5566037735849056,71,-12,63,-4
2014-15,2015-02-14,Florida Panthers,0,Atlantic,Eastern,59,2,108,0.5462962962962963,71,-12,63,-4
2014-15,2015-02-15,Florida Panthers,1,Atlantic,Eastern,60,2,110,0.5454545454545454,72,-12,63,-3
2014-15,2015-02-18,Florida Panthers,2,Atlantic,Eastern,62,2,112,0.5535714285714286,72,-10,64,-2
2014-15,2015-02-20,Florida Panthers,2,Atlantic,Eastern,64,2,114,0.5614035087719298,74,-10,65,-1
2014-15,2015-02-22,Florida Panthers,0,Atlantic,Eastern,64,2,116,0.5517241379310345,76,-12,67,-3
2014-15,2015-02-22,Florida Panthers,0,Atlantic,Eastern,64,2,118,0.5423728813559322,76,-12,67,-3
2014-15,2015-02-25,Florida Panthers,1,Atlantic,Eastern,65,2,120,0.5416666666666666,77,-12,67,-2
2014-15,2015-02-27,Florida Panthers,0,Atlantic,Eastern,65,2,122,0.5327868852459017,79,-14,67,-2
2014-15,2015-02-28,Florida Panthers,2,Atlantic,Eastern,67,2,124,0.5403225806451613,81,-14,69,-2
2014-15,2015-03-01,Florida Panthers,2,Atlantic,Eastern,69,2,126,0.5476190476190477,81,-12,69,0
2014-15,2015-03-04,Florida Panthers,0,Atlantic,Eastern,69,2,128,0.5390625,81,-12,69,0
2014-15,2015-03-06,Florida Panthers,1,Atlantic,Eastern,70,2,130,0.5384615384615384,83,-13,72,-2
2014-15,2015-03-08,Florida Panthers,2,Atlantic,Eastern,72,2,132,0.5454545454545454,83,-11,76,-4
2014-15,2015-03-12,Florida Panthers,2,Atlantic,Eastern,74,2,134,0.5522388059701493,85,-11,80,-6
2014-15,2015-03-14,Florida Panthers,2,Atlantic,Eastern,76,2,136,0.5588235294117647,85,-9,82,-6
2014-15,2015-03-15,Florida Panthers,0,Atlantic,Eastern,76,2,138,0.5507246376811594,87,-11,82,-6
2014-15,2015-03-17,Florida Panthers,0,Atlantic,Eastern,76,2,140,0.5428571428571428,87,-11,83,-7
2014-15,2015-03-19,Florida Panthers,2,Atlantic,Eastern,78,2,142,0.5492957746478874,87,-9,83,-5
2014-15,2015-03-21,Florida Panthers,2,Atlantic,Eastern,80,2,144,0.5555555555555556,87,-7,84,-4
2014-15,2015-03-24,Florida Panthers,0,Atlantic,Eastern,80,2,146,0.547945205479452,90,-10,85,-5
2014-15,2015-03-26,Florida Panthers,2,Atlantic,Eastern,82,2,148,0.5540540540540541,90,-8,85,-3
2014-15,2015-03-28,Florida Panthers,1,Atlantic,Eastern,83,2,150,0.5533333333333333,92,-9,87,-4
2014-15,2015-03-29,Florida Panthers,2,Atlantic,Eastern,85,2,152,0.5592105263157895,92,-7,89,-4
2014-15,2015-03-31,Florida Panthers,0,Atlantic,Eastern,85,2,154,0.551948051948052,93,-8,91,-6
2014-15,2015-04-02,Florida Panthers,2,Atlantic,Eastern,87,2,156,0.5576923076923077,93,-6,93,-6
2014-15,2015-04-04,Florida Panthers,0,Atlantic,Eastern,87,2,158,0.5506329113924051,95,-8,95,-8
2014-15,2015-04-05,Florida Panthers,0,Atlantic,Eastern,87,2,160,0.54375,95,-8,95,-8
2014-15,2015-04-09,Florida Panthers,2,Atlantic,Eastern,89,2,162,0.5493827160493827,98,-9,96,-7
2014-15,2015-04-11,Florida Panthers,2,Atlantic,Eastern,91,2,164,0.5548780487804879,100,-9,98,-7
2014-15,2014-10-09,Los Angeles Kings,0,Pacific,Western,0,2,2,0.0,0,0,0,0
2014-15,2014-10-12,Los Angeles Kings,1,Pacific,Western,1,2,4,0.25,2,-1,2,-1
2014-15,2014-10-13,Los Angeles Kings,2,Pacific,Western,3,2,6,0.5,4,-1,2,1
2014-15,2014-10-15,Los Angeles Kings,2,Pacific,Western,5,2,8,0.625,5,0,4,1
2014-15,2014-10-17,Los Angeles Kings,2,Pacific,Western,7,2,10,0.7,6,1,4,3
2014-15,2014-10-19,Los Angeles Kings,2,Pacific,Western,9,2,12,0.75,8,1,6,3
2014-15,2014-10-24,Los Angeles Kings,2,Pacific,Western,11,2,14,0.7857142857142857,11,0,8,3
2014-15,2014-10-26,Los Angeles Kings,2,Pacific,Western,13,2,16,0.8125,11,2,8,5
2014-15,2014-10-28,Los Angeles Kings,1,Pacific,Western,14,2,18,0.7777777777777778,11,3,10,4
2014-15,2014-10-30,Los Angeles Kings,0,Pacific,Western,14,2,20,0.7,13,1,11,3
2014-15,2014-10-31,Los Angeles Kings,0,Pacific,Western,14,2,22,0.6363636363636364,14,0,12,2
2014-15,2014-11-02,Los Angeles Kings,0,Pacific,Western,14,2,24,0.5833333333333334,16,-2,13,1
2014-15,2014-11-05,Los Angeles Kings,2,Pacific,Western,16,2,26,0.6153846153846154,18,-2,15,1
2014-15,2014-11-07,Los Angeles Kings,1,Pacific,Western,17,2,28,0.6071428571428571,18,-1,16,1
2014-15,2014-11-09,Los Angeles Kings,2,Pacific,Western,19,2,30,0.6333333333333333,20,-1,18,1
2014-15,2014-11-13,Los Angeles Kings,1,Pacific,Western,20,2,32,0.625,20,0,18,2
2014-15,2014-11-14,Los Angeles Kings,0,Pacific,Western,20,2,34,0.5882352941176471,22,-2,20,0
2014-15,2014-11-15,Los Angeles Kings,2,Pacific,Western,22,2,36,0.6111111111111112,22,0,20,2
2014-15,2014-11-19,Los Angeles Kings,2,Pacific,Western,24,2,38,0.631578947368421,24,0,22,2
2014-15,2014-11-21,Los Angeles Kings,2,Pacific,Western,26,2,40,0.65,26,0,23,3
2014-15,2014-11-23,Los Angeles Kings,0,Pacific,Western,26,2,42,0.6190476190476191,27,-1,24,2
2014-15,2014-11-26,Los Angeles Kings,1,Pacific,Western,27,2,44,0.6136363636363636,28,-1,25,2
2014-15,2014-11-27,Los Angeles Kings,2,Pacific,Western,29,2,46,0.6304347826086957,30,-1,27,2
2014-15,2014-11-30,Los Angeles Kings,0,Pacific,Western,29,2,48,0.6041666666666666,32,-3,28,1
2014-15,2014-12-03,Los Angeles Kings,2,Pacific,Western,31,2,50,0.62,34,-3,28,3
2014-15,2014-12-05,Los Angeles Kings,2,Pacific,Western,33,2,52,0.6346153846153846,36,-3,30,3
2014-15,2014-12-06,Los Angeles Kings,0,Pacific,Western,33,2,54,0.6111111111111112,36,-3,32,1
2014-15,2014-12-10,Los Angeles Kings,0,Pacific,Western,33,2,56,0.5892857142857143,36,-3,34,-1
2014-15,2014-12-12,Los Angeles Kings,2,Pacific,Western,35,2,58,0.603448275862069,36,-1,36,-1
2014-15,2014-12-13,Los Angeles Kings,0,Pacific,Western,35,2,60,0.5833333333333334,36,-1,36,-1
2014-15,2014-12-14,Los Angeles Kings,1,Pacific,Western,36,2,62,0.5806451612903226,38,-2,36,0
2014-15,2014-12-17,Los Angeles Kings,0,Pacific,Western,36,2,64,0.5625,38,-2,36,0
2014-15,2014-12-19,Los Angeles Kings,2,Pacific,Western,38,2,66,0.5757575757575758,38,0,38,0
2014-15,2014-12-20,Los Angeles Kings,2,Pacific,Western,40,2,68,0.5882352941176471,40,0,38,2
2014-15,2014-12-23,Los Angeles Kings,1,Pacific,Western,41,2,70,0.5857142857142857,42,-1,41,0
2014-15,2014-12-28,Los Angeles Kings,2,Pacific,Western,43,2,72,0.5972222222222222,43,0,42,1
2014-15,2014-12-30,Los Angeles Kings,0,Pacific,Western,43,2,74,0.581081081081081,43,0,43,0
2014-15,2014-12-31,Los Angeles Kings,1,Pacific,Western,44,2,76,0.5789473684210527,44,0,43,1
2014-15,2015-01-02,Los Angeles Kings,2,Pacific,Western,46,2,78,0.5897435897435898,45,1,45,1
2014-15,2015-01-03,Los Angeles Kings,1,Pacific,Western,47,2,80,0.5875,45,2,45,2
2014-15,2015-01-09,Los Angeles Kings,0,Pacific,Western,47,2,82,0.573170731707317,49,-2,47,0
2014-15,2015-01-11,Los Angeles Kings,1,Pacific,Western,48,2,84,0.5714285714285714,49,-1,48,0
2014-15,2015-01-13,Los Angeles Kings,2,Pacific,Western,50,2,86,0.5813953488372093,49,1,49,1
2014-15,2015-01-15,Los Angeles Kings,0,Pacific,Western,50,2,88,0.5681818181818182,50,0,49,1
2014-15,2015-01-18,Los Angeles Kings,1,Pacific,Western,51,2,90,0.5666666666666667,53,-2,51,0
2014-15,2015-01-20,Los Angeles Kings,1,Pacific,Western,52,2,92,0.5652173913043478,54,-2,53,-1
2014-15,2015-01-22,Los Angeles Kings,0,Pacific,Western,52,2,94,0.5531914893617021,55,-3,53,-1
2014-15,2015-01-29,Los Angeles Kings,2,Pacific,Western,54,2,96,0.5625,55,-1,55,-1
2014-15,2015-02-01,Los Angeles Kings,0,Pacific,Western,54,2,98,0.5510204081632653,57,-3,57,-3
2014-15,2015-02-04,Los Angeles Kings,0,Pacific,Western,54,2,100,0.54,59,-5,59,-5
2014-15,2015-02-06,Los Angeles Kings,0,Pacific,Western,54,2,102,0.5294117647058824,61,-7,59,-5
2014-15,2015-02-07,Los Angeles Kings,2,Pacific,Western,56,2,104,0.5384615384615384,61,-5,59,-3
2014-15,2015-02-10,Los Angeles Kings,2,Pacific,Western,58,2,106,0.5471698113207547,63,-5,61,-3
2014-15,2015-02-13,Los Angeles Kings,2,Pacific,Western,60,2,108,0.5555555555555556,63,-3,63,-3
2014-15,2015-02-15,Los Angeles Kings,2,Pacific,Western,62,2,110,0.5636363636363636,65,-3,65,-3
2014-15,2015-02-17,Los Angeles Kings,2,Pacific,Western,64,2,112,0.5714285714285714,67,-3,66,-2
2014-15,2015-02-19,Los Angeles Kings,2,Pacific,Western,66,2,114,0.5789473684210527,67,-1,66,0
2014-15,2015-02-22,Los Angeles Kings,2,Pacific,Western,68,2,116,0.5862068965517241,68,0,68,0
2014-15,2015-02-25,Los Angeles Kings,2,Pacific,Western,70,2,118,0.5932203389830508,70,0,69,1
2014-15,2015-02-27,Los Angeles Kings,0,Pacific,Western,70,2,120,0.5833333333333334,70,0,70,0
2014-15,2015-02-28,Los Angeles Kings,0,Pacific,Western,70,2,122,0.5737704918032787,70,0,70,0
2014-15,2015-03-01,Los Angeles Kings,0,Pacific,Western,70,2,124,0.5645161290322581,70,0,70,0
2014-15,2015-03-04,Los Angeles Kings,2,Pacific,Western,72,2,126,0.5714285714285714,72,0,72,0
2014-15,2015-03-06,Los Angeles Kings,2,Pacific,Western,74,2,128,0.578125,74,0,74,0
2014-15,2015-03-08,Los Angeles Kings,1,Pacific,Western,75,2,130,0.5769230769230769,77,-2,77,-2
2014-15,2015-03-11,Los Angeles Kings,2,Pacific,Western,77,2,132,0.5833333333333334,77,0,77,0
2014-15,2015-03-13,Los Angeles Kings,2,Pacific,Western,79,2,134,0.5895522388059702,79,0,79,0
2014-15,2015-03-15,Los Angeles Kings,0,Pacific,Western,79,2,136,0.5808823529411765,81,-2,80,-1
2014-15,2015-03-17,Los Angeles Kings,2,Pacific,Western,81,2,138,0.5869565217391305,81,0,81,0
2014-15,2015-03-19,Los Angeles Kings,1,Pacific,Western,82,2,140,0.5857142857142857,82,0,82,0
2014-15,2015-03-21,Los Angeles Kings,0,Pacific,Western,82,2,142,0.5774647887323944,84,-2,84,-2
2014-15,2015-03-23,Los Angeles Kings,2,Pacific,Western,84,2,144,0.5833333333333334,84,0,84,0
2014-15,2015-03-24,Los Angeles Kings,2,Pacific,Western,86,2,146,0.589041095890411,86,0,86,0
2014-15,2015-03-26,Los Angeles Kings,2,Pacific,Western,88,2,148,0.5945945945945946,88,0,88,0
2014-15,2015-03-29,Los Angeles Kings,0,Pacific,Western,88,2,150,0.5866666666666667,89,-1,89,-1
2014-15,2015-03-31,Los Angeles Kings,0,Pacific,Western,88,2,152,0.5789473684210527,91,-3,90,-2
2014-15,2015-04-03,Los Angeles Kings,2,Pacific,Western,90,2,154,0.5844155844155844,91,-1,90,0
2014-15,2015-04-05,Los Angeles Kings,2,Pacific,Western,92,2,156,0.5897435897435898,93,-1,92,0
2014-15,2015-04-07,Los Angeles Kings,1,Pacific,Western,93,2,158,0.5886075949367089,93,0,93,0
2014-15,2015-04-08,Los Angeles Kings,0,Pacific,Western,93,2,160,0.58125,95,-2,95,-2
2014-15,2015-04-10,Los Angeles Kings,0,Pacific,Western,93,2,162,0.5740740740740741,97,-4,97,-4
2014-15,2015-04-11,Los Angeles Kings,2,Pacific,Western,95,2,164,0.5792682926829268,97,-2,97,-2
2014-15,2014-10-10,Minnesota Wild,2,Central,Western,2,2,2,1.0,2,0,1,1
2014-15,2014-10-12,Minnesota Wild,2,Central,Western,4,2,4,1.0,4,0,2,2
2014-15,2014-10-18,Minnesota Wild,0,Central,Western,4,2,6,0.6666666666666666,5,-1,5,-1
2014-15,2014-10-19,Minnesota Wild,0,Central,Western,4,2,8,0.5,6,-2,6,-2
2014-15,2014-10-24,Minnesota Wild,2,Central,Western,6,2,10,0.6,9,-3,8,-2
2014-15,2014-10-26,Minnesota Wild,2,Central,Western,8,2,12,0.6666666666666666,9,-1,8,0
2014-15,2014-10-27,Minnesota Wild,0,Central,Western,8,2,14,0.5714285714285714,9,-1,10,-2
2014-15,2014-10-28,Minnesota Wild,2,Central,Western,10,2,16,0.625,10,0,10,0
2014-15,2014-10-31,Minnesota Wild,2,Central,Western,12,2,18,0.6666666666666666,12,0,12,0
2014-15,2014-11-02,Minnesota Wild,2,Central,Western,14,2,20,0.7,13,1,13,1
2014-15,2014-11-05,Minnesota Wild,0,Central,Western,14,2,22,0.6363636363636364,15,-1,15,-1
2014-15,2014-11-07,Minnesota Wild,0,Central,Western,14,2,24,0.5833333333333334,16,-2,16,-2
2014-15,2014-11-09,Minnesota Wild,0,Central,Western,14,2,26,0.5384615384615384,18,-4,18,-4
2014-15,2014-11-12,Minnesota Wild,0,Central,Western,14,2,28,0.5,19,-5,18,-4
2014-15,2014-11-14,Minnesota Wild,2,Central,Western,16,2,30,0.5333333333333333,20,-4,20,-4
2014-15,2014-11-15,Minnesota Wild,2,Central,Western,18,2,32,0.5625,20,-2,20,-2
2014-15,2014-11-16,Minnesota Wild,2,Central,Western,20,2,34,0.5882352941176471,21,-1,21,-1
2014-15,2014-11-21,Minnesota Wild,2,Central,Western,22,2,36,0.6111111111111112,23,-1,23,-1
2014-15,2014-11-23,Minnesota Wild,0,Central,Western,22,2,38,0.5789473684210527,25,-3,24,-2
2014-15,2014-11-25,Minnesota Wild,2,Central,Western,24,2,40,0.6,25,-1,24,0
2014-15,2014-11-27,Minnesota Wild,0,Central,Western,24,2,42,0.5714285714285714,27,-3,27,-3
2014-15,2014-11-29,Minnesota Wild,2,Central,Western,26,2,44,0.5909090909090909,29,-3,28,-2
2014-15,2014-11-30,Minnesota Wild,1,Central,Western,27,2,46,0.5869565217391305,31,-4,28,-1
2014-15,2014-12-04,Minnesota Wild,2,Central,Western,29,2,48,0.6041666666666666,33,-4,30,-1
2014-15,2014-12-06,Minnesota Wild,0,Central,Western,29,2,50,0.58,35,-6,32,-3
2014-15,2014-12-10,Minnesota Wild,2,Central,Western,31,2,52,0.5961538461538461,38,-7,34,-3
2014-15,2014-12-12,Minnesota Wild,0,Central,Western,31,2,54,0.5740740740740741,40,-9,36,-5
2014-15,2014-12-14,Minnesota Wild,2,Central,Western,33,2,56,0.5892857142857143,40,-7,36,-3
2014-15,2014-12-17,Minnesota Wild,0,Central,Western,33,2,58,0.5689655172413793,42,-9,36,-3
2014-15,2014-12-18,Minnesota Wild,1,Central,Western,34,2,60,0.5666666666666667,42,-8,36,-2
2014-15,2014-12-21,Minnesota Wild,1,Central,Western,35,2,62,0.5645161290322581,44,-9,40,-5
2014-15,2014-12-24,Minnesota Wild,0,Central,Western,35,2,64,0.546875,45,-10,41,-6
2014-15,2014-12-28,Minnesota Wild,1,Central,Western,36,2,66,0.5454545454545454,45,-9,42,-6
2014-15,2014-12-30,Minnesota Wild,2,Central,Western,38,2,68,0.5588235294117647,47,-9,43,-5
2014-15,2015-01-01,Minnesota Wild,0,Central,Western,38,2,70,0.5428571428571428,47,-9,45,-7
2014-15,2015-01-03,Minnesota Wild,2,Central,Western,40,2,72,0.5555555555555556,47,-7,45,-5
2014-15,2015-01-04,Minnesota Wild,0,Central,Western,40,2,74,0.5405405405405406,49,-9,45,-5
2014-15,2015-01-07,Minnesota Wild,1,Central,Western,41,2,76,0.5394736842105263,51,-10,47,-6
2014-15,2015-01-09,Minnesota Wild,0,Central,Western,41,2,78,0.5256410256410257,53,-12,47,-6
2014-15,2015-01-10,Minnesota Wild,0,Central,Western,41,2,80,0.5125,53,-12,47,-6
2014-15,2015-01-12,Minnesota Wild,0,Central,Western,41,2,82,0.5,55,-14,48,-7
2014-15,2015-01-14,Minnesota Wild,0,Central,Western,41,2,84,0.4880952380952381,57,-16,49,-8
2014-15,2015-01-16,Minnesota Wild,2,Central,Western,43,2,86,0.5,58,-15,50,-7
2014-15,2015-01-18,Minnesota Wild,2,Central,Western,45,2,88,0.5113636363636364,58,-13,51,-6
2014-15,2015-01-20,Minnesota Wild,0,Central,Western,45,2,90,0.5,58,-13,53,-8
2014-15,2015-01-21,Minnesota Wild,1,Central,Western,46,2,92,0.5,60,-14,53,-7
2014-15,2015-01-28,Minnesota Wild,2,Central,Western,48,2,94,0.5106382978723404,62,-14,55,-7
2014-15,2015-01-30,Minnesota Wild,2,Central,Western,50,2,96,0.5208333333333334,62,-12,55,-5
2014-15,2015-02-01,Minnesota Wild,2,Central,Western,52,2,98,0.5306122448979592,64,-12,57,-5
2014-15,2015-02-04,Minnesota Wild,2,Central,Western,54,2,100,0.54,64,-10,59,-5
2014-15,2015-02-08,Minnesota Wild,2,Central,Western,56,2,102,0.5490196078431373,68,-12,61,-5
2014-15,2015-02-10,Minnesota Wild,2,Central,Western,58,2,104,0.5576923076923077,69,-11,61,-3
2014-15,2015-02-11,Minnesota Wild,1,Central,Western,59,2,106,0.5566037735849056,69,-10,61,-2
2014-15,2015-02-13,Minnesota Wild,2,Central,Western,61,2,108,0.5648148148148148,70,-9,63,-2
2014-15,2015-02-15,Minnesota Wild,2,Central,Western,63,2,110,0.5727272727272728,74,-11,65,-2
2014-15,2015-02-17,Minnesota Wild,0,Central,Western,63,2,112,0.5625,74,-11,66,-3
2014-15,2015-02-19,Minnesota Wild,2,Central,Western,65,2,114,0.5701754385964912,75,-10,66,-1
2014-15,2015-02-21,Minnesota Wild,2,Central,Western,67,2,116,0.5775862068965517,75,-8,68,-1
2014-15,2015-02-23,Minnesota Wild,2,Central,Western,69,2,118,0.5847457627118644,75,-6,68,1
2014-15,2015-02-25,Minnesota Wild,0,Central,Western,69,2,120,0.575,77,-8,69,0
2014-15,2015-02-27,Minnesota Wild,2,Central,Western,71,2,122,0.5819672131147541,79,-8,70,1
2014-15,2015-03-01,Minnesota Wild,2,Central,Western,73,2,124,0.5887096774193549,79,-6,70,3
2014-15,2015-03-04,Minnesota Wild,2,Central,Western,75,2,126,0.5952380952380952,81,-6,72,3
2014-15,2015-03-06,Minnesota Wild,2,Central,Western,77,2,128,0.6015625,81,-4,74,3
2014-15,2015-03-07,Minnesota Wild,2,Central,Western,79,2,130,0.6076923076923076,83,-4,76,3
2014-15,2015-03-08,Minnesota Wild,0,Central,Western,79,2,132,0.5984848484848485,84,-5,77,2
2014-15,2015-03-11,Minnesota Wild,2,Central,Western,81,2,134,0.6044776119402985,84,-3,77,4
2014-15,2015-03-14,Minnesota Wild,0,Central,Western,81,2,136,0.5955882352941176,88,-7,80,1
2014-15,2015-03-15,Minnesota Wild,2,Central,Western,83,2,138,0.6014492753623188,88,-5,80,3
2014-15,2015-03-18,Minnesota Wild,2,Central,Western,85,2,140,0.6071428571428571,90,-5,81,4
2014-15,2015-03-20,Minnesota Wild,0,Central,Western,85,2,142,0.5985915492957746,92,-7,83,2
2014-15,2015-03-21,Minnesota Wild,2,Central,Western,87,2,144,0.6041666666666666,92,-5,84,3
2014-15,2015-03-23,Minnesota Wild,2,Central,Western,89,2,146,0.6095890410958904,94,-5,84,5
2014-15,2015-03-24,Minnesota Wild,2,Central,Western,91,2,148,0.6148648648648649,94,-3,86,5
2014-15,2015-03-28,Minnesota Wild,2,Central,Western,93,2,150,0.62,94,-1,88,5
2014-15,2015-03-29,Minnesota Wild,2,Central,Western,95,2,152,0.625,96,-1,89,6
2014-15,2015-04-03,Minnesota Wild,0,Central,Western,95,2,154,0.6168831168831169,100,-5,90,5
2014-15,2015-04-04,Minnesota Wild,1,Central,Western,96,2,156,0.6153846153846154,100,-4,91,5
2014-15,2015-04-07,Minnesota Wild,0,Central,Western,96,2,158,0.6075949367088608,102,-6,93,3
2014-15,2015-04-08,Minnesota Wild,2,Central,Western,98,2,160,0.6125,102,-4,95,3
2014-15,2015-04-10,Minnesota Wild,2,Central,Western,100,2,162,0.6172839506172839,102,-2,97,3
2014-15,2015-04-11,Minnesota Wild,0,Central,Western,100,2,164,0.6097560975609756,102,-2,97,3
2014-15,2014-10-08,Montréal Canadiens,2,Atlantic,Eastern,2,2,2,1.0,0,2,0,2
2014-15,2014-10-09,Montréal Canadiens,2,Atlantic,Eastern,4,2,4,1.0,2,2,1,3
2014-15,2014-10-11,Montréal Canadiens,2,Atlantic,Eastern,6,2,6,1.0,2,4,2,4
2014-15,2014-10-13,Montréal Canadiens,0,Atlantic,Eastern,6,2,8,0.75,4,2,3,3
2014-15,2014-10-16,Montréal Canadiens,2,Atlantic,Eastern,8,2,10,0.8,5,3,4,4
2014-15,2014-10-18,Montréal Canadiens,2,Atlantic,Eastern,10,2,12,0.8333333333333334,7,3,6,4
2014-15,2014-10-21,Montréal Canadiens,2,Atlantic,Eastern,12,2,14,0.8571428571428571,8,4,7,5
2014-15,2014-10-25,Montréal Canadiens,2,Atlantic,Eastern,14,2,16,0.875,10,4,8,6
2014-15,2014-10-28,Montréal Canadiens,0,Atlantic,Eastern,14,2,18,0.7777777777777778,11,3,10,4
2014-15,2014-10-29,Montréal Canadiens,2,Atlantic,Eastern,16,2,20,0.8,12,4,10,6
2014-15,2014-10-31,Montréal Canadiens,1,Atlantic,Eastern,17,2,22,0.7727272727272727,14,3,12,5
2014-15,2014-11-03,Montréal Canadiens,0,Atlantic,Eastern,17,2,24,0.7083333333333334,15,2,12,5
2014-15,2014-11-05,Montréal Canadiens,0,Atlantic,Eastern,17,2,26,0.6538461538461539,16,1,13,4
2014-15,2014-11-06,Montréal Canadiens,2,Atlantic,Eastern,19,2,28,0.6785714285714286,16,3,14,5
2014-15,2014-11-09,Montréal Canadiens,2,Atlantic,Eastern,21,2,30,0.7,19,2,16,5
2014-15,2014-11-12,Montréal Canadiens,2,Atlantic,Eastern,23,2,32,0.71875,20,3,18,5
2014-15,2014-11-14,Montréal Canadiens,2,Atlantic,Eastern,25,2,34,0.7352941176470589,20,5,19,6
2014-15,2014-11-16,Montréal Canadiens,2,Atlantic,Eastern,27,2,36,0.75,22,5,20,7
2014-15,2014-11-17,Montréal Canadiens,2,Atlantic,Eastern,29,2,38,0.7631578947368421,22,7,20,9
2014-15,2014-11-19,Montréal Canadiens,0,Atlantic,Eastern,29,2,40,0.725,24,5,20,9
2014-15,2014-11-21,Montréal Canadiens,2,Atlantic,Eastern,31,2,42,0.7380952380952381,25,6,22,9
2014-15,2014-11-23,Montréal Canadiens,2,Atlantic,Eastern,33,2,44,0.75,26,7,22,11
2014-15,2014-11-24,Montréal Canadiens,0,Atlantic,Eastern,33,2,46,0.717391304347826,26,7,22,11
2014-15,2014-11-29,Montréal Canadiens,0,Atlantic,Eastern,33,2,48,0.6875,31,2,25,8
2014-15,2014-11-30,Montréal Canadiens,1,Atlantic,Eastern,34,2,50,0.68,33,1,26,8
2014-15,2014-12-02,Montréal Canadiens,2,Atlantic,Eastern,36,2,52,0.6923076923076923,33,3,26,10
2014-15,2014-12-04,Montréal Canadiens,0,Atlantic,Eastern,36,2,54,0.6666666666666666,33,3,26,10
2014-15,2014-12-06,Montréal Canadiens,0,Atlantic,Eastern,36,2,56,0.6428571428571429,35,1,27,9
2014-15,2014-12-07,Montréal Canadiens,0,Atlantic,Eastern,36,2,58,0.6206896551724138,36,0,29,7
2014-15,2014-12-10,Montréal Canadiens,2,Atlantic,Eastern,38,2,60,0.6333333333333333,37,1,30,8
2014-15,2014-12-13,Montréal Canadiens,2,Atlantic,Eastern,40,2,62,0.6451612903225806,40,0,31,9
2014-15,2014-12-17,Montréal Canadiens,2,Atlantic,Eastern,42,2,64,0.65625,42,0,34,8
2014-15,2014-12-19,Montréal Canadiens,0,Atlantic,Eastern,42,2,66,0.6363636363636364,42,0,36,6
2014-15,2014-12-21,Montréal Canadiens,2,Atlantic,Eastern,44,2,68,0.6470588235294118,43,1,36,8
2014-15,2014-12-24,Montréal Canadiens,2,Atlantic,Eastern,46,2,70,0.6571428571428571,45,1,40,6
2014-15,2014-12-30,Montréal Canadiens,2,Atlantic,Eastern,48,2,72,0.6666666666666666,47,1,42,6
2014-15,2014-12-31,Montréal Canadiens,2,Atlantic,Eastern,50,2,74,0.6756756756756757,47,3,43,7
2014-15,2015-01-03,Montréal Canadiens,2,Atlantic,Eastern,52,2,76,0.6842105263157895,49,3,44,8
2014-15,2015-01-04,Montréal Canadiens,2,Atlantic,Eastern,54,2,78,0.6923076923076923,49,5,45,9
2014-15,2015-01-07,Montréal Canadiens,0,Atlantic,Eastern,54,2,80,0.675,51,3,45,9
2014-15,2015-01-11,Montréal Canadiens,1,Atlantic,Eastern,55,2,82,0.6707317073170732,53,2,50,5
2014-15,2015-01-15,Montréal Canadiens,2,Atlantic,Eastern,57,2,84,0.6785714285714286,55,2,52,5
2014-15,2015-01-16,Montréal Canadiens,0,Atlantic,Eastern,57,2,86,0.6627906976744186,57,0,52,5
2014-15,2015-01-18,Montréal Canadiens,2,Atlantic,Eastern,59,2,88,0.6704545454545454,59,0,54,5
2014-15,2015-01-21,Montréal Canadiens,2,Atlantic,Eastern,61,2,90,0.6777777777777778,61,0,56,5
2014-15,2015-01-28,Montréal Canadiens,2,Atlantic,Eastern,63,2,92,0.6847826086956522,63,0,57,6
2014-15,2015-01-30,Montréal Canadiens,2,Atlantic,Eastern,65,2,94,0.6914893617021277,65,0,58,7
2014-15,2015-01-31,Montréal Canadiens,2,Atlantic,Eastern,67,2,96,0.6979166666666666,66,1,58,9
2014-15,2015-02-01,Montréal Canadiens,0,Atlantic,Eastern,67,2,98,0.6836734693877551,67,0,60,7
2014-15,2015-02-04,Montréal Canadiens,0,Atlantic,Eastern,67,2,100,0.67,67,0,61,6
2014-15,2015-02-08,Montréal Canadiens,2,Atlantic,Eastern,69,2,102,0.6764705882352942,69,0,63,6
2014-15,2015-02-09,Montréal Canadiens,2,Atlantic,Eastern,71,2,104,0.6826923076923077,71,0,63,8
2014-15,2015-02-11,Montréal Canadiens,2,Atlantic,Eastern,73,2,106,0.6886792452830188,71,2,63,10
2014-15,2015-02-13,Montréal Canadiens,1,Atlantic,Eastern,74,2,108,0.6851851851851852,71,3,63,11
2014-15,2015-02-15,Montréal Canadiens,2,Atlantic,Eastern,76,2,110,0.6909090909090909,72,4,63,13
2014-15,2015-02-17,Montréal Canadiens,2,Atlantic,Eastern,78,2,112,0.6964285714285714,72,6,64,14
2014-15,2015-02-19,Montréal Canadiens,0,Atlantic,Eastern,78,2,114,0.6842105263157895,74,4,65,13
2014-15,2015-02-20,Montréal Canadiens,1,Atlantic,Eastern,79,2,116,0.6810344827586207,74,5,65,14
2014-15,2015-02-22,Montréal Canadiens,2,Atlantic,Eastern,81,2,118,0.6864406779661016,76,5,67,14
2014-15,2015-02-25,Montréal Canadiens,2,Atlantic,Eastern,83,2,120,0.6916666666666667,77,6,67,16
2014-15,2015-02-27,Montréal Canadiens,2,Atlantic,Eastern,85,2,122,0.6967213114754098,79,6,67,18
2014-15,2015-03-01,Montréal Canadiens,2,Atlantic,Eastern,87,2,124,0.7016129032258065,81,6,69,18
2014-15,2015-03-03,Montréal Canadiens,0,Atlantic,Eastern,87,2,126,0.6904761904761905,81,6,71,16
2014-15,2015-03-05,Montréal Canadiens,0,Atlantic,Eastern,87,2,128,0.6796875,83,4,69,18
2014-15,2015-03-06,Montréal Canadiens,1,Atlantic,Eastern,88,2,130,0.676923076923077,83,5,72,16
2014-15,2015-03-08,Montréal Canadiens,2,Atlantic,Eastern,90,2,132,0.6818181818181818,83,7,76,14
2014-15,2015-03-10,Montréal Canadiens,1,Atlantic,Eastern,91,2,134,0.6791044776119403,85,6,78,13
2014-15,2015-03-12,Montréal Canadiens,0,Atlantic,Eastern,91,2,136,0.6691176470588235,85,6,80,11
2014-15,2015-03-14,Montréal Canadiens,2,Atlantic,Eastern,93,2,138,0.6739130434782609,85,8,82,11
2014-15,2015-03-16,Montréal Canadiens,0,Atlantic,Eastern,93,2,140,0.6642857142857143,87,6,82,11
2014-15,2015-03-17,Montréal Canadiens,2,Atlantic,Eastern,95,2,142,0.6690140845070423,87,8,83,12
2014-15,2015-03-19,Montréal Canadiens,2,Atlantic,Eastern,97,2,144,0.6736111111111112,87,10,83,14
2014-15,2015-03-21,Montréal Canadiens,2,Atlantic,Eastern,99,2,146,0.678082191780822,87,12,84,15
2014-15,2015-03-25,Montréal Canadiens,1,Atlantic,Eastern,100,2,148,0.6756756756756757,90,10,85,15
2014-15,2015-03-27,Montréal Canadiens,0,Atlantic,Eastern,100,2,150,0.6666666666666666,90,10,85,15
2014-15,2015-03-28,Montréal Canadiens,2,Atlantic,Eastern,102,2,152,0.6710526315789473,92,10,87,15
2014-15,2015-03-30,Montréal Canadiens,0,Atlantic,Eastern,102,2,154,0.6623376623376623,92,10,89,13
2014-15,2015-04-02,Montréal Canadiens,1,Atlantic,Eastern,103,2,156,0.6602564102564102,93,10,93,10
2014-15,2015-04-03,Montréal Canadiens,1,Atlantic,Eastern,104,2,158,0.6582278481012658,93,11,93,11
2014-15,2015-04-05,Montréal Canadiens,2,Atlantic,Eastern,106,2,160,0.6625,95,11,95,11
2014-15,2015-04-09,Montréal Canadiens,2,Atlantic,Eastern,108,2,162,0.6666666666666666,98,10,96,12
2014-15,2015-04-11,Montréal Canadiens,2,Atlantic,Eastern,110,2,164,0.6707317073170732,100,10,98,12
2014-15,2014-10-10,Nashville Predators,2,Central,Western,2,2,2,1.0,2,0,1,1
2014-15,2014-10-12,Nashville Predators,2,Central,Western,4,2,4,1.0,4,0,2,2
2014-15,2014-10-15,Nashville Predators,1,Central,Western,5,2,6,0.8333333333333334,4,1,4,1
2014-15,2014-10-18,Nashville Predators,2,Central,Western,7,2,8,0.875,5,2,5,2
2014-15,2014-10-19,Nashville Predators,1,Central,Western,8,2,10,0.8,6,2,6,2
2014-15,2014-10-22,Nashville Predators,2,Central,Western,10,2,12,0.8333333333333334,8,2,6,4
2014-15,2014-10-24,Nashville Predators,2,Central,Western,12,2,14,0.8571428571428571,9,3,8,4
2014-15,2014-10-26,Nashville Predators,0,Central,Western,12,2,16,0.75,9,3,8,4
2014-15,2014-10-30,Nashville Predators,2,Central,Western,14,2,18,0.7777777777777778,11,3,11,3
2014-15,2014-11-01,Nashville Predators,0,Central,Western,14,2,20,0.7,12,2,12,2
2014-15,2014-11-03,Nashville Predators,2,Central,Western,16,2,22,0.7272727272727273,13,3,13,3
2014-15,2014-11-05,Nashville Predators,0,Central,Western,16,2,24,0.6666666666666666,15,1,15,1
2014-15,2014-11-07,Nashville Predators,2,Central,Western,18,2,26,0.6923076923076923,16,2,16,2
2014-15,2014-11-09,Nashville Predators,2,Central,Western,20,2,28,0.7142857142857143,18,2,18,2
2014-15,2014-11-12,Nashville Predators,2,Central,Western,22,2,30,0.7333333333333333,19,3,18,4
2014-15,2014-11-14,Nashville Predators,0,Central,Western,22,2,32,0.6875,20,2,20,2
2014-15,2014-11-16,Nashville Predators,2,Central,Western,24,2,34,0.7058823529411765,21,3,21,3
2014-15,2014-11-19,Nashville Predators,2,Central,Western,26,2,36,0.7222222222222222,23,3,22,4
2014-15,2014-11-21,Nashville Predators,0,Central,Western,26,2,38,0.6842105263157895,23,3,23,3
2014-15,2014-11-23,Nashville Predators,2,Central,Western,28,2,40,0.7,25,3,24,4
2014-15,2014-11-26,Nashville Predators,2,Central,Western,30,2,42,0.7142857142857143,25,5,25,5
2014-15,2014-11-28,Nashville Predators,2,Central,Western,32,2,44,0.7272727272727273,29,3,27,5
2014-15,2014-11-30,Nashville Predators,2,Central,Western,34,2,46,0.7391304347826086,31,3,28,6
2014-15,2014-12-03,Nashville Predators,0,Central,Western,34,2,48,0.7083333333333334,31,3,28,6
2014-15,2014-12-05,Nashville Predators,2,Central,Western,36,2,50,0.72,33,3,30,6
2014-15,2014-12-07,Nashville Predators,0,Central,Western,36,2,52,0.6923076923076923,36,0,33,3
2014-15,2014-12-10,Nashville Predators,2,Central,Western,38,2,54,0.7037037037037037,38,0,34,4
2014-15,2014-12-12,Nashville Predators,2,Central,Western,40,2,56,0.7142857142857143,40,0,36,4
2014-15,2014-12-14,Nashville Predators,0,Central,Western,40,2,58,0.6896551724137931,40,0,36,4
2014-15,2014-12-17,Nashville Predators,2,Central,Western,42,2,60,0.7,42,0,36,6
2014-15,2014-12-21,Nashville Predators,2,Central,Western,44,2,62,0.7096774193548387,44,0,40,4
2014-15,2014-12-23,Nashville Predators,2,Central,Western,46,2,64,0.71875,45,1,41,5
2014-15,2014-12-24,Nashville Predators,0,Central,Western,46,2,66,0.696969696969697,45,1,41,5
2014-15,2014-12-28,Nashville Predators,2,Central,Western,48,2,68,0.7058823529411765,45,3,42,6
2014-15,2014-12-30,Nashville Predators,1,Central,Western,49,2,70,0.7,47,2,43,6
2014-15,2014-12-31,Nashville Predators,2,Central,Western,51,2,72,0.7083333333333334,47,4,43,8
2014-15,2015-01-03,Nashville Predators,2,Central,Western,53,2,74,0.7162162162162162,47,6,45,8
2014-15,2015-01-05,Nashville Predators,1,Central,Western,54,2,76,0.7105263157894737,49,5,45,9
2014-15,2015-01-07,Nashville Predators,2,Central,Western,56,2,78,0.717948717948718,51,5,47,9
2014-15,2015-01-09,Nashville Predators,2,Central,Western,58,2,80,0.725,53,5,47,11
2014-15,2015-01-10,Nashville Predators,2,Central,Western,60,2,82,0.7317073170731707,53,7,47,13
2014-15,2015-01-14,Nashville Predators,2,Central,Western,62,2,84,0.7380952380952381,57,5,49,13
2014-15,2015-01-17,Nashville Predators,2,Central,Western,64,2,86,0.7441860465116279,58,6,50,14
2014-15,2015-01-18,Nashville Predators,0,Central,Western,64,2,88,0.7272727272727273,58,6,51,13
2014-15,2015-01-21,Nashville Predators,1,Central,Western,65,2,90,0.7222222222222222,60,5,53,12
2014-15,2015-01-28,Nashville Predators,2,Central,Western,67,2,92,0.7282608695652174,62,5,55,12
2014-15,2015-01-30,Nashville Predators,1,Central,Western,68,2,94,0.723404255319149,62,6,55,13
2014-15,2015-01-31,Nashville Predators,0,Central,Western,68,2,96,0.7083333333333334,64,4,55,13
2014-15,2015-02-01,Nashville Predators,2,Central,Western,70,2,98,0.7142857142857143,64,6,57,13
2014-15,2015-02-04,Nashville Predators,2,Central,Western,72,2,100,0.72,64,8,59,13
2014-15,2015-02-06,Nashville Predators,0,Central,Western,72,2,102,0.7058823529411765,64,8,59,13
2014-15,2015-02-07,Nashville Predators,2,Central,Western,74,2,104,0.7115384615384616,66,8,59,15
2014-15,2015-02-08,Nashville Predators,2,Central,Western,76,2,106,0.7169811320754716,68,8,61,15
2014-15,2015-02-11,Nashville Predators,2,Central,Western,78,2,108,0.7222222222222222,69,9,61,17
2014-15,2015-02-13,Nashville Predators,2,Central,Western,80,2,110,0.7272727272727273,70,10,63,17
2014-15,2015-02-15,Nashville Predators,2,Central,Western,82,2,112,0.7321428571428571,74,8,65,17
2014-15,2015-02-18,Nashville Predators,2,Central,Western,84,2,114,0.7368421052631579,74,10,66,18
2014-15,2015-02-20,Nashville Predators,0,Central,Western,84,2,116,0.7241379310344828,75,9,68,16
2014-15,2015-02-21,Nashville Predators,1,Central,Western,85,2,118,0.7203389830508474,75,10,68,17
2014-15,2015-02-22,Nashville Predators,2,Central,Western,87,2,120,0.725,75,12,68,19
2014-15,2015-02-25,Nashville Predators,2,Central,Western,89,2,122,0.7295081967213115,77,12,69,20
2014-15,2015-02-27,Nashville Predators,0,Central,Western,89,2,124,0.717741935483871,79,10,70,19
2014-15,2015-02-28,Nashville Predators,0,Central,Western,89,2,126,0.7063492063492064,79,10,70,19
2014-15,2015-03-03,Nashville Predators,0,Central,Western,89,2,128,0.6953125,81,8,70,19
2014-15,2015-03-04,Nashville Predators,0,Central,Western,89,2,130,0.6846153846153846,81,8,72,17
2014-15,2015-03-06,Nashville Predators,0,Central,Western,89,2,132,0.6742424242424242,81,8,74,15
2014-15,2015-03-08,Nashville Predators,0,Central,Western,89,2,134,0.664179104477612,84,5,77,12
2014-15,2015-03-10,Nashville Predators,2,Central,Western,91,2,136,0.6691176470588235,84,7,77,14
2014-15,2015-03-13,Nashville Predators,0,Central,Western,91,2,138,0.6594202898550725,86,5,79,12
2014-15,2015-03-15,Nashville Predators,2,Central,Western,93,2,140,0.6642857142857143,88,5,80,13
2014-15,2015-03-16,Nashville Predators,0,Central,Western,93,2,142,0.6549295774647887,88,5,80,13
2014-15,2015-03-18,Nashville Predators,1,Central,Western,94,2,144,0.6527777777777778,90,4,81,13
2014-15,2015-03-22,Nashville Predators,2,Central,Western,96,2,146,0.6575342465753424,92,4,84,12
2014-15,2015-03-25,Nashville Predators,2,Central,Western,98,2,148,0.6621621621621622,94,4,86,12
2014-15,2015-03-26,Nashville Predators,2,Central,Western,100,2,150,0.6666666666666666,94,6,88,12
2014-15,2015-03-28,Nashville Predators,2,Central,Western,102,2,152,0.6710526315789473,94,8,88,14
2014-15,2015-03-29,Nashville Predators,0,Central,Western,102,2,154,0.6623376623376623,96,6,89,13
2014-15,2015-04-01,Nashville Predators,1,Central,Western,103,2,156,0.6602564102564102,98,5,90,13
2014-15,2015-04-05,Nashville Predators,1,Central,Western,104,2,158,0.6582278481012658,102,2,92,12
2014-15,2015-04-08,Nashville Predators,0,Central,Western,104,2,160,0.65,102,2,95,9
2014-15,2015-04-10,Nashville Predators,0,Central,Western,104,2,162,0.6419753086419753,102,2,97,7
2014-15,2015-04-12,Nashville Predators,0,Central,Western,104,2,164,0.6341463414634146,102,2,97,7
2014-15,2014-10-09,New Jersey Devils,2,Metropolitan,Eastern,2,2,2,1.0,2,0,1,1
2014-15,2014-10-11,New Jersey Devils,2,Metropolitan,Eastern,4,2,4,1.0,4,0,2,2
2014-15,2014-10-14,New Jersey Devils,2,Metropolitan,Eastern,6,2,6,1.0,4,2,4,2
2014-15,2014-10-16,New Jersey Devils,0,Metropolitan,Eastern,6,2,8,0.75,6,0,4,2
2014-15,2014-10-18,New Jersey Devils,0,Metropolitan,Eastern,6,2,10,0.6,6,0,6,0
2014-15,2014-10-21,New Jersey Devils,1,Metropolitan,Eastern,7,2,12,0.5833333333333334,8,-1,7,0
2014-15,2014-10-24,New Jersey Devils,1,Metropolitan,Eastern,8,2,14,0.5714285714285714,8,0,8,0
2014-15,2014-10-25,New Jersey Devils,2,Metropolitan,Eastern,10,2,16,0.625,8,2,8,2
2014-15,2014-10-28,New Jersey Devils,0,Metropolitan,Eastern,10,2,18,0.5555555555555556,10,0,10,0
2014-15,2014-10-30,New Jersey Devils,2,Metropolitan,Eastern,12,2,20,0.6,12,0,12,0
2014-15,2014-11-01,New Jersey Devils,2,Metropolitan,Eastern,14,2,22,0.6363636363636364,12,2,12,2
2014-15,2014-11-05,New Jersey Devils,0,Metropolitan,Eastern,14,2,24,0.5833333333333334,12,2,13,1
2014-15,2014-11-07,New Jersey Devils,0,Metropolitan,Eastern,14,2,26,0.5384615384615384,14,0,14,0
2014-15,2014-11-08,New Jersey Devils,0,Metropolitan,Eastern,14,2,28,0.5,14,0,14,0
2014-15,2014-11-11,New Jersey Devils,0,Metropolitan,Eastern,14,2,30,0.4666666666666667,16,-2,16,-2
2014-15,2014-11-12,New Jersey Devils,2,Metropolitan,Eastern,16,2,32,0.5,17,-1,18,-2
2014-15,2014-11-15,New Jersey Devils,2,Metropolitan,Eastern,18,2,34,0.5294117647058824,18,0,20,-2
2014-15,2014-11-16,New Jersey Devils,0,Metropolitan,Eastern,18,2,36,0.5,18,0,20,-2
2014-15,2014-11-19,New Jersey Devils,0,Metropolitan,Eastern,18,2,38,0.47368421052631576,19,-1,20,-2
2014-15,2014-11-22,New Jersey Devils,2,Metropolitan,Eastern,20,2,40,0.5,21,-1,22,-2
2014-15,2014-11-23,New Jersey Devils,1,Metropolitan,Eastern,21,2,42,0.5,21,0,22,-1
2014-15,2014-11-26,New Jersey Devils,0,Metropolitan,Eastern,21,2,44,0.4772727272727273,22,-1,24,-3
2014-15,2014-11-29,New Jersey Devils,1,Metropolitan,Eastern,22,2,46,0.4782608695652174,26,-4,25,-3
2014-15,2014-11-30,New Jersey Devils,0,Metropolitan,Eastern,22,2,48,0.4583333333333333,26,-4,26,-4
2014-15,2014-12-03,New Jersey Devils,0,Metropolitan,Eastern,22,2,50,0.44,26,-4,26,-4
2014-15,2014-12-05,New Jersey Devils,2,Metropolitan,Eastern,24,2,52,0.46153846153846156,26,-2,27,-3
2014-15,2014-12-07,New Jersey Devils,0,Metropolitan,Eastern,24,2,54,0.4444444444444444,28,-4,29,-5
2014-15,2014-12-09,New Jersey Devils,2,Metropolitan,Eastern,26,2,56,0.4642857142857143,28,-2,29,-3
2014-15,2014-12-10,New Jersey Devils,1,Metropolitan,Eastern,27,2,58,0.46551724137931033,30,-3,30,-3
2014-15,2014-12-12,New Jersey Devils,0,Metropolitan,Eastern,27,2,60,0.45,31,-4,31,-4
2014-15,2014-12-14,New Jersey Devils,0,Metropolitan,Eastern,27,2,62,0.43548387096774194,33,-6,32,-5
2014-15,2014-12-16,New Jersey Devils,1,Metropolitan,Eastern,28,2,64,0.4375,33,-5,32,-4
2014-15,2014-12-18,New Jersey Devils,0,Metropolitan,Eastern,28,2,66,0.42424242424242425,34,-6,34,-6
2014-15,2014-12-20,New Jersey Devils,2,Metropolitan,Eastern,30,2,68,0.4411764705882353,36,-6,36,-6
2014-15,2014-12-21,New Jersey Devils,0,Metropolitan,Eastern,30,2,70,0.42857142857142855,38,-8,36,-6
2014-15,2014-12-24,New Jersey Devils,1,Metropolitan,Eastern,31,2,72,0.4305555555555556,40,-9,40,-9
2014-15,2014-12-28,New Jersey Devils,0,Metropolitan,Eastern,31,2,74,0.4189189189189189,42,-11,42,-11
2014-15,2014-12-30,New Jersey Devils,2,Metropolitan,Eastern,33,2,76,0.4342105263157895,43,-10,42,-9
2014-15,2015-01-01,New Jersey Devils,0,Metropolitan,Eastern,33,2,78,0.4230769230769231,45,-12,44,-11
2014-15,2015-01-03,New Jersey Devils,0,Metropolitan,Eastern,33,2,80,0.4125,45,-12,44,-11
2014-15,2015-01-04,New Jersey Devils,2,Metropolitan,Eastern,35,2,82,0.4268292682926829,47,-12,45,-10
2014-15,2015-01-07,New Jersey Devils,2,Metropolitan,Eastern,37,2,84,0.44047619047619047,47,-10,45,-8
2014-15,2015-01-09,New Jersey Devils,0,Metropolitan,Eastern,37,2,86,0.43023255813953487,50,-13,48,-11
2014-15,2015-01-10,New Jersey Devils,1,Metropolitan,Eastern,38,2,88,0.4318181818181818,50,-12,50,-12
2014-15,2015-01-15,New Jersey Devils,2,Metropolitan,Eastern,40,2,90,0.4444444444444444,56,-16,52,-12
2014-15,2015-01-17,New Jersey Devils,0,Metropolitan,Eastern,40,2,92,0.43478260869565216,56,-16,54,-14
2014-15,2015-01-20,New Jersey Devils,2,Metropolitan,Eastern,42,2,94,0.44680851063829785,56,-14,54,-12
2014-15,2015-01-29,New Jersey Devils,2,Metropolitan,Eastern,44,2,96,0.4583333333333333,59,-15,57,-13
2014-15,2015-01-31,New Jersey Devils,1,Metropolitan,Eastern,45,2,98,0.45918367346938777,60,-15,58,-13
2014-15,2015-02-01,New Jersey Devils,2,Metropolitan,Eastern,47,2,100,0.47,60,-13,60,-13
2014-15,2015-02-04,New Jersey Devils,2,Metropolitan,Eastern,49,2,102,0.4803921568627451,62,-13,61,-12
2014-15,2015-02-07,New Jersey Devils,2,Metropolitan,Eastern,51,2,104,0.49038461538461536,66,-15,61,-10
2014-15,2015-02-08,New Jersey Devils,0,Metropolitan,Eastern,51,2,106,0.4811320754716981,66,-15,63,-12
2014-15,2015-02-10,New Jersey Devils,0,Metropolitan,Eastern,51,2,108,0.4722222222222222,66,-15,63,-12
2014-15,2015-02-14,New Jersey Devils,0,Metropolitan,Eastern,51,2,110,0.4636363636363636,69,-18,63,-12
2014-15,2015-02-15,New Jersey Devils,0,Metropolitan,Eastern,51,2,112,0.45535714285714285,71,-20,63,-12
2014-15,2015-02-18,New Jersey Devils,2,Metropolitan,Eastern,53,2,114,0.4649122807017544,73,-20,64,-11
2014-15,2015-02-21,New Jersey Devils,2,Metropolitan,Eastern,55,2,116,0.47413793103448276,76,-21,65,-10
2014-15,2015-02-22,New Jersey Devils,2,Metropolitan,Eastern,57,2,118,0.4830508474576271,76,-19,67,-10
2014-15,2015-02-24,New Jersey Devils,2,Metropolitan,Eastern,59,2,120,0.49166666666666664,77,-18,67,-8
2014-15,2015-02-26,New Jersey Devils,0,Metropolitan,Eastern,59,2,122,0.48360655737704916,79,-20,67,-8
2014-15,2015-02-28,New Jersey Devils,1,Metropolitan,Eastern,60,2,124,0.4838709677419355,79,-19,69,-9
2014-15,2015-02-28,New Jersey Devils,2,Metropolitan,Eastern,62,2,126,0.49206349206349204,79,-17,69,-7
2014-15,2015-03-04,New Jersey Devils,2,Metropolitan,Eastern,64,2,128,0.5,81,-17,69,-5
2014-15,2015-03-07,New Jersey Devils,0,Metropolitan,Eastern,64,2,130,0.49230769230769234,83,-19,74,-10
2014-15,2015-03-08,New Jersey Devils,2,Metropolitan,Eastern,66,2,132,0.5,85,-19,76,-10
2014-15,2015-03-11,New Jersey Devils,0,Metropolitan,Eastern,66,2,134,0.4925373134328358,86,-20,78,-12
2014-15,2015-03-13,New Jersey Devils,1,Metropolitan,Eastern,67,2,136,0.49264705882352944,88,-21,80,-13
2014-15,2015-03-15,New Jersey Devils,2,Metropolitan,Eastern,69,2,138,0.5,88,-19,82,-13
2014-15,2015-03-17,New Jersey Devils,2,Metropolitan,Eastern,71,2,140,0.5071428571428571,88,-17,83,-12
2014-15,2015-03-20,New Jersey Devils,2,Metropolitan,Eastern,73,2,142,0.5140845070422535,88,-15,83,-10
2014-15,2015-03-21,New Jersey Devils,0,Metropolitan,Eastern,73,2,144,0.5069444444444444,88,-15,84,-11
2014-15,2015-03-23,New Jersey Devils,0,Metropolitan,Eastern,73,2,146,0.5,90,-17,85,-12
2014-15,2015-03-26,New Jersey Devils,1,Metropolitan,Eastern,74,2,148,0.5,91,-17,85,-11
2014-15,2015-03-28,New Jersey Devils,0,Metropolitan,Eastern,74,2,150,0.49333333333333335,93,-19,87,-13
2014-15,2015-03-29,New Jersey Devils,0,Metropolitan,Eastern,74,2,152,0.4868421052631579,95,-21,89,-15
2014-15,2015-03-31,New Jersey Devils,1,Metropolitan,Eastern,75,2,154,0.487012987012987,95,-20,91,-16
2014-15,2015-04-03,New Jersey Devils,2,Metropolitan,Eastern,77,2,156,0.4935897435897436,96,-19,93,-16
2014-15,2015-04-04,New Jersey Devils,0,Metropolitan,Eastern,77,2,158,0.4873417721518987,97,-20,95,-18
2014-15,2015-04-07,New Jersey Devils,0,Metropolitan,Eastern,77,2,160,0.48125,98,-21,95,-18
2014-15,2015-04-09,New Jersey Devils,1,Metropolitan,Eastern,78,2,162,0.48148148148148145,98,-20,96,-18
2014-15,2015-04-11,New Jersey Devils,0,Metropolitan,Eastern,78,2,164,0.47560975609756095,101,-23,98,-20
2014-15,2014-10-10,New York Islanders,2,Metropolitan,Eastern,2,2,2,1.0,2,0,2,0
2014-15,2014-10-11,New York Islanders,2,Metropolitan,Eastern,4,2,4,1.0,4,0,2,2
2014-15,2014-10-14,New York Islanders,2,Metropolitan,Eastern,6,2,6,1.0,4,2,4,2
2014-15,2014-10-16,New York Islanders,2,Metropolitan,Eastern,8,2,8,1.0,6,2,4,4
2014-15,2014-10-18,New York Islanders,0,Metropolitan,Eastern,8,2,10,0.8,6,2,6,2
2014-15,2014-10-21,New York Islanders,0,Metropolitan,Eastern,8,2,12,0.6666666666666666,8,0,7,1
2014-15,2014-10-23,New York Islanders,2,Metropolitan,Eastern,10,2,14,0.7142857142857143,8,2,8,2
2014-15,2014-10-25,New York Islanders,2,Metropolitan,Eastern,12,2,16,0.75,8,4,8,4
2014-15,2014-10-28,New York Islanders,0,Metropolitan,Eastern,12,2,18,0.6666666666666666,10,2,10,2
2014-15,2014-10-31,New York Islanders,0,Metropolitan,Eastern,12,2,20,0.6,12,0,12,0
2014-15,2014-11-02,New York Islanders,0,Metropolitan,Eastern,12,2,22,0.5454545454545454,12,0,12,0
2014-15,2014-11-06,New York Islanders,2,Metropolitan,Eastern,14,2,24,0.5833333333333334,14,0,14,0
2014-15,2014-11-07,New York Islanders,2,Metropolitan,Eastern,16,2,26,0.6153846153846154,14,2,14,2
2014-15,2014-11-09,New York Islanders,2,Metropolitan,Eastern,18,2,28,0.6428571428571429,16,2,16,2
2014-15,2014-11-12,New York Islanders,2,Metropolitan,Eastern,20,2,30,0.6666666666666666,17,3,18,2
2014-15,2014-11-15,New York Islanders,2,Metropolitan,Eastern,22,2,32,0.6875,18,4,20,2
2014-15,2014-11-16,New York Islanders,0,Metropolitan,Eastern,22,2,34,0.6470588235294118,18,4,20,2
2014-15,2014-11-19,New York Islanders,2,Metropolitan,Eastern,24,2,36,0.6666666666666666,19,5,20,4
2014-15,2014-11-22,New York Islanders,2,Metropolitan,Eastern,26,2,38,0.6842105263157895,21,5,22,4
2014-15,2014-11-23,New York Islanders,2,Metropolitan,Eastern,28,2,40,0.7,21,7,22,6
2014-15,2014-11-25,New York Islanders,2,Metropolitan,Eastern,30,2,42,0.7142857142857143,22,8,22,8
2014-15,2014-11-27,New York Islanders,2,Metropolitan,Eastern,32,2,44,0.7272727272727273,22,10,24,8
2014-15,2014-11-28,New York Islanders,0,Metropolitan,Eastern,32,2,46,0.6956521739130435,24,8,24,8
2014-15,2014-11-30,New York Islanders,2,Metropolitan,Eastern,34,2,48,0.7083333333333334,26,8,26,8
2014-15,2014-12-03,New York Islanders,2,Metropolitan,Eastern,36,2,50,0.72,26,10,26,10
2014-15,2014-12-05,New York Islanders,2,Metropolitan,Eastern,38,2,52,0.7307692307692307,26,12,27,11
2014-15,2014-12-06,New York Islanders,0,Metropolitan,Eastern,38,2,54,0.7037037037037037,26,12,27,11
2014-15,2014-12-10,New York Islanders,0,Metropolitan,Eastern,38,2,56,0.6785714285714286,30,8,30,8
2014-15,2014-12-12,New York Islanders,0,Metropolitan,Eastern,38,2,58,0.6551724137931034,31,7,31,7
2014-15,2014-12-14,New York Islanders,2,Metropolitan,Eastern,40,2,60,0.6666666666666666,33,7,32,8
2014-15,2014-12-16,New York Islanders,2,Metropolitan,Eastern,42,2,62,0.6774193548387096,33,9,32,10
2014-15,2014-12-20,New York Islanders,2,Metropolitan,Eastern,44,2,64,0.6875,36,8,36,8
2014-15,2014-12-21,New York Islanders,2,Metropolitan,Eastern,46,2,66,0.696969696969697,38,8,36,10
2014-15,2014-12-24,New York Islanders,0,Metropolitan,Eastern,46,2,68,0.6764705882352942,40,6,40,6
2014-15,2014-12-28,New York Islanders,1,Metropolitan,Eastern,47,2,70,0.6714285714285714,42,5,42,5
2014-15,2014-12-30,New York Islanders,2,Metropolitan,Eastern,49,2,72,0.6805555555555556,43,6,42,7
2014-15,2014-12-31,New York Islanders,2,Metropolitan,Eastern,51,2,74,0.6891891891891891,44,7,43,8
2014-15,2015-01-03,New York Islanders,2,Metropolitan,Eastern,53,2,76,0.6973684210526315,45,8,44,9
2014-15,2015-01-05,New York Islanders,0,Metropolitan,Eastern,53,2,78,0.6794871794871795,47,6,45,8
2014-15,2015-01-07,New York Islanders,0,Metropolitan,Eastern,53,2,80,0.6625,47,6,45,8
2014-15,2015-01-10,New York Islanders,2,Metropolitan,Eastern,55,2,82,0.6707317073170732,50,5,50,5
2014-15,2015-01-11,New York Islanders,2,Metropolitan,Eastern,57,2,84,0.6785714285714286,52,5,50,7
2014-15,2015-01-14,New York Islanders,2,Metropolitan,Eastern,59,2,86,0.686046511627907,54,5,52,7
2014-15,2015-01-17,New York Islanders,2,Metropolitan,Eastern,61,2,88,0.6931818181818182,56,5,54,7
2014-15,2015-01-18,New York Islanders,0,Metropolitan,Eastern,61,2,90,0.6777777777777778,56,5,54,7
2014-15,2015-01-19,New York Islanders,2,Metropolitan,Eastern,63,2,92,0.6847826086956522,56,7,54,9
2014-15,2015-01-28,New York Islanders,2,Metropolitan,Eastern,65,2,94,0.6914893617021277,58,7,57,8
2014-15,2015-01-30,New York Islanders,0,Metropolitan,Eastern,65,2,96,0.6770833333333334,59,6,58,7
2014-15,2015-01-31,New York Islanders,0,Metropolitan,Eastern,65,2,98,0.6632653061224489,60,5,58,7
2014-15,2015-02-04,New York Islanders,0,Metropolitan,Eastern,65,2,100,0.65,62,3,61,4
2014-15,2015-02-06,New York Islanders,2,Metropolitan,Eastern,67,2,102,0.6568627450980392,64,3,61,6
2014-15,2015-02-08,New York Islanders,0,Metropolitan,Eastern,67,2,104,0.6442307692307693,66,1,63,4
2014-15,2015-02-08,New York Islanders,2,Metropolitan,Eastern,69,2,106,0.6509433962264151,66,3,63,6
2014-15,2015-02-11,New York Islanders,2,Metropolitan,Eastern,71,2,108,0.6574074074074074,67,4,63,8
2014-15,2015-02-13,New York Islanders,2,Metropolitan,Eastern,73,2,110,0.6636363636363637,69,4,63,10
2014-15,2015-02-15,New York Islanders,2,Metropolitan,Eastern,75,2,112,0.6696428571428571,71,4,63,12
2014-15,2015-02-17,New York Islanders,0,Metropolitan,Eastern,75,2,114,0.6578947368421053,73,2,64,11
2014-15,2015-02-18,New York Islanders,2,Metropolitan,Eastern,77,2,116,0.6637931034482759,73,4,64,13
2014-15,2015-02-20,New York Islanders,2,Metropolitan,Eastern,79,2,118,0.6694915254237288,74,5,65,14
2014-15,2015-02-21,New York Islanders,1,Metropolitan,Eastern,80,2,120,0.6666666666666666,76,4,65,15
2014-15,2015-02-22,New York Islanders,0,Metropolitan,Eastern,80,2,122,0.6557377049180327,76,4,67,13
2014-15,2015-02-25,New York Islanders,2,Metropolitan,Eastern,82,2,124,0.6612903225806451,76,6,67,15
2014-15,2015-02-28,New York Islanders,0,Metropolitan,Eastern,82,2,126,0.6507936507936508,79,3,69,13
2014-15,2015-02-28,New York Islanders,2,Metropolitan,Eastern,84,2,128,0.65625,79,5,69,15
2014-15,2015-03-04,New York Islanders,1,Metropolitan,Eastern,85,2,130,0.6538461538461539,81,4,69,16
2014-15,2015-03-06,New York Islanders,2,Metropolitan,Eastern,87,2,132,0.6590909090909091,81,6,72,15
2014-15,2015-03-08,New York Islanders,1,Metropolitan,Eastern,88,2,134,0.6567164179104478,85,3,76,12
2014-15,2015-03-09,New York Islanders,2,Metropolitan,Eastern,90,2,136,0.6617647058823529,85,5,76,14
2014-15,2015-03-10,New York Islanders,0,Metropolitan,Eastern,90,2,138,0.6521739130434783,86,4,78,12
2014-15,2015-03-13,New York Islanders,0,Metropolitan,Eastern,90,2,140,0.6428571428571429,88,2,80,10
2014-15,2015-03-14,New York Islanders,0,Metropolitan,Eastern,90,2,142,0.6338028169014085,88,2,82,8
2014-15,2015-03-18,New York Islanders,0,Metropolitan,Eastern,90,2,144,0.625,88,2,83,7
2014-15,2015-03-21,New York Islanders,2,Metropolitan,Eastern,92,2,146,0.6301369863013698,88,4,84,8
2014-15,2015-03-24,New York Islanders,1,Metropolitan,Eastern,93,2,148,0.6283783783783784,91,2,85,8
2014-15,2015-03-26,New York Islanders,0,Metropolitan,Eastern,93,2,150,0.62,91,2,85,8
2014-15,2015-03-28,New York Islanders,0,Metropolitan,Eastern,93,2,152,0.6118421052631579,93,0,87,6
2014-15,2015-03-29,New York Islanders,2,Metropolitan,Eastern,95,2,154,0.6168831168831169,95,0,89,6
2014-15,2015-04-02,New York Islanders,1,Metropolitan,Eastern,96,2,156,0.6153846153846154,96,0,93,3
2014-15,2015-04-04,New York Islanders,2,Metropolitan,Eastern,98,2,158,0.620253164556962,97,1,95,3
2014-15,2015-04-07,New York Islanders,0,Metropolitan,Eastern,98,2,160,0.6125,98,0,95,3
2014-15,2015-04-10,New York Islanders,2,Metropolitan,Eastern,100,2,162,0.6172839506172839,100,0,96,4
2014-15,2015-04-11,New York Islanders,1,Metropolitan,Eastern,101,2,164,0.6158536585365854,101,0,98,3
2014-15,2014-10-10,New York Rangers,2,Metropolitan,Eastern,2,2,2,1.0,2,0,2,0
2014-15,2014-10-11,New York Rangers,0,Metropolitan,Eastern,2,2,4,0.5,4,-2,2,0
2014-15,2014-10-12,New York Rangers,0,Metropolitan,Eastern,2,2,6,0.3333333333333333,4,-2,2,0
2014-15,2014-10-14,New York Rangers,0,Metropolitan,Eastern,2,2,8,0.25,4,-2,4,-2
2014-15,2014-10-16,New York Rangers,2,Metropolitan,Eastern,4,2,10,0.4,6,-2,4,0
2014-15,2014-10-19,New York Rangers,2,Metropolitan,Eastern,6,2,12,0.5,6,0,6,0
2014-15,2014-10-21,New York Rangers,2,Metropolitan,Eastern,8,2,14,0.5714285714285714,8,0,7,1
2014-15,2014-10-25,New York Rangers,0,Metropolitan,Eastern,8,2,16,0.5,8,0,8,0
2014-15,2014-10-27,New York Rangers,2,Metropolitan,Eastern,10,2,18,0.5555555555555556,10,0,10,0
2014-15,2014-11-01,New York Rangers,1,Metropolitan,Eastern,11,2,20,0.55,12,-1,12,-1
2014-15,2014-11-04,New York Rangers,1,Metropolitan,Eastern,12,2,22,0.5454545454545454,12,0,12,0
2014-15,2014-11-06,New York Rangers,2,Metropolitan,Eastern,14,2,24,0.5833333333333334,14,0,14,0
2014-15,2014-11-09,New York Rangers,0,Metropolitan,Eastern,14,2,26,0.5384615384615384,16,-2,16,-2
2014-15,2014-11-09,New York Rangers,0,Metropolitan,Eastern,14,2,28,0.5,16,-2,16,-2
2014-15,2014-11-12,New York Rangers,2,Metropolitan,Eastern,16,2,30,0.5333333333333333,17,-1,18,-2
2014-15,2014-11-14,New York Rangers,1,Metropolitan,Eastern,17,2,32,0.53125,17,0,19,-2
2014-15,2014-11-16,New York Rangers,1,Metropolitan,Eastern,18,2,34,0.5294117647058824,18,0,20,-2
2014-15,2014-11-18,New York Rangers,0,Metropolitan,Eastern,18,2,36,0.5,18,0,20,-2
2014-15,2014-11-20,New York Rangers,2,Metropolitan,Eastern,20,2,38,0.5263157894736842,20,0,20,0
2014-15,2014-11-24,New York Rangers,2,Metropolitan,Eastern,22,2,40,0.55,22,0,22,0
2014-15,2014-11-27,New York Rangers,0,Metropolitan,Eastern,22,2,42,0.5238095238095238,22,0,24,-2
2014-15,2014-11-28,New York Rangers,2,Metropolitan,Eastern,24,2,44,0.5454545454545454,24,0,24,0
2014-15,2014-11-29,New York Rangers,2,Metropolitan,Eastern,26,2,46,0.5652173913043478,26,0,25,1
2014-15,2014-12-02,New York Rangers,0,Metropolitan,Eastern,26,2,48,0.5416666666666666,26,0,26,0
2014-15,2014-12-07,New York Rangers,0,Metropolitan,Eastern,26,2,50,0.52,28,-2,29,-3
2014-15,2014-12-09,New York Rangers,2,Metropolitan,Eastern,28,2,52,0.5384615384615384,28,0,29,-1
2014-15,2014-12-14,New York Rangers,2,Metropolitan,Eastern,30,2,54,0.5555555555555556,33,-3,32,-2
2014-15,2014-12-15,New York Rangers,2,Metropolitan,Eastern,32,2,56,0.5714285714285714,33,-1,32,0
2014-15,2014-12-17,New York Rangers,2,Metropolitan,Eastern,34,2,58,0.5862068965517241,34,0,34,0
2014-15,2014-12-21,New York Rangers,2,Metropolitan,Eastern,36,2,60,0.6,38,-2,36,0
2014-15,2014-12-22,New York Rangers,2,Metropolitan,Eastern,38,2,62,0.6129032258064516,38,0,38,0
2014-15,2014-12-24,New York Rangers,2,Metropolitan,Eastern,40,2,64,0.625,40,0,40,0
2014-15,2014-12-28,New York Rangers,2,Metropolitan,Eastern,42,2,66,0.6363636363636364,42,0,42,0
2014-15,2014-12-30,New York Rangers,0,Metropolitan,Eastern,42,2,68,0.6176470588235294,43,-1,42,0
2014-15,2014-12-31,New York Rangers,2,Metropolitan,Eastern,44,2,70,0.6285714285714286,44,0,43,1
2014-15,2015-01-04,New York Rangers,2,Metropolitan,Eastern,46,2,72,0.6388888888888888,47,-1,45,1
2014-15,2015-01-08,New York Rangers,2,Metropolitan,Eastern,48,2,74,0.6486486486486487,49,-1,46,2
2014-15,2015-01-09,New York Rangers,2,Metropolitan,Eastern,50,2,76,0.6578947368421053,50,0,48,2
2014-15,2015-01-11,New York Rangers,2,Metropolitan,Eastern,52,2,78,0.6666666666666666,52,0,50,2
2014-15,2015-01-14,New York Rangers,0,Metropolitan,Eastern,52,2,80,0.65,54,-2,52,0
2014-15,2015-01-16,New York Rangers,0,Metropolitan,Eastern,52,2,82,0.6341463414634146,56,-4,52,0
2014-15,2015-01-17,New York Rangers,2,Metropolitan,Eastern,54,2,84,0.6428571428571429,56,-2,54,0
2014-15,2015-01-18,New York Rangers,2,Metropolitan,Eastern,56,2,86,0.6511627906976745,56,0,54,2
2014-15,2015-01-21,New York Rangers,2,Metropolitan,Eastern,58,2,88,0.6590909090909091,58,0,56,2
2014-15,2015-01-28,New York Rangers,0,Metropolitan,Eastern,58,2,90,0.6444444444444445,58,0,57,1
2014-15,2015-01-30,New York Rangers,0,Metropolitan,Eastern,58,2,92,0.6304347826086957,59,-1,58,0
2014-15,2015-02-01,New York Rangers,2,Metropolitan,Eastern,60,2,94,0.6382978723404256,60,0,60,0
2014-15,2015-02-03,New York Rangers,2,Metropolitan,Eastern,62,2,96,0.6458333333333334,62,0,60,2
2014-15,2015-02-05,New York Rangers,2,Metropolitan,Eastern,64,2,98,0.6530612244897959,64,0,61,3
2014-15,2015-02-07,New York Rangers,0,Metropolitan,Eastern,64,2,100,0.64,66,-2,61,3
2014-15,2015-02-08,New York Rangers,1,Metropolitan,Eastern,65,2,102,0.6372549019607843,66,-1,63,2
2014-15,2015-02-11,New York Rangers,2,Metropolitan,Eastern,67,2,104,0.6442307692307693,67,0,63,4
2014-15,2015-02-13,New York Rangers,2,Metropolitan,Eastern,69,2,106,0.6509433962264151,69,0,63,6
2014-15,2015-02-15,New York Rangers,2,Metropolitan,Eastern,71,2,108,0.6574074074074074,71,0,63,8
2014-15,2015-02-17,New York Rangers,2,Metropolitan,Eastern,73,2,110,0.6636363636363637,73,0,64,9
2014-15,2015-02-20,New York Rangers,1,Metropolitan,Eastern,74,2,112,0.6607142857142857,74,0,65,9
2014-15,2015-02-21,New York Rangers,2,Metropolitan,Eastern,76,2,114,0.6666666666666666,76,0,65,11
2014-15,2015-02-23,New York Rangers,2,Metropolitan,Eastern,78,2,116,0.6724137931034483,77,1,67,11
2014-15,2015-02-25,New York Rangers,2,Metropolitan,Eastern,80,2,118,0.6779661016949152,76,4,67,13
2014-15,2015-02-27,New York Rangers,2,Metropolitan,Eastern,82,2,120,0.6833333333333333,79,3,67,15
2014-15,2015-03-01,New York Rangers,0,Metropolitan,Eastern,82,2,122,0.6721311475409836,81,1,69,13
2014-15,2015-03-03,New York Rangers,2,Metropolitan,Eastern,84,2,124,0.6774193548387096,81,3,71,13
2014-15,2015-03-05,New York Rangers,1,Metropolitan,Eastern,85,2,126,0.6746031746031746,81,4,69,16
2014-15,2015-03-08,New York Rangers,2,Metropolitan,Eastern,87,2,128,0.6796875,85,2,76,11
2014-15,2015-03-10,New York Rangers,2,Metropolitan,Eastern,89,2,130,0.6846153846153846,86,3,78,11
2014-15,2015-03-12,New York Rangers,2,Metropolitan,Eastern,91,2,132,0.6893939393939394,88,3,80,11
2014-15,2015-03-14,New York Rangers,2,Metropolitan,Eastern,93,2,134,0.6940298507462687,88,5,82,11
2014-15,2015-03-15,New York Rangers,2,Metropolitan,Eastern,95,2,136,0.6985294117647058,88,7,82,13
2014-15,2015-03-19,New York Rangers,0,Metropolitan,Eastern,95,2,138,0.6884057971014492,88,7,83,12
2014-15,2015-03-21,New York Rangers,2,Metropolitan,Eastern,97,2,140,0.6928571428571428,88,9,84,13
2014-15,2015-03-22,New York Rangers,2,Metropolitan,Eastern,99,2,142,0.6971830985915493,90,9,84,15
2014-15,2015-03-24,New York Rangers,0,Metropolitan,Eastern,99,2,144,0.6875,91,8,85,14
2014-15,2015-03-26,New York Rangers,2,Metropolitan,Eastern,101,2,146,0.6917808219178082,91,10,85,16
2014-15,2015-03-28,New York Rangers,0,Metropolitan,Eastern,101,2,148,0.6824324324324325,93,8,87,14
2014-15,2015-03-29,New York Rangers,0,Metropolitan,Eastern,101,2,150,0.6733333333333333,95,6,89,12
2014-15,2015-04-01,New York Rangers,2,Metropolitan,Eastern,103,2,152,0.6776315789473685,95,8,91,12
2014-15,2015-04-03,New York Rangers,2,Metropolitan,Eastern,105,2,154,0.6818181818181818,96,9,93,12
2014-15,2015-04-04,New York Rangers,2,Metropolitan,Eastern,107,2,156,0.6858974358974359,97,10,95,12
2014-15,2015-04-06,New York Rangers,2,Metropolitan,Eastern,109,2,158,0.689873417721519,98,11,95,14
2014-15,2015-04-07,New York Rangers,2,Metropolitan,Eastern,111,2,160,0.69375,98,13,95,16
2014-15,2015-04-09,New York Rangers,0,Metropolitan,Eastern,111,2,162,0.6851851851851852,98,13,96,15
2014-15,2015-04-11,New York Rangers,2,Metropolitan,Eastern,113,2,164,0.6890243902439024,101,12,98,15
2014-15,2014-10-10,Ottawa Senators,0,Atlantic,Eastern,0,2,2,0.0,2,-2,2,-2
2014-15,2014-10-11,Ottawa Senators,2,Atlantic,Eastern,2,2,4,0.5,2,0,2,0
2014-15,2014-10-13,Ottawa Senators,2,Atlantic,Eastern,4,2,6,0.6666666666666666,4,0,3,1
2014-15,2014-10-16,Ottawa Senators,2,Atlantic,Eastern,6,2,8,0.75,5,1,4,2
2014-15,2014-10-18,Ottawa Senators,2,Atlantic,Eastern,8,2,10,0.8,7,1,6,2
2014-15,2014-10-25,Ottawa Senators,1,Atlantic,Eastern,9,2,12,0.75,10,-1,8,1
2014-15,2014-10-26,Ottawa Senators,0,Atlantic,Eastern,9,2,14,0.6428571428571429,10,-1,9,0
2014-15,2014-10-28,Ottawa Senators,2,Atlantic,Eastern,11,2,16,0.6875,11,0,10,1
2014-15,2014-10-30,Ottawa Senators,1,Atlantic,Eastern,12,2,18,0.6666666666666666,12,0,12,0
2014-15,2014-11-01,Ottawa Senators,0,Atlantic,Eastern,12,2,20,0.6,14,-2,12,0
2014-15,2014-11-05,Ottawa Senators,2,Atlantic,Eastern,14,2,22,0.6363636363636364,16,-2,13,1
2014-15,2014-11-07,Ottawa Senators,2,Atlantic,Eastern,16,2,24,0.6666666666666666,18,-2,14,2
2014-15,2014-11-09,Ottawa Senators,1,Atlantic,Eastern,17,2,26,0.6538461538461539,19,-2,16,1
2014-15,2014-11-09,Ottawa Senators,0,Atlantic,Eastern,17,2,28,0.6071428571428571,19,-2,16,1
2014-15,2014-11-12,Ottawa Senators,1,Atlantic,Eastern,18,2,30,0.6,20,-2,18,0
2014-15,2014-11-14,Ottawa Senators,2,Atlantic,Eastern,20,2,32,0.625,20,0,19,1
2014-15,2014-11-16,Ottawa Senators,0,Atlantic,Eastern,20,2,34,0.5882352941176471,22,-2,20,0
2014-15,2014-11-21,Ottawa Senators,2,Atlantic,Eastern,22,2,36,0.6111111111111112,25,-3,22,0
2014-15,2014-11-22,Ottawa Senators,0,Atlantic,Eastern,22,2,38,0.5789473684210527,26,-4,22,0
2014-15,2014-11-25,Ottawa Senators,0,Atlantic,Eastern,22,2,40,0.55,27,-5,22,0
2014-15,2014-11-26,Ottawa Senators,2,Atlantic,Eastern,24,2,42,0.5714285714285714,27,-3,24,0
2014-15,2014-11-29,Ottawa Senators,0,Atlantic,Eastern,24,2,44,0.5454545454545454,31,-7,25,-1
2014-15,2014-11-30,Ottawa Senators,0,Atlantic,Eastern,24,2,46,0.5217391304347826,33,-9,26,-2
2014-15,2014-12-03,Ottawa Senators,1,Atlantic,Eastern,25,2,48,0.5208333333333334,33,-8,26,-1
2014-15,2014-12-05,Ottawa Senators,0,Atlantic,Eastern,25,2,50,0.5,35,-10,27,-2
2014-15,2014-12-06,Ottawa Senators,0,Atlantic,Eastern,25,2,52,0.4807692307692308,35,-10,27,-2
2014-15,2014-12-08,Ottawa Senators,2,Atlantic,Eastern,27,2,54,0.5,36,-9,29,-2
2014-15,2014-12-12,Ottawa Senators,0,Atlantic,Eastern,27,2,56,0.48214285714285715,38,-11,31,-4
2014-15,2014-12-13,Ottawa Senators,2,Atlantic,Eastern,29,2,58,0.5,40,-11,31,-2
2014-15,2014-12-16,Ottawa Senators,1,Atlantic,Eastern,30,2,60,0.5,40,-10,32,-2
2014-15,2014-12-18,Ottawa Senators,2,Atlantic,Eastern,32,2,62,0.5161290322580645,42,-10,34,-2
2014-15,2014-12-20,Ottawa Senators,2,Atlantic,Eastern,34,2,64,0.53125,42,-8,36,-2
2014-15,2014-12-21,Ottawa Senators,0,Atlantic,Eastern,34,2,66,0.5151515151515151,43,-9,36,-2
2014-15,2014-12-23,Ottawa Senators,0,Atlantic,Eastern,34,2,68,0.5,43,-9,38,-4
2014-15,2014-12-28,Ottawa Senators,1,Atlantic,Eastern,35,2,70,0.5,46,-11,42,-7
2014-15,2014-12-30,Ottawa Senators,2,Atlantic,Eastern,37,2,72,0.5138888888888888,47,-10,42,-5
2014-15,2015-01-03,Ottawa Senators,2,Atlantic,Eastern,39,2,74,0.527027027027027,49,-10,44,-5
2014-15,2015-01-05,Ottawa Senators,0,Atlantic,Eastern,39,2,76,0.5131578947368421,49,-10,45,-6
2014-15,2015-01-07,Ottawa Senators,1,Atlantic,Eastern,40,2,78,0.5128205128205128,51,-11,45,-5
2014-15,2015-01-09,Ottawa Senators,0,Atlantic,Eastern,40,2,80,0.5,53,-13,48,-8
2014-15,2015-01-11,Ottawa Senators,2,Atlantic,Eastern,42,2,82,0.5121951219512195,53,-11,50,-8
2014-15,2015-01-14,Ottawa Senators,0,Atlantic,Eastern,42,2,84,0.5,55,-13,52,-10
2014-15,2015-01-16,Ottawa Senators,2,Atlantic,Eastern,44,2,86,0.5116279069767442,57,-13,52,-8
2014-15,2015-01-18,Ottawa Senators,0,Atlantic,Eastern,44,2,88,0.5,59,-15,54,-10
2014-15,2015-01-21,Ottawa Senators,1,Atlantic,Eastern,45,2,90,0.5,61,-16,56,-11
2014-15,2015-01-22,Ottawa Senators,2,Atlantic,Eastern,47,2,92,0.5108695652173914,61,-14,57,-10
2014-15,2015-01-30,Ottawa Senators,0,Atlantic,Eastern,47,2,94,0.5,65,-18,58,-11
2014-15,2015-01-31,Ottawa Senators,2,Atlantic,Eastern,49,2,96,0.5104166666666666,66,-17,58,-9
2014-15,2015-02-04,Ottawa Senators,0,Atlantic,Eastern,49,2,98,0.5,67,-18,61,-12
2014-15,2015-02-06,Ottawa Senators,0,Atlantic,Eastern,49,2,100,0.49,67,-18,61,-12
2014-15,2015-02-08,Ottawa Senators,0,Atlantic,Eastern,49,2,102,0.4803921568627451,69,-20,63,-14
2014-15,2015-02-11,Ottawa Senators,2,Atlantic,Eastern,51,2,104,0.49038461538461536,71,-20,63,-12
2014-15,2015-02-13,Ottawa Senators,1,Atlantic,Eastern,52,2,106,0.49056603773584906,71,-19,63,-11
2014-15,2015-02-14,Ottawa Senators,2,Atlantic,Eastern,54,2,108,0.5,71,-17,63,-9
2014-15,2015-02-17,Ottawa Senators,0,Atlantic,Eastern,54,2,110,0.4909090909090909,72,-18,64,-10
2014-15,2015-02-19,Ottawa Senators,2,Atlantic,Eastern,56,2,112,0.5,74,-18,65,-9
2014-15,2015-02-22,Ottawa Senators,2,Atlantic,Eastern,58,2,114,0.5087719298245614,76,-18,67,-9
2014-15,2015-02-26,Ottawa Senators,2,Atlantic,Eastern,60,2,116,0.5172413793103449,77,-17,67,-7
2014-15,2015-02-27,Ottawa Senators,2,Atlantic,Eastern,62,2,118,0.5254237288135594,79,-17,67,-5
2014-15,2015-03-01,Ottawa Senators,2,Atlantic,Eastern,64,2,120,0.5333333333333333,81,-17,69,-5
2014-15,2015-03-04,Ottawa Senators,1,Atlantic,Eastern,65,2,122,0.5327868852459017,81,-16,69,-4
2014-15,2015-03-05,Ottawa Senators,2,Atlantic,Eastern,67,2,124,0.5403225806451613,83,-16,69,-2
2014-15,2015-03-07,Ottawa Senators,2,Atlantic,Eastern,69,2,126,0.5476190476190477,83,-14,74,-5
2014-15,2015-03-08,Ottawa Senators,2,Atlantic,Eastern,71,2,128,0.5546875,83,-12,76,-5
2014-15,2015-03-10,Ottawa Senators,0,Atlantic,Eastern,71,2,130,0.5461538461538461,85,-14,78,-7
2014-15,2015-03-12,Ottawa Senators,2,Atlantic,Eastern,73,2,132,0.553030303030303,85,-12,80,-7
2014-15,2015-03-13,Ottawa Senators,2,Atlantic,Eastern,75,2,134,0.5597014925373134,85,-10,80,-5
2014-15,2015-03-15,Ottawa Senators,2,Atlantic,Eastern,77,2,136,0.5661764705882353,87,-10,82,-5
2014-15,2015-03-17,Ottawa Senators,2,Atlantic,Eastern,79,2,138,0.572463768115942,87,-8,83,-4
2014-15,2015-03-19,Ottawa Senators,2,Atlantic,Eastern,81,2,140,0.5785714285714286,87,-6,83,-2
2014-15,2015-03-21,Ottawa Senators,2,Atlantic,Eastern,83,2,142,0.5845070422535211,87,-4,84,-1
2014-15,2015-03-23,Ottawa Senators,2,Atlantic,Eastern,85,2,144,0.5902777777777778,89,-4,85,0
2014-15,2015-03-26,Ottawa Senators,0,Atlantic,Eastern,85,2,146,0.5821917808219178,90,-5,85,0
2014-15,2015-03-28,Ottawa Senators,1,Atlantic,Eastern,86,2,148,0.581081081081081,92,-6,87,-1
2014-15,2015-03-29,Ottawa Senators,0,Atlantic,Eastern,86,2,150,0.5733333333333334,92,-6,89,-3
2014-15,2015-03-31,Ottawa Senators,2,Atlantic,Eastern,88,2,152,0.5789473684210527,93,-5,91,-3
2014-15,2015-04-02,Ottawa Senators,2,Atlantic,Eastern,90,2,154,0.5844155844155844,93,-3,93,-3
2014-15,2015-04-04,Ottawa Senators,2,Atlantic,Eastern,92,2,156,0.5897435897435898,95,-3,95,-3
2014-15,2015-04-05,Ottawa Senators,1,Atlantic,Eastern,93,2,158,0.5886075949367089,95,-2,95,-2
2014-15,2015-04-07,Ottawa Senators,2,Atlantic,Eastern,95,2,160,0.59375,97,-2,95,0
2014-15,2015-04-09,Ottawa Senators,2,Atlantic,Eastern,97,2,162,0.5987654320987654,98,-1,96,1
2014-15,2015-04-11,Ottawa Senators,2,Atlantic,Eastern,99,2,164,0.6036585365853658,100,-1,98,1
2014-15,2014-10-08,Philadelphia Flyers,0,Metropolitan,Eastern,0,2,2,0.0,0,0,0,0
2014-15,2014-10-09,Philadelphia Flyers,0,Metropolitan,Eastern,0,2,4,0.0,2,-2,1,-1
2014-15,2014-10-11,Philadelphia Flyers,1,Metropolitan,Eastern,1,2,6,0.16666666666666666,4,-3,2,-1
2014-15,2014-10-14,Philadelphia Flyers,1,Metropolitan,Eastern,2,2,8,0.25,4,-2,4,-2
2014-15,2014-10-19,Philadelphia Flyers,2,Metropolitan,Eastern,4,2,10,0.4,6,-2,6,-2
2014-15,2014-10-22,Philadelphia Flyers,0,Metropolitan,Eastern,4,2,12,0.3333333333333333,8,-4,8,-4
2014-15,2014-10-23,Philadelphia Flyers,2,Metropolitan,Eastern,6,2,14,0.42857142857142855,8,-2,8,-2
2014-15,2014-10-25,Philadelphia Flyers,2,Metropolitan,Eastern,8,2,16,0.5,8,0,8,0
2014-15,2014-10-28,Philadelphia Flyers,2,Metropolitan,Eastern,10,2,18,0.5555555555555556,10,0,10,0
2014-15,2014-10-30,Philadelphia Flyers,0,Metropolitan,Eastern,10,2,20,0.5,12,-2,12,-2
2014-15,2014-11-01,Philadelphia Flyers,0,Metropolitan,Eastern,10,2,22,0.45454545454545453,12,-2,12,-2
2014-15,2014-11-05,Philadelphia Flyers,2,Metropolitan,Eastern,12,2,24,0.5,12,0,13,-1
2014-15,2014-11-07,Philadelphia Flyers,2,Metropolitan,Eastern,14,2,26,0.5384615384615384,14,0,14,0
2014-15,2014-11-09,Philadelphia Flyers,2,Metropolitan,Eastern,16,2,28,0.5714285714285714,16,0,16,0
2014-15,2014-11-15,Philadelphia Flyers,0,Metropolitan,Eastern,16,2,30,0.5333333333333333,18,-2,20,-4
2014-15,2014-11-16,Philadelphia Flyers,0,Metropolitan,Eastern,16,2,32,0.5,18,-2,20,-4
2014-15,2014-11-20,Philadelphia Flyers,0,Metropolitan,Eastern,16,2,34,0.47058823529411764,20,-4,20,-4
2014-15,2014-11-21,Philadelphia Flyers,0,Metropolitan,Eastern,16,2,36,0.4444444444444444,21,-5,22,-6
2014-15,2014-11-23,Philadelphia Flyers,2,Metropolitan,Eastern,18,2,38,0.47368421052631576,21,-3,22,-4
2014-15,2014-11-25,Philadelphia Flyers,1,Metropolitan,Eastern,19,2,40,0.475,22,-3,22,-3
2014-15,2014-11-27,Philadelphia Flyers,0,Metropolitan,Eastern,19,2,42,0.4523809523809524,22,-3,24,-5
2014-15,2014-11-28,Philadelphia Flyers,0,Metropolitan,Eastern,19,2,44,0.4318181818181818,24,-5,24,-5
2014-15,2014-11-29,Philadelphia Flyers,0,Metropolitan,Eastern,19,2,46,0.41304347826086957,26,-7,25,-6
2014-15,2014-12-03,Philadelphia Flyers,0,Metropolitan,Eastern,19,2,48,0.3958333333333333,26,-7,26,-7
2014-15,2014-12-04,Philadelphia Flyers,1,Metropolitan,Eastern,20,2,50,0.4,26,-6,26,-6
2014-15,2014-12-06,Philadelphia Flyers,2,Metropolitan,Eastern,22,2,52,0.4230769230769231,26,-4,27,-5
2014-15,2014-12-10,Philadelphia Flyers,1,Metropolitan,Eastern,23,2,54,0.42592592592592593,30,-7,30,-7
2014-15,2014-12-12,Philadelphia Flyers,2,Metropolitan,Eastern,25,2,56,0.44642857142857145,31,-6,31,-6
2014-15,2014-12-13,Philadelphia Flyers,2,Metropolitan,Eastern,27,2,58,0.46551724137931033,31,-4,31,-4
2014-15,2014-12-17,Philadelphia Flyers,0,Metropolitan,Eastern,27,2,60,0.45,34,-7,34,-7
2014-15,2014-12-19,Philadelphia Flyers,1,Metropolitan,Eastern,28,2,62,0.45161290322580644,36,-8,36,-8
2014-15,2014-12-21,Philadelphia Flyers,2,Metropolitan,Eastern,30,2,64,0.46875,38,-8,36,-6
2014-15,2014-12-22,Philadelphia Flyers,2,Metropolitan,Eastern,32,2,66,0.48484848484848486,38,-6,38,-6
2014-15,2014-12-24,Philadelphia Flyers,2,Metropolitan,Eastern,34,2,68,0.5,40,-6,40,-6
2014-15,2014-12-28,Philadelphia Flyers,0,Metropolitan,Eastern,34,2,70,0.4857142857142857,42,-8,42,-8
2014-15,2014-12-30,Philadelphia Flyers,0,Metropolitan,Eastern,34,2,72,0.4722222222222222,43,-9,42,-8
2014-15,2015-01-01,Philadelphia Flyers,1,Metropolitan,Eastern,35,2,74,0.47297297297297297,45,-10,44,-9
2014-15,2015-01-03,Philadelphia Flyers,0,Metropolitan,Eastern,35,2,76,0.4605263157894737,45,-10,44,-9
2014-15,2015-01-04,Philadelphia Flyers,0,Metropolitan,Eastern,35,2,78,0.44871794871794873,47,-12,45,-10
2014-15,2015-01-07,Philadelphia Flyers,2,Metropolitan,Eastern,37,2,80,0.4625,47,-10,45,-8
2014-15,2015-01-09,Philadelphia Flyers,2,Metropolitan,Eastern,39,2,82,0.47560975609756095,50,-11,48,-9
2014-15,2015-01-10,Philadelphia Flyers,0,Metropolitan,Eastern,39,2,84,0.4642857142857143,50,-11,50,-11
2014-15,2015-01-13,Philadelphia Flyers,2,Metropolitan,Eastern,41,2,86,0.47674418604651164,54,-13,50,-9
2014-15,2015-01-15,Philadelphia Flyers,0,Metropolitan,Eastern,41,2,88,0.4659090909090909,56,-15,52,-11
2014-15,2015-01-16,Philadelphia Flyers,0,Metropolitan,Eastern,41,2,90,0.45555555555555555,56,-15,52,-11
2014-15,2015-01-18,Philadelphia Flyers,2,Metropolitan,Eastern,43,2,92,0.4673913043478261,56,-13,54,-11
2014-15,2015-01-19,Philadelphia Flyers,0,Metropolitan,Eastern,43,2,94,0.4574468085106383,56,-13,54,-11
2014-15,2015-01-21,Philadelphia Flyers,2,Metropolitan,Eastern,45,2,96,0.46875,58,-13,56,-11
2014-15,2015-01-28,Philadelphia Flyers,2,Metropolitan,Eastern,47,2,98,0.47959183673469385,58,-11,57,-10
2014-15,2015-01-30,Philadelphia Flyers,2,Metropolitan,Eastern,49,2,100,0.49,59,-10,58,-9
2014-15,2015-02-01,Philadelphia Flyers,2,Metropolitan,Eastern,51,2,102,0.5,60,-9,60,-9
2014-15,2015-02-06,Philadelphia Flyers,1,Metropolitan,Eastern,52,2,104,0.5,64,-12,61,-9
2014-15,2015-02-08,Philadelphia Flyers,2,Metropolitan,Eastern,54,2,106,0.5094339622641509,66,-12,63,-9
2014-15,2015-02-11,Philadelphia Flyers,1,Metropolitan,Eastern,55,2,108,0.5092592592592593,67,-12,63,-8
2014-15,2015-02-14,Philadelphia Flyers,1,Metropolitan,Eastern,56,2,110,0.509090909090909,69,-13,63,-7
2014-15,2015-02-16,Philadelphia Flyers,2,Metropolitan,Eastern,58,2,112,0.5178571428571429,71,-13,63,-5
2014-15,2015-02-18,Philadelphia Flyers,0,Metropolitan,Eastern,58,2,114,0.5087719298245614,73,-15,64,-6
2014-15,2015-02-20,Philadelphia Flyers,1,Metropolitan,Eastern,59,2,116,0.5086206896551724,74,-15,65,-6
2014-15,2015-02-21,Philadelphia Flyers,2,Metropolitan,Eastern,61,2,118,0.5169491525423728,76,-15,65,-4
2014-15,2015-02-22,Philadelphia Flyers,2,Metropolitan,Eastern,63,2,120,0.525,76,-13,67,-4
2014-15,2015-02-25,Philadelphia Flyers,0,Metropolitan,Eastern,63,2,122,0.5163934426229508,76,-13,67,-4
2014-15,2015-02-27,Philadelphia Flyers,0,Metropolitan,Eastern,63,2,124,0.5080645161290323,79,-16,67,-4
2014-15,2015-03-01,Philadelphia Flyers,2,Metropolitan,Eastern,65,2,126,0.5158730158730159,81,-16,69,-4
2014-15,2015-03-04,Philadelphia Flyers,1,Metropolitan,Eastern,66,2,128,0.515625,81,-15,69,-3
2014-15,2015-03-06,Philadelphia Flyers,2,Metropolitan,Eastern,68,2,130,0.5230769230769231,81,-13,72,-4
2014-15,2015-03-07,Philadelphia Flyers,1,Metropolitan,Eastern,69,2,132,0.5227272727272727,83,-14,74,-5
2014-15,2015-03-08,Philadelphia Flyers,0,Metropolitan,Eastern,69,2,134,0.5149253731343284,85,-16,76,-7
2014-15,2015-03-10,Philadelphia Flyers,0,Metropolitan,Eastern,69,2,136,0.5073529411764706,86,-17,78,-9
2014-15,2015-03-13,Philadelphia Flyers,1,Metropolitan,Eastern,70,2,138,0.5072463768115942,88,-18,80,-10
2014-15,2015-03-14,Philadelphia Flyers,2,Metropolitan,Eastern,72,2,140,0.5142857142857142,88,-16,82,-10
2014-15,2015-03-15,Philadelphia Flyers,1,Metropolitan,Eastern,73,2,142,0.5140845070422535,88,-15,82,-9
2014-15,2015-03-18,Philadelphia Flyers,0,Metropolitan,Eastern,73,2,144,0.5069444444444444,88,-15,83,-10
2014-15,2015-03-20,Philadelphia Flyers,0,Metropolitan,Eastern,73,2,146,0.5,88,-15,83,-10
2014-15,2015-03-22,Philadelphia Flyers,1,Metropolitan,Eastern,74,2,148,0.5,90,-16,84,-10
2014-15,2015-03-26,Philadelphia Flyers,2,Metropolitan,Eastern,76,2,150,0.5066666666666667,91,-15,85,-9
2014-15,2015-03-28,Philadelphia Flyers,1,Metropolitan,Eastern,77,2,152,0.506578947368421,93,-16,87,-10
2014-15,2015-04-02,Philadelphia Flyers,2,Metropolitan,Eastern,79,2,154,0.512987012987013,96,-17,93,-14
2014-15,2015-04-04,Philadelphia Flyers,1,Metropolitan,Eastern,80,2,156,0.5128205128205128,97,-17,95,-15
2014-15,2015-04-05,Philadelphia Flyers,2,Metropolitan,Eastern,82,2,158,0.5189873417721519,98,-16,95,-13
2014-15,2015-04-07,Philadelphia Flyers,2,Metropolitan,Eastern,84,2,160,0.525,98,-14,95,-11
2014-15,2015-04-09,Philadelphia Flyers,0,Metropolitan,Eastern,84,2,162,0.5185185185185185,98,-14,96,-12
2014-15,2015-04-11,Philadelphia Flyers,0,Metropolitan,Eastern,84,2,164,0.5121951219512195,101,-17,98,-14
2014-15,2014-10-09,Pittsburgh Penguins,2,Metropolitan,Eastern,2,2,2,1.0,2,0,1,1
2014-15,2014-10-11,Pittsburgh Penguins,2,Metropolitan,Eastern,4,2,4,1.0,4,0,2,2
2014-15,2014-10-16,Pittsburgh Penguins,0,Metropolitan,Eastern,4,2,6,0.6666666666666666,6,-2,4,0
2014-15,2014-10-18,Pittsburgh Penguins,2,Metropolitan,Eastern,6,2,8,0.75,6,0,6,0
2014-15,2014-10-23,Pittsburgh Penguins,1,Metropolitan,Eastern,7,2,10,0.7,8,-1,8,-1
2014-15,2014-10-23,Pittsburgh Penguins,0,Metropolitan,Eastern,7,2,12,0.5833333333333334,8,-1,8,-1
2014-15,2014-10-26,Pittsburgh Penguins,2,Metropolitan,Eastern,9,2,14,0.6428571428571429,10,-1,9,0
2014-15,2014-10-28,Pittsburgh Penguins,2,Metropolitan,Eastern,11,2,16,0.6875,10,1,10,1
2014-15,2014-10-30,Pittsburgh Penguins,2,Metropolitan,Eastern,13,2,18,0.7222222222222222,12,1,12,1
2014-15,2014-11-01,Pittsburgh Penguins,2,Metropolitan,Eastern,15,2,20,0.75,12,3,12,3
2014-15,2014-11-05,Pittsburgh Penguins,2,Metropolitan,Eastern,17,2,22,0.7727272727272727,12,5,13,4
2014-15,2014-11-07,Pittsburgh Penguins,2,Metropolitan,Eastern,19,2,24,0.7916666666666666,14,5,14,5
2014-15,2014-11-09,Pittsburgh Penguins,2,Metropolitan,Eastern,21,2,26,0.8076923076923077,16,5,16,5
2014-15,2014-11-12,Pittsburgh Penguins,0,Metropolitan,Eastern,21,2,28,0.75,17,4,18,3
2014-15,2014-11-15,Pittsburgh Penguins,2,Metropolitan,Eastern,23,2,30,0.7666666666666667,18,5,20,3
2014-15,2014-11-16,Pittsburgh Penguins,2,Metropolitan,Eastern,25,2,32,0.78125,18,7,20,5
2014-15,2014-11-19,Pittsburgh Penguins,2,Metropolitan,Eastern,27,2,34,0.7941176470588235,19,8,20,7
2014-15,2014-11-22,Pittsburgh Penguins,1,Metropolitan,Eastern,28,2,36,0.7777777777777778,21,7,22,6
2014-15,2014-11-23,Pittsburgh Penguins,0,Metropolitan,Eastern,28,2,38,0.7368421052631579,21,7,22,6
2014-15,2014-11-25,Pittsburgh Penguins,2,Metropolitan,Eastern,30,2,40,0.75,22,8,22,8
2014-15,2014-11-27,Pittsburgh Penguins,2,Metropolitan,Eastern,32,2,42,0.7619047619047619,22,10,24,8
2014-15,2014-11-29,Pittsburgh Penguins,0,Metropolitan,Eastern,32,2,44,0.7272727272727273,26,6,25,7
2014-15,2014-11-30,Pittsburgh Penguins,2,Metropolitan,Eastern,34,2,46,0.7391304347826086,26,8,26,8
2014-15,2014-12-03,Pittsburgh Penguins,2,Metropolitan,Eastern,36,2,48,0.75,26,10,26,10
2014-15,2014-12-05,Pittsburgh Penguins,0,Metropolitan,Eastern,36,2,50,0.72,26,10,27,9
2014-15,2014-12-06,Pittsburgh Penguins,2,Metropolitan,Eastern,38,2,52,0.7307692307692307,26,12,27,11
2014-15,2014-12-09,Pittsburgh Penguins,1,Metropolitan,Eastern,39,2,54,0.7222222222222222,28,11,29,10
2014-15,2014-12-13,Pittsburgh Penguins,2,Metropolitan,Eastern,41,2,56,0.7321428571428571,31,10,31,10
2014-15,2014-12-14,Pittsburgh Penguins,1,Metropolitan,Eastern,42,2,58,0.7241379310344828,33,9,32,10
2014-15,2014-12-16,Pittsburgh Penguins,2,Metropolitan,Eastern,44,2,60,0.7333333333333333,33,11,32,12
2014-15,2014-12-19,Pittsburgh Penguins,2,Metropolitan,Eastern,46,2,62,0.7419354838709677,36,10,36,10
2014-15,2014-12-21,Pittsburgh Penguins,2,Metropolitan,Eastern,48,2,64,0.75,38,10,36,12
2014-15,2014-12-23,Pittsburgh Penguins,1,Metropolitan,Eastern,49,2,66,0.7424242424242424,40,9,38,11
2014-15,2014-12-24,Pittsburgh Penguins,0,Metropolitan,Eastern,49,2,68,0.7205882352941176,40,9,40,9
2014-15,2014-12-28,Pittsburgh Penguins,0,Metropolitan,Eastern,49,2,70,0.7,42,7,42,7
2014-15,2014-12-30,Pittsburgh Penguins,0,Metropolitan,Eastern,49,2,72,0.6805555555555556,43,6,42,7
2014-15,2015-01-01,Pittsburgh Penguins,2,Metropolitan,Eastern,51,2,74,0.6891891891891891,45,6,44,7
2014-15,2015-01-03,Pittsburgh Penguins,2,Metropolitan,Eastern,53,2,76,0.6973684210526315,45,8,44,9
2014-15,2015-01-04,Pittsburgh Penguins,0,Metropolitan,Eastern,53,2,78,0.6794871794871795,47,6,45,8
2014-15,2015-01-08,Pittsburgh Penguins,1,Metropolitan,Eastern,54,2,80,0.675,49,5,46,8
2014-15,2015-01-11,Pittsburgh Penguins,2,Metropolitan,Eastern,56,2,82,0.6829268292682927,52,4,50,6
2014-15,2015-01-14,Pittsburgh Penguins,2,Metropolitan,Eastern,58,2,84,0.6904761904761905,54,4,52,6
2014-15,2015-01-17,Pittsburgh Penguins,0,Metropolitan,Eastern,58,2,86,0.6744186046511628,56,2,54,4
2014-15,2015-01-18,Pittsburgh Penguins,0,Metropolitan,Eastern,58,2,88,0.6590909090909091,56,2,54,4
2014-15,2015-01-21,Pittsburgh Penguins,1,Metropolitan,Eastern,59,2,90,0.6555555555555556,58,1,56,3
2014-15,2015-01-22,Pittsburgh Penguins,1,Metropolitan,Eastern,60,2,92,0.6521739130434783,58,2,57,3
2014-15,2015-01-28,Pittsburgh Penguins,2,Metropolitan,Eastern,62,2,94,0.6595744680851063,58,4,57,5
2014-15,2015-01-29,Pittsburgh Penguins,0,Metropolitan,Eastern,62,2,96,0.6458333333333334,59,3,57,5
2014-15,2015-01-31,Pittsburgh Penguins,2,Metropolitan,Eastern,64,2,98,0.6530612244897959,60,4,58,6
2014-15,2015-02-01,Pittsburgh Penguins,0,Metropolitan,Eastern,64,2,100,0.64,60,4,60,4
2014-15,2015-02-05,Pittsburgh Penguins,2,Metropolitan,Eastern,66,2,102,0.6470588235294118,64,2,61,5
2014-15,2015-02-07,Pittsburgh Penguins,2,Metropolitan,Eastern,68,2,104,0.6538461538461539,66,2,61,7
2014-15,2015-02-08,Pittsburgh Penguins,0,Metropolitan,Eastern,68,2,106,0.6415094339622641,66,2,63,5
2014-15,2015-02-12,Pittsburgh Penguins,2,Metropolitan,Eastern,70,2,108,0.6481481481481481,68,2,63,7
2014-15,2015-02-13,Pittsburgh Penguins,2,Metropolitan,Eastern,72,2,110,0.6545454545454545,69,3,63,9
2014-15,2015-02-15,Pittsburgh Penguins,1,Metropolitan,Eastern,73,2,112,0.6517857142857143,71,2,63,10
2014-15,2015-02-18,Pittsburgh Penguins,0,Metropolitan,Eastern,73,2,114,0.6403508771929824,73,0,64,9
2014-15,2015-02-20,Pittsburgh Penguins,0,Metropolitan,Eastern,73,2,116,0.6293103448275862,74,-1,65,8
2014-15,2015-02-22,Pittsburgh Penguins,2,Metropolitan,Eastern,75,2,118,0.635593220338983,76,-1,67,8
2014-15,2015-02-22,Pittsburgh Penguins,2,Metropolitan,Eastern,77,2,120,0.6416666666666667,76,1,67,10
2014-15,2015-02-26,Pittsburgh Penguins,2,Metropolitan,Eastern,79,2,122,0.6475409836065574,79,0,67,12
2014-15,2015-03-01,Pittsburgh Penguins,2,Metropolitan,Eastern,81,2,124,0.6532258064516129,81,0,69,12
2014-15,2015-03-05,Pittsburgh Penguins,0,Metropolitan,Eastern,81,2,126,0.6428571428571429,81,0,69,12
2014-15,2015-03-07,Pittsburgh Penguins,2,Metropolitan,Eastern,83,2,128,0.6484375,83,0,74,9
2014-15,2015-03-08,Pittsburgh Penguins,2,Metropolitan,Eastern,85,2,130,0.6538461538461539,85,0,76,9
2014-15,2015-03-10,Pittsburgh Penguins,1,Metropolitan,Eastern,86,2,132,0.6515151515151515,86,0,78,8
2014-15,2015-03-12,Pittsburgh Penguins,2,Metropolitan,Eastern,88,2,134,0.6567164179104478,88,0,80,8
2014-15,2015-03-14,Pittsburgh Penguins,0,Metropolitan,Eastern,88,2,136,0.6470588235294118,88,0,82,6
2014-15,2015-03-15,Pittsburgh Penguins,0,Metropolitan,Eastern,88,2,138,0.6376811594202898,88,0,82,6
2014-15,2015-03-17,Pittsburgh Penguins,0,Metropolitan,Eastern,88,2,140,0.6285714285714286,88,0,83,5
2014-15,2015-03-20,Pittsburgh Penguins,0,Metropolitan,Eastern,88,2,142,0.6197183098591549,88,0,83,5
2014-15,2015-03-22,Pittsburgh Penguins,2,Metropolitan,Eastern,90,2,144,0.625,90,0,84,6
2014-15,2015-03-24,Pittsburgh Penguins,1,Metropolitan,Eastern,91,2,146,0.6232876712328768,91,0,85,6
2014-15,2015-03-26,Pittsburgh Penguins,0,Metropolitan,Eastern,91,2,148,0.6148648648648649,91,0,85,6
2014-15,2015-03-28,Pittsburgh Penguins,2,Metropolitan,Eastern,93,2,150,0.62,93,0,87,6
2014-15,2015-03-29,Pittsburgh Penguins,2,Metropolitan,Eastern,95,2,152,0.625,95,0,89,6
2014-15,2015-04-02,Pittsburgh Penguins,0,Metropolitan,Eastern,95,2,154,0.6168831168831169,96,-1,93,2
2014-15,2015-04-04,Pittsburgh Penguins,0,Metropolitan,Eastern,95,2,156,0.6089743589743589,97,-2,95,0
2014-15,2015-04-05,Pittsburgh Penguins,0,Metropolitan,Eastern,95,2,158,0.6012658227848101,98,-3,95,0
2014-15,2015-04-07,Pittsburgh Penguins,1,Metropolitan,Eastern,96,2,160,0.6,98,-2,95,1
2014-15,2015-04-10,Pittsburgh Penguins,0,Metropolitan,Eastern,96,2,162,0.5925925925925926,100,-4,96,0
2014-15,2015-04-11,Pittsburgh Penguins,2,Metropolitan,Eastern,98,2,164,0.5975609756097561,101,-3,98,0
2014-15,2014-10-09,San Jose Sharks,2,Pacific,Western,2,2,2,1.0,0,2,0,2
2014-15,2014-10-12,San Jose Sharks,2,Pacific,Western,4,2,4,1.0,2,2,2,2
2014-15,2014-10-14,San Jose Sharks,2,Pacific,Western,6,2,6,1.0,4,2,3,3
2014-15,2014-10-16,San Jose Sharks,1,Pacific,Western,7,2,8,0.875,6,1,4,3
2014-15,2014-10-18,San Jose Sharks,2,Pacific,Western,9,2,10,0.9,7,2,5,4
2014-15,2014-10-19,San Jose Sharks,0,Pacific,Western,9,2,12,0.75,8,1,6,3
2014-15,2014-10-21,San Jose Sharks,0,Pacific,Western,9,2,14,0.6428571428571429,9,0,6,3
2014-15,2014-10-24,San Jose Sharks,0,Pacific,Western,9,2,16,0.5625,11,-2,8,1
2014-15,2014-10-25,San Jose Sharks,0,Pacific,Western,9,2,18,0.5,11,-2,8,1
2014-15,2014-10-27,San Jose Sharks,2,Pacific,Western,11,2,20,0.55,11,0,10,1
2014-15,2014-10-29,San Jose Sharks,2,Pacific,Western,13,2,22,0.5909090909090909,13,0,11,2
2014-15,2014-10-31,San Jose Sharks,1,Pacific,Western,14,2,24,0.5833333333333334,14,0,12,2
2014-15,2014-11-02,San Jose Sharks,2,Pacific,Western,16,2,26,0.6153846153846154,16,0,13,3
2014-15,2014-11-07,San Jose Sharks,0,Pacific,Western,16,2,28,0.5714285714285714,18,-2,16,0
2014-15,2014-11-09,San Jose Sharks,2,Pacific,Western,18,2,30,0.6,20,-2,18,0
2014-15,2014-11-10,San Jose Sharks,0,Pacific,Western,18,2,32,0.5625,20,-2,18,0
2014-15,2014-11-12,San Jose Sharks,0,Pacific,Western,18,2,34,0.5294117647058824,20,-2,18,0
2014-15,2014-11-14,San Jose Sharks,2,Pacific,Western,20,2,36,0.5555555555555556,22,-2,20,0
2014-15,2014-11-16,San Jose Sharks,0,Pacific,Western,20,2,38,0.5263157894736842,24,-4,21,-1
2014-15,2014-11-16,San Jose Sharks,2,Pacific,Western,22,2,40,0.55,24,-2,21,1
2014-15,2014-11-19,San Jose Sharks,0,Pacific,Western,22,2,42,0.5238095238095238,24,-2,22,0
2014-15,2014-11-21,San Jose Sharks,1,Pacific,Western,23,2,44,0.5227272727272727,26,-3,23,0
2014-15,2014-11-23,San Jose Sharks,1,Pacific,Western,24,2,46,0.5217391304347826,27,-3,24,0
2014-15,2014-11-27,San Jose Sharks,0,Pacific,Western,24,2,48,0.5,30,-6,27,-3
2014-15,2014-11-30,San Jose Sharks,2,Pacific,Western,26,2,50,0.52,32,-6,28,-2
2014-15,2014-12-03,San Jose Sharks,2,Pacific,Western,28,2,52,0.5384615384615384,34,-6,28,0
2014-15,2014-12-05,San Jose Sharks,2,Pacific,Western,30,2,54,0.5555555555555556,36,-6,30,0
2014-15,2014-12-07,San Jose Sharks,2,Pacific,Western,32,2,56,0.5714285714285714,36,-4,33,-1
2014-15,2014-12-08,San Jose Sharks,0,Pacific,Western,32,2,58,0.5517241379310345,36,-4,33,-1
2014-15,2014-12-10,San Jose Sharks,2,Pacific,Western,34,2,60,0.5666666666666667,36,-2,34,0
2014-15,2014-12-12,San Jose Sharks,2,Pacific,Western,36,2,62,0.5806451612903226,36,0,36,0
2014-15,2014-12-14,San Jose Sharks,2,Pacific,Western,38,2,64,0.59375,38,0,36,2
2014-15,2014-12-19,San Jose Sharks,2,Pacific,Western,40,2,66,0.6060606060606061,38,2,38,2
2014-15,2014-12-21,San Jose Sharks,2,Pacific,Western,42,2,68,0.6176470588235294,40,2,40,2
2014-15,2014-12-23,San Jose Sharks,1,Pacific,Western,43,2,70,0.6142857142857143,42,1,41,2
2014-15,2014-12-28,San Jose Sharks,0,Pacific,Western,43,2,72,0.5972222222222222,43,0,42,1
2014-15,2014-12-31,San Jose Sharks,0,Pacific,Western,43,2,74,0.581081081081081,44,-1,43,0
2014-15,2015-01-01,San Jose Sharks,2,Pacific,Western,45,2,76,0.5921052631578947,45,0,45,0
2014-15,2015-01-04,San Jose Sharks,0,Pacific,Western,45,2,78,0.5769230769230769,47,-2,45,0
2014-15,2015-01-06,San Jose Sharks,2,Pacific,Western,47,2,80,0.5875,47,0,47,0
2014-15,2015-01-07,San Jose Sharks,2,Pacific,Western,49,2,82,0.5975609756097561,49,0,47,2
2014-15,2015-01-09,San Jose Sharks,0,Pacific,Western,49,2,84,0.5833333333333334,49,0,47,2
2014-15,2015-01-11,San Jose Sharks,0,Pacific,Western,49,2,86,0.5697674418604651,49,0,48,1
2014-15,2015-01-14,San Jose Sharks,2,Pacific,Western,51,2,88,0.5795454545454546,50,1,49,2
2014-15,2015-01-16,San Jose Sharks,2,Pacific,Western,53,2,90,0.5888888888888889,51,2,50,3
2014-15,2015-01-18,San Jose Sharks,1,Pacific,Western,54,2,92,0.5869565217391305,53,1,51,3
2014-15,2015-01-20,San Jose Sharks,0,Pacific,Western,54,2,94,0.574468085106383,54,0,53,1
2014-15,2015-01-22,San Jose Sharks,2,Pacific,Western,56,2,96,0.5833333333333334,55,1,53,3
2014-15,2015-01-30,San Jose Sharks,2,Pacific,Western,58,2,98,0.5918367346938775,55,3,55,3
2014-15,2015-02-01,San Jose Sharks,2,Pacific,Western,60,2,100,0.6,57,3,57,3
2014-15,2015-02-03,San Jose Sharks,1,Pacific,Western,61,2,102,0.5980392156862745,59,2,57,4
2014-15,2015-02-05,San Jose Sharks,0,Pacific,Western,61,2,104,0.5865384615384616,61,0,59,2
2014-15,2015-02-06,San Jose Sharks,2,Pacific,Western,63,2,106,0.5943396226415094,61,2,59,4
2014-15,2015-02-08,San Jose Sharks,0,Pacific,Western,63,2,108,0.5833333333333334,61,2,61,2
2014-15,2015-02-10,San Jose Sharks,0,Pacific,Western,63,2,110,0.5727272727272728,63,0,61,2
2014-15,2015-02-12,San Jose Sharks,1,Pacific,Western,64,2,112,0.5714285714285714,63,1,63,1
2014-15,2015-02-14,San Jose Sharks,2,Pacific,Western,66,2,114,0.5789473684210527,65,1,63,3
2014-15,2015-02-16,San Jose Sharks,0,Pacific,Western,66,2,116,0.5689655172413793,65,1,65,1
2014-15,2015-02-18,San Jose Sharks,0,Pacific,Western,66,2,118,0.559322033898305,67,-1,66,0
2014-15,2015-02-20,San Jose Sharks,2,Pacific,Western,68,2,120,0.5666666666666667,68,0,68,0
2014-15,2015-02-22,San Jose Sharks,0,Pacific,Western,68,2,122,0.5573770491803278,68,0,68,0
2014-15,2015-02-27,San Jose Sharks,0,Pacific,Western,68,2,124,0.5483870967741935,70,-2,70,-2
2014-15,2015-03-01,San Jose Sharks,0,Pacific,Western,68,2,126,0.5396825396825397,70,-2,70,-2
2014-15,2015-03-03,San Jose Sharks,2,Pacific,Western,70,2,128,0.546875,70,0,70,0
2014-15,2015-03-04,San Jose Sharks,2,Pacific,Western,72,2,130,0.5538461538461539,72,0,72,0
2014-15,2015-03-08,San Jose Sharks,0,Pacific,Western,72,2,132,0.5454545454545454,77,-5,77,-5
2014-15,2015-03-10,San Jose Sharks,2,Pacific,Western,74,2,134,0.5522388059701493,77,-3,77,-3
2014-15,2015-03-13,San Jose Sharks,2,Pacific,Western,76,2,136,0.5588235294117647,79,-3,79,-3
2014-15,2015-03-14,San Jose Sharks,0,Pacific,Western,76,2,138,0.5507246376811594,81,-5,80,-4
2014-15,2015-03-18,San Jose Sharks,0,Pacific,Western,76,2,140,0.5428571428571428,81,-5,81,-5
2014-15,2015-03-19,San Jose Sharks,2,Pacific,Western,78,2,142,0.5492957746478874,82,-4,82,-4
2014-15,2015-03-21,San Jose Sharks,0,Pacific,Western,78,2,144,0.5416666666666666,84,-6,84,-6
2014-15,2015-03-23,San Jose Sharks,0,Pacific,Western,78,2,146,0.5342465753424658,84,-6,84,-6
2014-15,2015-03-26,San Jose Sharks,2,Pacific,Western,80,2,148,0.5405405405405406,88,-8,88,-8
2014-15,2015-03-28,San Jose Sharks,2,Pacific,Western,82,2,150,0.5466666666666666,88,-6,88,-6
2014-15,2015-03-29,San Jose Sharks,1,Pacific,Western,83,2,152,0.5460526315789473,89,-6,89,-6
2014-15,2015-04-02,San Jose Sharks,2,Pacific,Western,85,2,154,0.551948051948052,91,-6,90,-5
2014-15,2015-04-04,San Jose Sharks,2,Pacific,Western,87,2,156,0.5576923076923077,91,-4,91,-4
2014-15,2015-04-05,San Jose Sharks,0,Pacific,Western,87,2,158,0.5506329113924051,93,-6,92,-5
2014-15,2015-04-07,San Jose Sharks,0,Pacific,Western,87,2,160,0.54375,93,-6,93,-6
2014-15,2015-04-10,San Jose Sharks,2,Pacific,Western,89,2,162,0.5493827160493827,97,-8,97,-8
2014-15,2015-04-11,San Jose Sharks,0,Pacific,Western,89,2,164,0.5426829268292683,97,-8,97,-8
2014-15,2014-10-10,St. Louis Blues,0,Central,Western,0,2,2,0.0,2,-2,1,-1
2014-15,2014-10-11,St. Louis Blues,2,Central,Western,2,2,4,0.5,2,0,2,0
2014-15,2014-10-17,St. Louis Blues,1,Central,Western,3,2,6,0.5,5,-2,4,-1
2014-15,2014-10-19,St. Louis Blues,2,Central,Western,5,2,8,0.625,6,-1,6,-1
2014-15,2014-10-20,St. Louis Blues,0,Central,Western,5,2,10,0.5,6,-1,6,-1
2014-15,2014-10-24,St. Louis Blues,0,Central,Western,5,2,12,0.4166666666666667,9,-4,8,-3
2014-15,2014-10-26,St. Louis Blues,2,Central,Western,7,2,14,0.5,9,-2,8,-1
2014-15,2014-10-29,St. Louis Blues,2,Central,Western,9,2,16,0.5625,11,-2,11,-2
2014-15,2014-10-31,St. Louis Blues,2,Central,Western,11,2,18,0.6111111111111112,12,-1,12,-1
2014-15,2014-11-02,St. Louis Blues,2,Central,Western,13,2,20,0.65,13,0,13,0
2014-15,2014-11-04,St. Louis Blues,2,Central,Western,15,2,22,0.6818181818181818,14,1,14,1
2014-15,2014-11-05,St. Louis Blues,2,Central,Western,17,2,24,0.7083333333333334,15,2,15,2
2014-15,2014-11-07,St. Louis Blues,2,Central,Western,19,2,26,0.7307692307692307,16,3,16,3
2014-15,2014-11-09,St. Louis Blues,0,Central,Western,19,2,28,0.6785714285714286,18,1,18,1
2014-15,2014-11-12,St. Louis Blues,2,Central,Western,21,2,30,0.7,19,2,18,3
2014-15,2014-11-14,St. Louis Blues,2,Central,Western,23,2,32,0.71875,20,3,20,3
2014-15,2014-11-16,St. Louis Blues,2,Central,Western,25,2,34,0.7352941176470589,21,4,21,4
2014-15,2014-11-19,St. Louis Blues,0,Central,Western,25,2,36,0.6944444444444444,23,2,22,3
2014-15,2014-11-21,St. Louis Blues,0,Central,Western,25,2,38,0.6578947368421053,23,2,23,2
2014-15,2014-11-22,St. Louis Blues,2,Central,Western,27,2,40,0.675,23,4,23,4
2014-15,2014-11-23,St. Louis Blues,2,Central,Western,29,2,42,0.6904761904761905,25,4,24,5
2014-15,2014-11-26,St. Louis Blues,1,Central,Western,30,2,44,0.6818181818181818,25,5,25,5
2014-15,2014-11-29,St. Louis Blues,2,Central,Western,32,2,46,0.6956521739130435,29,3,28,4
2014-15,2014-11-30,St. Louis Blues,2,Central,Western,34,2,48,0.7083333333333334,31,3,28,6
2014-15,2014-12-04,St. Louis Blues,0,Central,Western,34,2,50,0.68,33,1,30,4
2014-15,2014-12-05,St. Louis Blues,0,Central,Western,34,2,52,0.6538461538461539,33,1,30,4
2014-15,2014-12-06,St. Louis Blues,2,Central,Western,36,2,54,0.6666666666666666,35,1,32,4
2014-15,2014-12-09,St. Louis Blues,2,Central,Western,38,2,56,0.6785714285714286,36,2,33,5
2014-15,2014-12-12,St. Louis Blues,2,Central,Western,40,2,58,0.6896551724137931,40,0,36,4
2014-15,2014-12-14,St. Louis Blues,2,Central,Western,42,2,60,0.7,40,2,36,6
2014-15,2014-12-17,St. Louis Blues,2,Central,Western,44,2,62,0.7096774193548387,42,2,36,8
2014-15,2014-12-19,St. Louis Blues,0,Central,Western,44,2,64,0.6875,42,2,38,6
2014-15,2014-12-21,St. Louis Blues,1,Central,Western,45,2,66,0.6818181818181818,44,1,40,5
2014-15,2014-12-24,St. Louis Blues,0,Central,Western,45,2,68,0.6617647058823529,45,0,41,4
2014-15,2014-12-28,St. Louis Blues,0,Central,Western,45,2,70,0.6428571428571429,45,0,42,3
2014-15,2014-12-30,St. Louis Blues,2,Central,Western,47,2,72,0.6527777777777778,47,0,43,4
2014-15,2014-12-31,St. Louis Blues,0,Central,Western,47,2,74,0.6351351351351351,47,0,43,4
2014-15,2015-01-03,St. Louis Blues,0,Central,Western,47,2,76,0.618421052631579,47,0,45,2
2014-15,2015-01-04,St. Louis Blues,2,Central,Western,49,2,78,0.6282051282051282,49,0,45,4
2014-15,2015-01-07,St. Louis Blues,2,Central,Western,51,2,80,0.6375,51,0,47,4
2014-15,2015-01-09,St. Louis Blues,2,Central,Western,53,2,82,0.6463414634146342,53,0,47,6
2014-15,2015-01-11,St. Louis Blues,2,Central,Western,55,2,84,0.6547619047619048,55,0,48,7
2014-15,2015-01-14,St. Louis Blues,2,Central,Western,57,2,86,0.6627906976744186,57,0,49,8
2014-15,2015-01-16,St. Louis Blues,1,Central,Western,58,2,88,0.6590909090909091,58,0,50,8
2014-15,2015-01-18,St. Louis Blues,2,Central,Western,60,2,90,0.6666666666666666,58,2,51,9
2014-15,2015-01-20,St. Louis Blues,2,Central,Western,62,2,92,0.6739130434782609,58,4,53,9
2014-15,2015-01-30,St. Louis Blues,2,Central,Western,64,2,94,0.6808510638297872,62,2,55,9
2014-15,2015-01-31,St. Louis Blues,2,Central,Western,66,2,96,0.6875,64,2,55,11
2014-15,2015-02-01,St. Louis Blues,2,Central,Western,68,2,98,0.6938775510204082,64,4,57,11
2014-15,2015-02-04,St. Louis Blues,2,Central,Western,70,2,100,0.7,64,6,59,11
2014-15,2015-02-06,St. Louis Blues,2,Central,Western,72,2,102,0.7058823529411765,64,8,59,13
2014-15,2015-02-07,St. Louis Blues,0,Central,Western,72,2,104,0.6923076923076923,66,6,59,13
2014-15,2015-02-08,St. Louis Blues,0,Central,Western,72,2,106,0.6792452830188679,68,4,61,11
2014-15,2015-02-11,St. Louis Blues,2,Central,Western,74,2,108,0.6851851851851852,69,5,61,13
2014-15,2015-02-13,St. Louis Blues,2,Central,Western,76,2,110,0.6909090909090909,70,6,63,13
2014-15,2015-02-15,St. Louis Blues,2,Central,Western,78,2,112,0.6964285714285714,74,4,65,13
2014-15,2015-02-18,St. Louis Blues,0,Central,Western,78,2,114,0.6842105263157895,74,4,66,12
2014-15,2015-02-21,St. Louis Blues,2,Central,Western,80,2,116,0.6896551724137931,75,5,68,12
2014-15,2015-02-22,St. Louis Blues,0,Central,Western,80,2,118,0.6779661016949152,75,5,68,12
2014-15,2015-02-25,St. Louis Blues,0,Central,Western,80,2,120,0.6666666666666666,77,3,69,11
2014-15,2015-02-27,St. Louis Blues,2,Central,Western,82,2,122,0.6721311475409836,79,3,70,12
2014-15,2015-03-01,St. Louis Blues,2,Central,Western,84,2,124,0.6774193548387096,79,5,70,14
2014-15,2015-03-02,St. Louis Blues,1,Central,Western,85,2,126,0.6746031746031746,79,6,70,15
2014-15,2015-03-06,St. Louis Blues,0,Central,Western,85,2,128,0.6640625,81,4,74,11
2014-15,2015-03-08,St. Louis Blues,2,Central,Western,87,2,130,0.6692307692307692,84,3,77,10
2014-15,2015-03-11,St. Louis Blues,2,Central,Western,89,2,132,0.6742424242424242,84,5,77,12
2014-15,2015-03-13,St. Louis Blues,2,Central,Western,91,2,134,0.6791044776119403,86,5,79,12
2014-15,2015-03-15,St. Louis Blues,2,Central,Western,93,2,136,0.6838235294117647,88,5,80,13
2014-15,2015-03-15,St. Louis Blues,0,Central,Western,93,2,138,0.6739130434782609,88,5,80,13
2014-15,2015-03-18,St. Louis Blues,2,Central,Western,95,2,140,0.6785714285714286,90,5,81,14
2014-15,2015-03-20,St. Louis Blues,1,Central,Western,96,2,142,0.676056338028169,92,4,83,13
2014-15,2015-03-21,St. Louis Blues,0,Central,Western,96,2,144,0.6666666666666666,92,4,84,12
2014-15,2015-03-22,St. Louis Blues,1,Central,Western,97,2,146,0.6643835616438356,92,5,84,13
2014-15,2015-03-24,St. Louis Blues,2,Central,Western,99,2,148,0.668918918918919,94,5,86,13
2014-15,2015-03-29,St. Louis Blues,0,Central,Western,99,2,150,0.66,96,3,89,10
2014-15,2015-03-31,St. Louis Blues,0,Central,Western,99,2,152,0.6513157894736842,98,1,90,9
2014-15,2015-04-03,St. Louis Blues,2,Central,Western,101,2,154,0.6558441558441559,100,1,90,11
2014-15,2015-04-04,St. Louis Blues,2,Central,Western,103,2,156,0.6602564102564102,100,3,91,12
2014-15,2015-04-05,St. Louis Blues,2,Central,Western,105,2,158,0.6645569620253164,102,3,92,13
2014-15,2015-04-08,St. Louis Blues,0,Central,Western,105,2,160,0.65625,102,3,95,10
2014-15,2015-04-10,St. Louis Blues,2,Central,Western,107,2,162,0.6604938271604939,102,5,97,10
2014-15,2015-04-11,St. Louis Blues,2,Central,Western,109,2,164,0.6646341463414634,102,7,97,12
2014-15,2014-10-09,Tampa Bay Lightning,2,Atlantic,Eastern,2,2,2,1.0,2,0,1,1
2014-15,2014-10-11,Tampa Bay Lightning,1,Atlantic,Eastern,3,2,4,0.75,2,1,2,1
2014-15,2014-10-13,Tampa Bay Lightning,2,Atlantic,Eastern,5,2,6,0.8333333333333334,4,1,3,2
2014-15,2014-10-14,Tampa Bay Lightning,0,Atlantic,Eastern,5,2,8,0.625,4,1,4,1
2014-15,2014-10-19,Tampa Bay Lightning,2,Atlantic,Eastern,7,2,10,0.7,7,0,6,1
2014-15,2014-10-21,Tampa Bay Lightning,0,Atlantic,Eastern,7,2,12,0.5833333333333334,8,-1,7,0
2014-15,2014-10-22,Tampa Bay Lightning,2,Atlantic,Eastern,9,2,14,0.6428571428571429,8,1,8,1
2014-15,2014-10-25,Tampa Bay Lightning,2,Atlantic,Eastern,11,2,16,0.6875,10,1,8,3
2014-15,2014-10-26,Tampa Bay Lightning,0,Atlantic,Eastern,11,2,18,0.6111111111111112,10,1,9,2
2014-15,2014-10-28,Tampa Bay Lightning,2,Atlantic,Eastern,13,2,20,0.65,11,2,10,3
2014-15,2014-10-30,Tampa Bay Lightning,2,Atlantic,Eastern,15,2,22,0.6818181818181818,12,3,12,3
2014-15,2014-11-01,Tampa Bay Lightning,2,Atlantic,Eastern,17,2,24,0.7083333333333334,14,3,12,5
2014-15,2014-11-07,Tampa Bay Lightning,2,Atlantic,Eastern,19,2,26,0.7307692307692307,18,1,14,5
2014-15,2014-11-09,Tampa Bay Lightning,2,Atlantic,Eastern,21,2,28,0.75,19,2,16,5
2014-15,2014-11-09,Tampa Bay Lightning,2,Atlantic,Eastern,23,2,30,0.7666666666666667,19,4,16,7
2014-15,2014-11-12,Tampa Bay Lightning,1,Atlantic,Eastern,24,2,32,0.75,20,4,18,6
2014-15,2014-11-14,Tampa Bay Lightning,0,Atlantic,Eastern,24,2,34,0.7058823529411765,20,4,19,5
2014-15,2014-11-16,Tampa Bay Lightning,2,Atlantic,Eastern,26,2,36,0.7222222222222222,22,4,20,6
2014-15,2014-11-18,Tampa Bay Lightning,2,Atlantic,Eastern,28,2,38,0.7368421052631579,22,6,20,8
2014-15,2014-11-19,Tampa Bay Lightning,0,Atlantic,Eastern,28,2,40,0.7,24,4,20,8
2014-15,2014-11-21,Tampa Bay Lightning,0,Atlantic,Eastern,28,2,42,0.6666666666666666,25,3,22,6
2014-15,2014-11-23,Tampa Bay Lightning,2,Atlantic,Eastern,30,2,44,0.6818181818181818,26,4,22,8
2014-15,2014-11-27,Tampa Bay Lightning,2,Atlantic,Eastern,32,2,46,0.6956521739130435,29,3,24,8
2014-15,2014-11-30,Tampa Bay Lightning,2,Atlantic,Eastern,34,2,48,0.7083333333333334,33,1,26,8
2014-15,2014-12-02,Tampa Bay Lightning,2,Atlantic,Eastern,36,2,50,0.72,33,3,26,10
2014-15,2014-12-03,Tampa Bay Lightning,1,Atlantic,Eastern,37,2,52,0.7115384615384616,33,4,26,11
2014-15,2014-12-05,Tampa Bay Lightning,2,Atlantic,Eastern,39,2,54,0.7222222222222222,35,4,27,12
2014-15,2014-12-07,Tampa Bay Lightning,0,Atlantic,Eastern,39,2,56,0.6964285714285714,36,3,29,10
2014-15,2014-12-10,Tampa Bay Lightning,0,Atlantic,Eastern,39,2,58,0.6724137931034483,37,2,30,9
2014-15,2014-12-12,Tampa Bay Lightning,2,Atlantic,Eastern,41,2,60,0.6833333333333333,38,3,31,10
2014-15,2014-12-14,Tampa Bay Lightning,0,Atlantic,Eastern,41,2,62,0.6612903225806451,40,1,32,9
2014-15,2014-12-16,Tampa Bay Lightning,0,Atlantic,Eastern,41,2,64,0.640625,40,1,32,9
2014-15,2014-12-17,Tampa Bay Lightning,2,Atlantic,Eastern,43,2,66,0.6515151515151515,42,1,34,9
2014-15,2014-12-20,Tampa Bay Lightning,1,Atlantic,Eastern,44,2,68,0.6470588235294118,42,2,36,8
2014-15,2014-12-21,Tampa Bay Lightning,0,Atlantic,Eastern,44,2,70,0.6285714285714286,43,1,36,8
2014-15,2014-12-24,Tampa Bay Lightning,2,Atlantic,Eastern,46,2,72,0.6388888888888888,45,1,40,6
2014-15,2014-12-28,Tampa Bay Lightning,2,Atlantic,Eastern,48,2,74,0.6486486486486487,46,2,42,6
2014-15,2014-12-30,Tampa Bay Lightning,2,Atlantic,Eastern,50,2,76,0.6578947368421053,47,3,42,8
2014-15,2014-12-31,Tampa Bay Lightning,2,Atlantic,Eastern,52,2,78,0.6666666666666666,47,5,43,9
2014-15,2015-01-03,Tampa Bay Lightning,0,Atlantic,Eastern,52,2,80,0.65,49,3,44,8
2014-15,2015-01-05,Tampa Bay Lightning,2,Atlantic,Eastern,54,2,82,0.6585365853658537,49,5,45,9
2014-15,2015-01-07,Tampa Bay Lightning,2,Atlantic,Eastern,56,2,84,0.6666666666666666,51,5,45,11
2014-15,2015-01-10,Tampa Bay Lightning,2,Atlantic,Eastern,58,2,86,0.6744186046511628,53,5,50,8
2014-15,2015-01-13,Tampa Bay Lightning,0,Atlantic,Eastern,58,2,88,0.6590909090909091,53,5,50,8
2014-15,2015-01-14,Tampa Bay Lightning,0,Atlantic,Eastern,58,2,90,0.6444444444444445,55,3,52,6
2014-15,2015-01-16,Tampa Bay Lightning,2,Atlantic,Eastern,60,2,92,0.6521739130434783,57,3,52,8
2014-15,2015-01-18,Tampa Bay Lightning,2,Atlantic,Eastern,62,2,94,0.6595744680851063,59,3,54,8
2014-15,2015-01-21,Tampa Bay Lightning,2,Atlantic,Eastern,64,2,96,0.6666666666666666,61,3,56,8
2014-15,2015-01-28,Tampa Bay Lightning,0,Atlantic,Eastern,64,2,98,0.6530612244897959,63,1,57,7
2014-15,2015-01-30,Tampa Bay Lightning,2,Atlantic,Eastern,66,2,100,0.66,65,1,58,8
2014-15,2015-02-01,Tampa Bay Lightning,2,Atlantic,Eastern,68,2,102,0.6666666666666666,67,1,60,8
2014-15,2015-02-04,Tampa Bay Lightning,1,Atlantic,Eastern,69,2,104,0.6634615384615384,67,2,61,8
2014-15,2015-02-06,Tampa Bay Lightning,2,Atlantic,Eastern,71,2,106,0.6698113207547169,67,4,61,10
2014-15,2015-02-07,Tampa Bay Lightning,0,Atlantic,Eastern,71,2,108,0.6574074074074074,67,4,61,10
2014-15,2015-02-08,Tampa Bay Lightning,2,Atlantic,Eastern,73,2,110,0.6636363636363637,69,4,63,10
2014-15,2015-02-11,Tampa Bay Lightning,1,Atlantic,Eastern,74,2,112,0.6607142857142857,71,3,63,11
2014-15,2015-02-13,Tampa Bay Lightning,0,Atlantic,Eastern,74,2,114,0.6491228070175439,71,3,63,11
2014-15,2015-02-16,Tampa Bay Lightning,2,Atlantic,Eastern,76,2,116,0.6551724137931034,72,4,63,13
2014-15,2015-02-17,Tampa Bay Lightning,0,Atlantic,Eastern,76,2,118,0.6440677966101694,72,4,64,12
2014-15,2015-02-19,Tampa Bay Lightning,2,Atlantic,Eastern,78,2,120,0.65,74,4,65,13
2014-15,2015-02-22,Tampa Bay Lightning,2,Atlantic,Eastern,80,2,122,0.6557377049180327,76,4,67,13
2014-15,2015-02-23,Tampa Bay Lightning,0,Atlantic,Eastern,80,2,124,0.6451612903225806,76,4,67,13
2014-15,2015-02-28,Tampa Bay Lightning,2,Atlantic,Eastern,82,2,126,0.6507936507936508,81,1,69,13
2014-15,2015-03-01,Tampa Bay Lightning,0,Atlantic,Eastern,82,2,128,0.640625,81,1,69,13
2014-15,2015-03-04,Tampa Bay Lightning,2,Atlantic,Eastern,84,2,130,0.6461538461538462,81,3,69,15
2014-15,2015-03-06,Tampa Bay Lightning,2,Atlantic,Eastern,86,2,132,0.6515151515151515,83,3,72,14
2014-15,2015-03-08,Tampa Bay Lightning,2,Atlantic,Eastern,88,2,134,0.6567164179104478,83,5,76,12
2014-15,2015-03-10,Tampa Bay Lightning,2,Atlantic,Eastern,90,2,136,0.6617647058823529,85,5,78,12
2014-15,2015-03-12,Tampa Bay Lightning,1,Atlantic,Eastern,91,2,138,0.6594202898550725,85,6,80,11
2014-15,2015-03-14,Tampa Bay Lightning,0,Atlantic,Eastern,91,2,140,0.65,85,6,82,9
2014-15,2015-03-16,Tampa Bay Lightning,2,Atlantic,Eastern,93,2,142,0.6549295774647887,87,6,82,11
2014-15,2015-03-20,Tampa Bay Lightning,2,Atlantic,Eastern,95,2,144,0.6597222222222222,87,8,83,12
2014-15,2015-03-22,Tampa Bay Lightning,2,Atlantic,Eastern,97,2,146,0.6643835616438356,89,8,84,13
2014-15,2015-03-24,Tampa Bay Lightning,2,Atlantic,Eastern,99,2,148,0.668918918918919,90,9,85,14
2014-15,2015-03-26,Tampa Bay Lightning,0,Atlantic,Eastern,99,2,150,0.66,90,9,85,14
2014-15,2015-03-28,Tampa Bay Lightning,0,Atlantic,Eastern,99,2,152,0.6513157894736842,92,7,87,12
2014-15,2015-03-30,Tampa Bay Lightning,2,Atlantic,Eastern,101,2,154,0.6558441558441559,92,9,89,12
2014-15,2015-03-31,Tampa Bay Lightning,0,Atlantic,Eastern,101,2,156,0.6474358974358975,93,8,91,10
2014-15,2015-04-02,Tampa Bay Lightning,1,Atlantic,Eastern,102,2,158,0.6455696202531646,93,9,93,9
2014-15,2015-04-04,Tampa Bay Lightning,2,Atlantic,Eastern,104,2,160,0.65,95,9,95,9
2014-15,2015-04-09,Tampa Bay Lightning,2,Atlantic,Eastern,106,2,162,0.654320987654321,98,8,96,10
2014-15,2015-04-11,Tampa Bay Lightning,2,Atlantic,Eastern,108,2,164,0.6585365853658537,100,8,98,10
2014-15,2014-10-08,Toronto Maple Leafs,0,Atlantic,Eastern,0,2,2,0.0,0,0,0,0
2014-15,2014-10-11,Toronto Maple Leafs,0,Atlantic,Eastern,0,2,4,0.0,2,-2,2,-2
2014-15,2014-10-12,Toronto Maple Leafs,2,Atlantic,Eastern,2,2,6,0.3333333333333333,2,0,2,0
2014-15,2014-10-14,Toronto Maple Leafs,2,Atlantic,Eastern,4,2,8,0.5,4,0,4,0
2014-15,2014-10-17,Toronto Maple Leafs,0,Atlantic,Eastern,4,2,10,0.4,5,-1,5,-1
2014-15,2014-10-18,Toronto Maple Leafs,1,Atlantic,Eastern,5,2,12,0.4166666666666667,7,-2,6,-1
2014-15,2014-10-21,Toronto Maple Leafs,2,Atlantic,Eastern,7,2,14,0.5,8,-1,7,0
2014-15,2014-10-25,Toronto Maple Leafs,0,Atlantic,Eastern,7,2,16,0.4375,10,-3,8,-1
2014-15,2014-10-28,Toronto Maple Leafs,2,Atlantic,Eastern,9,2,18,0.5,11,-2,10,-1
2014-15,2014-10-31,Toronto Maple Leafs,2,Atlantic,Eastern,11,2,20,0.55,14,-3,12,-1
2014-15,2014-11-01,Toronto Maple Leafs,2,Atlantic,Eastern,13,2,22,0.5909090909090909,14,-1,12,1
2014-15,2014-11-05,Toronto Maple Leafs,0,Atlantic,Eastern,13,2,24,0.5416666666666666,16,-3,13,0
2014-15,2014-11-07,Toronto Maple Leafs,1,Atlantic,Eastern,14,2,26,0.5384615384615384,18,-4,14,0
2014-15,2014-11-09,Toronto Maple Leafs,2,Atlantic,Eastern,16,2,28,0.5714285714285714,19,-3,16,0
2014-15,2014-11-09,Toronto Maple Leafs,2,Atlantic,Eastern,18,2,30,0.6,19,-1,16,2
2014-15,2014-11-13,Toronto Maple Leafs,2,Atlantic,Eastern,20,2,32,0.625,20,0,18,2
2014-15,2014-11-15,Toronto Maple Leafs,0,Atlantic,Eastern,20,2,34,0.5882352941176471,22,-2,20,0
2014-15,2014-11-16,Toronto Maple Leafs,0,Atlantic,Eastern,20,2,36,0.5555555555555556,22,-2,20,0
2014-15,2014-11-19,Toronto Maple Leafs,0,Atlantic,Eastern,20,2,38,0.5263157894736842,24,-4,20,0
2014-15,2014-11-21,Toronto Maple Leafs,2,Atlantic,Eastern,22,2,40,0.55,25,-3,22,0
2014-15,2014-11-23,Toronto Maple Leafs,2,Atlantic,Eastern,24,2,42,0.5714285714285714,26,-2,22,2
2014-15,2014-11-27,Toronto Maple Leafs,1,Atlantic,Eastern,25,2,44,0.5681818181818182,29,-4,24,1
2014-15,2014-11-30,Toronto Maple Leafs,2,Atlantic,Eastern,27,2,46,0.5869565217391305,33,-6,26,1
2014-15,2014-12-03,Toronto Maple Leafs,2,Atlantic,Eastern,29,2,48,0.6041666666666666,33,-4,26,3
2014-15,2014-12-05,Toronto Maple Leafs,0,Atlantic,Eastern,29,2,50,0.58,35,-6,27,2
2014-15,2014-12-07,Toronto Maple Leafs,2,Atlantic,Eastern,31,2,52,0.5961538461538461,36,-5,29,2
2014-15,2014-12-10,Toronto Maple Leafs,2,Atlantic,Eastern,33,2,54,0.6111111111111112,37,-4,30,3
2014-15,2014-12-11,Toronto Maple Leafs,2,Atlantic,Eastern,35,2,56,0.625,38,-3,30,5
2014-15,2014-12-14,Toronto Maple Leafs,2,Atlantic,Eastern,37,2,58,0.6379310344827587,40,-3,32,5
2014-15,2014-12-14,Toronto Maple Leafs,2,Atlantic,Eastern,39,2,60,0.65,40,-1,32,7
2014-15,2014-12-17,Toronto Maple Leafs,2,Atlantic,Eastern,41,2,62,0.6612903225806451,42,-1,34,7
2014-15,2014-12-19,Toronto Maple Leafs,0,Atlantic,Eastern,41,2,64,0.640625,42,-1,36,5
2014-15,2014-12-21,Toronto Maple Leafs,0,Atlantic,Eastern,41,2,66,0.6212121212121212,43,-2,36,5
2014-15,2014-12-22,Toronto Maple Leafs,0,Atlantic,Eastern,41,2,68,0.6029411764705882,43,-2,38,3
2014-15,2014-12-24,Toronto Maple Leafs,2,Atlantic,Eastern,43,2,70,0.6142857142857143,45,-2,40,3
2014-15,2014-12-28,Toronto Maple Leafs,0,Atlantic,Eastern,43,2,72,0.5972222222222222,46,-3,42,1
2014-15,2014-12-30,Toronto Maple Leafs,0,Atlantic,Eastern,43,2,74,0.581081081081081,47,-4,42,1
2014-15,2015-01-01,Toronto Maple Leafs,2,Atlantic,Eastern,45,2,76,0.5921052631578947,49,-4,44,1
2014-15,2015-01-03,Toronto Maple Leafs,0,Atlantic,Eastern,45,2,78,0.5769230769230769,49,-4,44,1
2014-15,2015-01-04,Toronto Maple Leafs,0,Atlantic,Eastern,45,2,80,0.5625,49,-4,45,0
2014-15,2015-01-08,Toronto Maple Leafs,0,Atlantic,Eastern,45,2,82,0.5487804878048781,53,-8,46,-1
2014-15,2015-01-10,Toronto Maple Leafs,2,Atlantic,Eastern,47,2,84,0.5595238095238095,53,-6,50,-3
2014-15,2015-01-13,Toronto Maple Leafs,0,Atlantic,Eastern,47,2,86,0.5465116279069767,53,-6,50,-3
2014-15,2015-01-15,Toronto Maple Leafs,0,Atlantic,Eastern,47,2,88,0.5340909090909091,55,-8,52,-5
2014-15,2015-01-16,Toronto Maple Leafs,0,Atlantic,Eastern,47,2,90,0.5222222222222223,57,-10,52,-5
2014-15,2015-01-18,Toronto Maple Leafs,0,Atlantic,Eastern,47,2,92,0.5108695652173914,59,-12,54,-7
2014-15,2015-01-20,Toronto Maple Leafs,0,Atlantic,Eastern,47,2,94,0.5,59,-12,54,-7
2014-15,2015-01-22,Toronto Maple Leafs,0,Atlantic,Eastern,47,2,96,0.4895833333333333,61,-14,57,-10
2014-15,2015-01-29,Toronto Maple Leafs,1,Atlantic,Eastern,48,2,98,0.4897959183673469,63,-15,57,-9
2014-15,2015-01-30,Toronto Maple Leafs,0,Atlantic,Eastern,48,2,100,0.48,65,-17,58,-10
2014-15,2015-02-01,Toronto Maple Leafs,0,Atlantic,Eastern,48,2,102,0.47058823529411764,67,-19,60,-12
2014-15,2015-02-04,Toronto Maple Leafs,0,Atlantic,Eastern,48,2,104,0.46153846153846156,67,-19,61,-13
2014-15,2015-02-07,Toronto Maple Leafs,0,Atlantic,Eastern,48,2,106,0.4528301886792453,67,-19,61,-13
2014-15,2015-02-08,Toronto Maple Leafs,2,Atlantic,Eastern,50,2,108,0.46296296296296297,69,-19,63,-13
2014-15,2015-02-11,Toronto Maple Leafs,0,Atlantic,Eastern,50,2,110,0.45454545454545453,71,-21,63,-13
2014-15,2015-02-13,Toronto Maple Leafs,0,Atlantic,Eastern,50,2,112,0.44642857142857145,71,-21,63,-13
2014-15,2015-02-15,Toronto Maple Leafs,1,Atlantic,Eastern,51,2,114,0.4473684210526316,72,-21,63,-12
2014-15,2015-02-18,Toronto Maple Leafs,0,Atlantic,Eastern,51,2,116,0.4396551724137931,72,-21,64,-13
2014-15,2015-02-21,Toronto Maple Leafs,0,Atlantic,Eastern,51,2,118,0.4322033898305085,74,-23,65,-14
2014-15,2015-02-22,Toronto Maple Leafs,2,Atlantic,Eastern,53,2,120,0.44166666666666665,76,-23,67,-14
2014-15,2015-02-27,Toronto Maple Leafs,2,Atlantic,Eastern,55,2,122,0.45081967213114754,79,-24,67,-12
2014-15,2015-03-01,Toronto Maple Leafs,0,Atlantic,Eastern,55,2,124,0.4435483870967742,81,-26,69,-14
2014-15,2015-03-02,Toronto Maple Leafs,0,Atlantic,Eastern,55,2,126,0.4365079365079365,81,-26,71,-16
2014-15,2015-03-04,Toronto Maple Leafs,2,Atlantic,Eastern,57,2,128,0.4453125,81,-24,69,-12
2014-15,2015-03-06,Toronto Maple Leafs,0,Atlantic,Eastern,57,2,130,0.43846153846153846,83,-26,72,-15
2014-15,2015-03-08,Toronto Maple Leafs,0,Atlantic,Eastern,57,2,132,0.4318181818181818,83,-26,76,-19
2014-15,2015-03-09,Toronto Maple Leafs,1,Atlantic,Eastern,58,2,134,0.43283582089552236,85,-27,76,-18
2014-15,2015-03-11,Toronto Maple Leafs,2,Atlantic,Eastern,60,2,136,0.4411764705882353,85,-25,78,-18
2014-15,2015-03-14,Toronto Maple Leafs,0,Atlantic,Eastern,60,2,138,0.43478260869565216,85,-25,82,-22
2014-15,2015-03-14,Toronto Maple Leafs,0,Atlantic,Eastern,60,2,140,0.42857142857142855,85,-25,82,-22
2014-15,2015-03-17,Toronto Maple Leafs,0,Atlantic,Eastern,60,2,142,0.4225352112676056,87,-27,83,-23
2014-15,2015-03-19,Toronto Maple Leafs,0,Atlantic,Eastern,60,2,144,0.4166666666666667,87,-27,83,-23
2014-15,2015-03-21,Toronto Maple Leafs,0,Atlantic,Eastern,60,2,146,0.410958904109589,87,-27,84,-24
2014-15,2015-03-23,Toronto Maple Leafs,0,Atlantic,Eastern,60,2,148,0.40540540540540543,89,-29,85,-25
2014-15,2015-03-26,Toronto Maple Leafs,0,Atlantic,Eastern,60,2,150,0.4,90,-30,85,-25
2014-15,2015-03-28,Toronto Maple Leafs,2,Atlantic,Eastern,62,2,152,0.40789473684210525,92,-30,87,-25
2014-15,2015-03-31,Toronto Maple Leafs,2,Atlantic,Eastern,64,2,154,0.4155844155844156,93,-29,91,-27
2014-15,2015-04-01,Toronto Maple Leafs,0,Atlantic,Eastern,64,2,156,0.41025641025641024,93,-29,91,-27
2014-15,2015-04-04,Toronto Maple Leafs,1,Atlantic,Eastern,65,2,158,0.41139240506329117,95,-30,95,-30
2014-15,2015-04-05,Toronto Maple Leafs,2,Atlantic,Eastern,67,2,160,0.41875,95,-28,95,-28
2014-15,2015-04-08,Toronto Maple Leafs,0,Atlantic,Eastern,67,2,162,0.41358024691358025,97,-30,95,-28
2014-15,2015-04-11,Toronto Maple Leafs,1,Atlantic,Eastern,68,2,164,0.4146341463414634,100,-32,98,-30
2014-15,2014-10-09,Vancouver Canucks,2,Pacific,Western,2,2,2,1.0,0,2,0,2
2014-15,2014-10-12,Vancouver Canucks,2,Pacific,Western,4,2,4,1.0,2,2,2,2
2014-15,2014-10-18,Vancouver Canucks,2,Pacific,Western,6,2,6,1.0,7,-1,5,1
2014-15,2014-10-19,Vancouver Canucks,0,Pacific,Western,6,2,8,0.75,8,-2,6,0
2014-15,2014-10-22,Vancouver Canucks,0,Pacific,Western,6,2,10,0.6,9,-3,6,0
2014-15,2014-10-24,Vancouver Canucks,2,Pacific,Western,8,2,12,0.6666666666666666,11,-3,8,0
2014-15,2014-10-25,Vancouver Canucks,0,Pacific,Western,8,2,14,0.5714285714285714,11,-3,8,0
2014-15,2014-10-27,Vancouver Canucks,2,Pacific,Western,10,2,16,0.625,11,-1,10,0
2014-15,2014-10-29,Vancouver Canucks,2,Pacific,Western,12,2,18,0.6666666666666666,13,-1,11,1
2014-15,2014-10-31,Vancouver Canucks,2,Pacific,Western,14,2,20,0.7,14,0,12,2
2014-15,2014-11-02,Vancouver Canucks,2,Pacific,Western,16,2,22,0.7272727272727273,16,0,13,3
2014-15,2014-11-03,Vancouver Canucks,0,Pacific,Western,16,2,24,0.6666666666666666,16,0,13,3
2014-15,2014-11-05,Vancouver Canucks,2,Pacific,Western,18,2,26,0.6923076923076923,18,0,15,3
2014-15,2014-11-07,Vancouver Canucks,2,Pacific,Western,20,2,28,0.7142857142857143,18,2,16,4
2014-15,2014-11-09,Vancouver Canucks,0,Pacific,Western,20,2,30,0.6666666666666666,20,0,18,2
2014-15,2014-11-10,Vancouver Canucks,2,Pacific,Western,22,2,32,0.6875,20,2,18,4
2014-15,2014-11-12,Vancouver Canucks,2,Pacific,Western,24,2,34,0.7058823529411765,20,4,18,6
2014-15,2014-11-15,Vancouver Canucks,0,Pacific,Western,24,2,36,0.6666666666666666,22,2,20,4
2014-15,2014-11-20,Vancouver Canucks,2,Pacific,Western,26,2,38,0.6842105263157895,26,0,22,4
2014-15,2014-11-21,Vancouver Canucks,1,Pacific,Western,27,2,40,0.675,26,1,23,4
2014-15,2014-11-24,Vancouver Canucks,2,Pacific,Western,29,2,42,0.6904761904761905,28,1,24,5
2014-15,2014-11-26,Vancouver Canucks,2,Pacific,Western,31,2,44,0.7045454545454546,28,3,25,6
2014-15,2014-11-29,Vancouver Canucks,2,Pacific,Western,33,2,46,0.717391304347826,30,3,28,5
2014-15,2014-11-30,Vancouver Canucks,0,Pacific,Western,33,2,48,0.6875,32,1,28,5
2014-15,2014-12-03,Vancouver Canucks,2,Pacific,Western,35,2,50,0.7,34,1,28,7
2014-15,2014-12-05,Vancouver Canucks,2,Pacific,Western,37,2,52,0.7115384615384616,36,1,30,7
2014-15,2014-12-07,Vancouver Canucks,0,Pacific,Western,37,2,54,0.6851851851851852,36,1,33,4
2014-15,2014-12-08,Vancouver Canucks,1,Pacific,Western,38,2,56,0.6785714285714286,36,2,33,5
2014-15,2014-12-10,Vancouver Canucks,0,Pacific,Western,38,2,58,0.6551724137931034,36,2,34,4
2014-15,2014-12-14,Vancouver Canucks,0,Pacific,Western,38,2,60,0.6333333333333333,38,0,36,2
2014-15,2014-12-18,Vancouver Canucks,0,Pacific,Western,38,2,62,0.6129032258064516,38,0,36,2
2014-15,2014-12-21,Vancouver Canucks,2,Pacific,Western,40,2,64,0.625,40,0,40,0
2014-15,2014-12-23,Vancouver Canucks,2,Pacific,Western,42,2,66,0.6363636363636364,42,0,41,1
2014-15,2014-12-29,Vancouver Canucks,1,Pacific,Western,43,2,68,0.6323529411764706,43,0,43,0
2014-15,2014-12-31,Vancouver Canucks,2,Pacific,Western,45,2,70,0.6428571428571429,44,1,43,2
2014-15,2015-01-02,Vancouver Canucks,0,Pacific,Western,45,2,72,0.625,45,0,45,0
2014-15,2015-01-04,Vancouver Canucks,2,Pacific,Western,47,2,74,0.6351351351351351,47,0,45,2
2014-15,2015-01-07,Vancouver Canucks,2,Pacific,Western,49,2,76,0.6447368421052632,49,0,47,2
2014-15,2015-01-09,Vancouver Canucks,0,Pacific,Western,49,2,78,0.6282051282051282,49,0,47,2
2014-15,2015-01-11,Vancouver Canucks,0,Pacific,Western,49,2,80,0.6125,49,0,48,1
2014-15,2015-01-14,Vancouver Canucks,0,Pacific,Western,49,2,82,0.5975609756097561,50,-1,49,0
2014-15,2015-01-16,Vancouver Canucks,2,Pacific,Western,51,2,84,0.6071428571428571,51,0,50,1
2014-15,2015-01-17,Vancouver Canucks,2,Pacific,Western,53,2,86,0.6162790697674418,53,0,50,3
2014-15,2015-01-20,Vancouver Canucks,2,Pacific,Western,55,2,88,0.625,54,1,53,2
2014-15,2015-01-21,Vancouver Canucks,0,Pacific,Western,55,2,90,0.6111111111111112,54,1,53,2
2014-15,2015-01-28,Vancouver Canucks,0,Pacific,Western,55,2,92,0.5978260869565217,55,0,55,0
2014-15,2015-01-31,Vancouver Canucks,2,Pacific,Western,57,2,94,0.6063829787234043,57,0,55,2
2014-15,2015-02-01,Vancouver Canucks,0,Pacific,Western,57,2,96,0.59375,57,0,57,0
2014-15,2015-02-04,Vancouver Canucks,2,Pacific,Western,59,2,98,0.6020408163265306,59,0,59,0
2014-15,2015-02-06,Vancouver Canucks,0,Pacific,Western,59,2,100,0.59,61,-2,59,0
2014-15,2015-02-08,Vancouver Canucks,2,Pacific,Western,61,2,102,0.5980392156862745,61,0,61,0
2014-15,2015-02-10,Vancouver Canucks,0,Pacific,Western,61,2,104,0.5865384615384616,63,-2,61,0
2014-15,2015-02-12,Vancouver Canucks,2,Pacific,Western,63,2,106,0.5943396226415094,63,0,63,0
2014-15,2015-02-14,Vancouver Canucks,2,Pacific,Western,65,2,108,0.6018518518518519,65,0,63,2
2014-15,2015-02-15,Vancouver Canucks,0,Pacific,Western,65,2,110,0.5909090909090909,65,0,65,0
2014-15,2015-02-17,Vancouver Canucks,2,Pacific,Western,67,2,112,0.5982142857142857,67,0,66,1
2014-15,2015-02-20,Vancouver Canucks,2,Pacific,Western,69,2,114,0.6052631578947368,68,1,68,1
2014-15,2015-02-21,Vancouver Canucks,0,Pacific,Western,69,2,116,0.5948275862068966,68,1,68,1
2014-15,2015-02-22,Vancouver Canucks,2,Pacific,Western,71,2,118,0.6016949152542372,68,3,68,3
2014-15,2015-02-25,Vancouver Canucks,2,Pacific,Western,73,2,120,0.6083333333333333,70,3,69,4
2014-15,2015-02-27,Vancouver Canucks,0,Pacific,Western,73,2,122,0.5983606557377049,70,3,70,3
2014-15,2015-03-02,Vancouver Canucks,2,Pacific,Western,75,2,124,0.6048387096774194,70,5,70,5
2014-15,2015-03-04,Vancouver Canucks,0,Pacific,Western,75,2,126,0.5952380952380952,72,3,72,3
2014-15,2015-03-06,Vancouver Canucks,1,Pacific,Western,76,2,128,0.59375,74,2,74,2
2014-15,2015-03-08,Vancouver Canucks,2,Pacific,Western,78,2,130,0.6,77,1,77,1
2014-15,2015-03-10,Vancouver Canucks,2,Pacific,Western,80,2,132,0.6060606060606061,77,3,77,3
2014-15,2015-03-13,Vancouver Canucks,0,Pacific,Western,80,2,134,0.5970149253731343,79,1,79,1
2014-15,2015-03-14,Vancouver Canucks,2,Pacific,Western,82,2,136,0.6029411764705882,81,1,80,2
2014-15,2015-03-18,Vancouver Canucks,2,Pacific,Western,84,2,138,0.6086956521739131,81,3,81,3
2014-15,2015-03-20,Vancouver Canucks,0,Pacific,Western,84,2,140,0.6,83,1,83,1
2014-15,2015-03-21,Vancouver Canucks,2,Pacific,Western,86,2,142,0.6056338028169014,84,2,84,2
2014-15,2015-03-23,Vancouver Canucks,2,Pacific,Western,88,2,144,0.6111111111111112,84,4,84,4
2014-15,2015-03-25,Vancouver Canucks,2,Pacific,Western,90,2,146,0.6164383561643836,86,4,86,4
2014-15,2015-03-27,Vancouver Canucks,0,Pacific,Western,90,2,148,0.6081081081081081,88,2,88,2
2014-15,2015-03-29,Vancouver Canucks,1,Pacific,Western,91,2,150,0.6066666666666667,89,2,89,2
2014-15,2015-03-31,Vancouver Canucks,2,Pacific,Western,93,2,152,0.6118421052631579,91,2,90,3
2014-15,2015-04-01,Vancouver Canucks,2,Pacific,Western,95,2,154,0.6168831168831169,91,4,90,5
2014-15,2015-04-03,Vancouver Canucks,0,Pacific,Western,95,2,156,0.6089743589743589,91,4,90,5
2014-15,2015-04-04,Vancouver Canucks,0,Pacific,Western,95,2,158,0.6012658227848101,91,4,91,4
2014-15,2015-04-07,Vancouver Canucks,2,Pacific,Western,97,2,160,0.60625,93,4,93,4
2014-15,2015-04-10,Vancouver Canucks,2,Pacific,Western,99,2,162,0.6111111111111112,97,2,97,2
2014-15,2015-04-12,Vancouver Canucks,2,Pacific,Western,101,2,164,0.6158536585365854,97,4,97,4
2014-15,2014-10-09,Washington Capitals,1,Metropolitan,Eastern,1,2,2,0.5,2,-1,1,0
2014-15,2014-10-11,Washington Capitals,2,Metropolitan,Eastern,3,2,4,0.75,4,-1,2,1
2014-15,2014-10-14,Washington Capitals,1,Metropolitan,Eastern,4,2,6,0.6666666666666666,4,0,4,0
2014-15,2014-10-16,Washington Capitals,2,Metropolitan,Eastern,6,2,8,0.75,6,0,4,2
2014-15,2014-10-18,Washington Capitals,2,Metropolitan,Eastern,8,2,10,0.8,6,2,6,2
2014-15,2014-10-23,Washington Capitals,0,Metropolitan,Eastern,8,2,12,0.6666666666666666,8,0,8,0
2014-15,2014-10-26,Washington Capitals,2,Metropolitan,Eastern,10,2,14,0.7142857142857143,10,0,9,1
2014-15,2014-10-27,Washington Capitals,0,Metropolitan,Eastern,10,2,16,0.625,10,0,10,0
2014-15,2014-10-29,Washington Capitals,0,Metropolitan,Eastern,10,2,18,0.5555555555555556,10,0,10,0
2014-15,2014-11-01,Washington Capitals,0,Metropolitan,Eastern,10,2,20,0.5,12,-2,12,-2
2014-15,2014-11-03,Washington Capitals,0,Metropolitan,Eastern,10,2,22,0.45454545454545453,12,-2,12,-2
2014-15,2014-11-05,Washington Capitals,1,Metropolitan,Eastern,11,2,24,0.4583333333333333,12,-1,13,-2
2014-15,2014-11-08,Washington Capitals,2,Metropolitan,Eastern,13,2,26,0.5,14,-1,14,-1
2014-15,2014-11-09,Washington Capitals,2,Metropolitan,Eastern,15,2,28,0.5357142857142857,16,-1,16,-1
2014-15,2014-11-12,Washington Capitals,2,Metropolitan,Eastern,17,2,30,0.5666666666666667,17,0,18,-1
2014-15,2014-11-15,Washington Capitals,0,Metropolitan,Eastern,17,2,32,0.53125,18,-1,20,-3
2014-15,2014-11-16,Washington Capitals,0,Metropolitan,Eastern,17,2,34,0.5,18,-1,20,-3
2014-15,2014-11-19,Washington Capitals,2,Metropolitan,Eastern,19,2,36,0.5277777777777778,19,0,20,-1
2014-15,2014-11-21,Washington Capitals,2,Metropolitan,Eastern,21,2,38,0.5526315789473685,21,0,22,-1
2014-15,2014-11-23,Washington Capitals,0,Metropolitan,Eastern,21,2,40,0.525,21,0,22,-1
2014-15,2014-11-27,Washington Capitals,1,Metropolitan,Eastern,22,2,42,0.5238095238095238,22,0,24,-2
2014-15,2014-11-28,Washington Capitals,2,Metropolitan,Eastern,24,2,44,0.5454545454545454,24,0,24,0
2014-15,2014-11-30,Washington Capitals,0,Metropolitan,Eastern,24,2,46,0.5217391304347826,26,-2,26,-2
2014-15,2014-12-03,Washington Capitals,0,Metropolitan,Eastern,24,2,48,0.5,26,-2,26,-2
2014-15,2014-12-05,Washington Capitals,2,Metropolitan,Eastern,26,2,50,0.52,26,0,27,-1
2014-15,2014-12-07,Washington Capitals,2,Metropolitan,Eastern,28,2,52,0.5384615384615384,28,0,29,-1
2014-15,2014-12-10,Washington Capitals,2,Metropolitan,Eastern,30,2,54,0.5555555555555556,30,0,30,0
2014-15,2014-12-12,Washington Capitals,1,Metropolitan,Eastern,31,2,56,0.5535714285714286,31,0,31,0
2014-15,2014-12-14,Washington Capitals,2,Metropolitan,Eastern,33,2,58,0.5689655172413793,33,0,32,1
2014-15,2014-12-17,Washington Capitals,1,Metropolitan,Eastern,34,2,60,0.5666666666666667,34,0,34,0
2014-15,2014-12-19,Washington Capitals,2,Metropolitan,Eastern,36,2,62,0.5806451612903226,36,0,36,0
2014-15,2014-12-21,Washington Capitals,2,Metropolitan,Eastern,38,2,64,0.59375,38,0,36,2
2014-15,2014-12-23,Washington Capitals,2,Metropolitan,Eastern,40,2,66,0.6060606060606061,40,0,38,2
2014-15,2014-12-24,Washington Capitals,0,Metropolitan,Eastern,40,2,68,0.5882352941176471,40,0,40,0
2014-15,2014-12-28,Washington Capitals,2,Metropolitan,Eastern,42,2,70,0.6,42,0,42,0
2014-15,2014-12-30,Washington Capitals,1,Metropolitan,Eastern,43,2,72,0.5972222222222222,43,0,42,1
2014-15,2015-01-01,Washington Capitals,2,Metropolitan,Eastern,45,2,74,0.6081081081081081,45,0,44,1
2014-15,2015-01-04,Washington Capitals,2,Metropolitan,Eastern,47,2,76,0.618421052631579,47,0,45,2
2014-15,2015-01-08,Washington Capitals,2,Metropolitan,Eastern,49,2,78,0.6282051282051282,49,0,46,3
2014-15,2015-01-09,Washington Capitals,1,Metropolitan,Eastern,50,2,80,0.625,50,0,48,2
2014-15,2015-01-11,Washington Capitals,2,Metropolitan,Eastern,52,2,82,0.6341463414634146,52,0,50,2
2014-15,2015-01-13,Washington Capitals,2,Metropolitan,Eastern,54,2,84,0.6428571428571429,54,0,50,4
2014-15,2015-01-15,Washington Capitals,2,Metropolitan,Eastern,56,2,86,0.6511627906976745,56,0,52,4
2014-15,2015-01-17,Washington Capitals,0,Metropolitan,Eastern,56,2,88,0.6363636363636364,56,0,54,2
2014-15,2015-01-18,Washington Capitals,0,Metropolitan,Eastern,56,2,90,0.6222222222222222,56,0,54,2
2014-15,2015-01-21,Washington Capitals,1,Metropolitan,Eastern,57,2,92,0.6195652173913043,58,-1,56,1
2014-15,2015-01-28,Washington Capitals,0,Metropolitan,Eastern,57,2,94,0.6063829787234043,58,-1,57,0
2014-15,2015-01-29,Washington Capitals,2,Metropolitan,Eastern,59,2,96,0.6145833333333334,59,0,57,2
2014-15,2015-01-31,Washington Capitals,1,Metropolitan,Eastern,60,2,98,0.6122448979591837,60,0,58,2
2014-15,2015-02-01,Washington Capitals,0,Metropolitan,Eastern,60,2,100,0.6,60,0,60,0
2014-15,2015-02-04,Washington Capitals,2,Metropolitan,Eastern,62,2,102,0.6078431372549019,62,0,61,1
2014-15,2015-02-06,Washington Capitals,2,Metropolitan,Eastern,64,2,104,0.6153846153846154,64,0,61,3
2014-15,2015-02-07,Washington Capitals,2,Metropolitan,Eastern,66,2,106,0.6226415094339622,66,0,61,5
2014-15,2015-02-08,Washington Capitals,0,Metropolitan,Eastern,66,2,108,0.6111111111111112,66,0,63,3
2014-15,2015-02-12,Washington Capitals,2,Metropolitan,Eastern,68,2,110,0.6181818181818182,68,0,63,5
2014-15,2015-02-15,Washington Capitals,0,Metropolitan,Eastern,68,2,112,0.6071428571428571,71,-3,63,5
2014-15,2015-02-16,Washington Capitals,2,Metropolitan,Eastern,70,2,114,0.6140350877192983,71,-1,63,7
2014-15,2015-02-18,Washington Capitals,2,Metropolitan,Eastern,72,2,116,0.6206896551724138,73,-1,64,8
2014-15,2015-02-20,Washington Capitals,2,Metropolitan,Eastern,74,2,118,0.6271186440677966,74,0,65,9
2014-15,2015-02-21,Washington Capitals,2,Metropolitan,Eastern,76,2,120,0.6333333333333333,76,0,65,11
2014-15,2015-02-22,Washington Capitals,0,Metropolitan,Eastern,76,2,122,0.6229508196721312,76,0,67,9
2014-15,2015-02-26,Washington Capitals,0,Metropolitan,Eastern,76,2,124,0.6129032258064516,79,-3,67,9
2014-15,2015-02-28,Washington Capitals,0,Metropolitan,Eastern,76,2,126,0.6031746031746031,79,-3,69,7
2014-15,2015-03-02,Washington Capitals,2,Metropolitan,Eastern,78,2,128,0.609375,81,-3,71,7
2014-15,2015-03-04,Washington Capitals,2,Metropolitan,Eastern,80,2,130,0.6153846153846154,81,-1,69,11
2014-15,2015-03-06,Washington Capitals,0,Metropolitan,Eastern,80,2,132,0.6060606060606061,81,-1,72,8
2014-15,2015-03-08,Washington Capitals,2,Metropolitan,Eastern,82,2,134,0.6119402985074627,85,-3,76,6
2014-15,2015-03-12,Washington Capitals,0,Metropolitan,Eastern,82,2,136,0.6029411764705882,88,-6,80,2
2014-15,2015-03-13,Washington Capitals,0,Metropolitan,Eastern,82,2,138,0.5942028985507246,88,-6,80,2
2014-15,2015-03-15,Washington Capitals,2,Metropolitan,Eastern,84,2,140,0.6,88,-4,82,2
2014-15,2015-03-16,Washington Capitals,2,Metropolitan,Eastern,86,2,142,0.6056338028169014,88,-2,82,4
2014-15,2015-03-20,Washington Capitals,2,Metropolitan,Eastern,88,2,144,0.6111111111111112,88,0,83,5
2014-15,2015-03-21,Washington Capitals,0,Metropolitan,Eastern,88,2,146,0.6027397260273972,88,0,84,4
2014-15,2015-03-26,Washington Capitals,2,Metropolitan,Eastern,90,2,148,0.6081081081081081,91,-1,85,5
2014-15,2015-03-28,Washington Capitals,0,Metropolitan,Eastern,90,2,150,0.6,93,-3,87,3
2014-15,2015-03-29,Washington Capitals,2,Metropolitan,Eastern,92,2,152,0.6052631578947368,95,-3,89,3
2014-15,2015-03-31,Washington Capitals,2,Metropolitan,Eastern,94,2,154,0.6103896103896104,95,-1,91,3
2014-15,2015-04-02,Washington Capitals,2,Metropolitan,Eastern,96,2,156,0.6153846153846154,96,0,93,3
2014-15,2015-04-04,Washington Capitals,1,Metropolitan,Eastern,97,2,158,0.6139240506329114,97,0,95,2
2014-15,2015-04-05,Washington Capitals,2,Metropolitan,Eastern,99,2,160,0.61875,98,1,95,4
2014-15,2015-04-09,Washington Capitals,2,Metropolitan,Eastern,101,2,162,0.6234567901234568,98,3,96,5
2014-15,2015-04-11,Washington Capitals,0,Metropolitan,Eastern,101,2,164,0.6158536585365854,101,0,98,3
2014-15,2014-10-10,Winnipeg Jets,2,Central,Western,2,2,2,1.0,2,0,1,1
2014-15,2014-10-12,Winnipeg Jets,0,Central,Western,2,2,4,0.5,4,-2,2,0
2014-15,2014-10-13,Winnipeg Jets,0,Central,Western,2,2,6,0.3333333333333333,4,-2,2,0
2014-15,2014-10-18,Winnipeg Jets,0,Central,Western,2,2,8,0.25,5,-3,5,-3
2014-15,2014-10-19,Winnipeg Jets,0,Central,Western,2,2,10,0.2,6,-4,6,-4
2014-15,2014-10-22,Winnipeg Jets,2,Central,Western,4,2,12,0.3333333333333333,8,-4,6,-2
2014-15,2014-10-25,Winnipeg Jets,0,Central,Western,4,2,14,0.2857142857142857,9,-5,8,-4
2014-15,2014-10-26,Winnipeg Jets,2,Central,Western,6,2,16,0.375,9,-3,8,-2
2014-15,2014-10-28,Winnipeg Jets,2,Central,Western,8,2,18,0.4444444444444444,10,-2,10,-2
2014-15,2014-10-30,Winnipeg Jets,1,Central,Western,9,2,20,0.45,11,-2,11,-2
2014-15,2014-11-01,Winnipeg Jets,2,Central,Western,11,2,22,0.5,12,-1,12,-1
2014-15,2014-11-03,Winnipeg Jets,2,Central,Western,13,2,24,0.5416666666666666,13,0,13,0
2014-15,2014-11-05,Winnipeg Jets,2,Central,Western,15,2,26,0.5769230769230769,15,0,15,0
2014-15,2014-11-07,Winnipeg Jets,1,Central,Western,16,2,28,0.5714285714285714,16,0,16,0
2014-15,2014-11-09,Winnipeg Jets,2,Central,Western,18,2,30,0.6,18,0,18,0
2014-15,2014-11-12,Winnipeg Jets,0,Central,Western,18,2,32,0.5625,19,-1,18,0
2014-15,2014-11-14,Winnipeg Jets,2,Central,Western,20,2,34,0.5882352941176471,20,0,20,0
2014-15,2014-11-16,Winnipeg Jets,1,Central,Western,21,2,36,0.5833333333333334,21,0,21,0
2014-15,2014-11-16,Winnipeg Jets,0,Central,Western,21,2,38,0.5526315789473685,21,0,21,0
2014-15,2014-11-19,Winnipeg Jets,2,Central,Western,23,2,40,0.575,23,0,22,1
2014-15,2014-11-21,Winnipeg Jets,0,Central,Western,23,2,42,0.5476190476190477,23,0,23,0
2014-15,2014-11-23,Winnipeg Jets,0,Central,Western,23,2,44,0.5227272727272727,25,-2,24,-1
2014-15,2014-11-26,Winnipeg Jets,2,Central,Western,25,2,46,0.5434782608695652,25,0,25,0
2014-15,2014-11-27,Winnipeg Jets,2,Central,Western,27,2,48,0.5625,27,0,27,0
2014-15,2014-11-29,Winnipeg Jets,1,Central,Western,28,2,50,0.56,29,-1,28,0
2014-15,2014-12-04,Winnipeg Jets,2,Central,Western,30,2,52,0.5769230769230769,33,-3,30,0
2014-15,2014-12-06,Winnipeg Jets,2,Central,Western,32,2,54,0.5925925925925926,35,-3,32,0
2014-15,2014-12-07,Winnipeg Jets,1,Central,Western,33,2,56,0.5892857142857143,36,-3,33,0
2014-15,2014-12-10,Winnipeg Jets,2,Central,Western,35,2,58,0.603448275862069,38,-3,34,1
2014-15,2014-12-12,Winnipeg Jets,1,Central,Western,36,2,60,0.6,40,-4,36,0
2014-15,2014-12-14,Winnipeg Jets,0,Central,Western,36,2,62,0.5806451612903226,40,-4,36,0
2014-15,2014-12-17,Winnipeg Jets,2,Central,Western,38,2,64,0.59375,42,-4,36,2
2014-15,2014-12-20,Winnipeg Jets,2,Central,Western,40,2,66,0.6060606060606061,42,-2,38,2
2014-15,2014-12-22,Winnipeg Jets,1,Central,Western,41,2,68,0.6029411764705882,44,-3,40,1
2014-15,2014-12-24,Winnipeg Jets,2,Central,Western,43,2,70,0.6142857142857143,45,-2,41,2
2014-15,2014-12-28,Winnipeg Jets,2,Central,Western,45,2,72,0.625,45,0,42,3
2014-15,2014-12-30,Winnipeg Jets,0,Central,Western,45,2,74,0.6081081081081081,47,-2,43,2
2014-15,2014-12-31,Winnipeg Jets,0,Central,Western,45,2,76,0.5921052631578947,47,-2,43,2
2014-15,2015-01-04,Winnipeg Jets,2,Central,Western,47,2,78,0.6025641025641025,49,-2,45,2
2014-15,2015-01-06,Winnipeg Jets,0,Central,Western,47,2,80,0.5875,49,-2,47,0
2014-15,2015-01-09,Winnipeg Jets,0,Central,Western,47,2,82,0.573170731707317,53,-6,47,0
2014-15,2015-01-11,Winnipeg Jets,2,Central,Western,49,2,84,0.5833333333333334,55,-6,48,1
2014-15,2015-01-12,Winnipeg Jets,1,Central,Western,50,2,86,0.5813953488372093,55,-5,48,2
2014-15,2015-01-14,Winnipeg Jets,2,Central,Western,52,2,88,0.5909090909090909,57,-5,49,3
2014-15,2015-01-16,Winnipeg Jets,2,Central,Western,54,2,90,0.6,58,-4,50,4
2014-15,2015-01-17,Winnipeg Jets,2,Central,Western,56,2,92,0.6086956521739131,58,-2,50,6
2014-15,2015-01-19,Winnipeg Jets,2,Central,Western,58,2,94,0.6170212765957447,58,0,51,7
2014-15,2015-01-22,Winnipeg Jets,2,Central,Western,60,2,96,0.625,62,-2,53,7
2014-15,2015-01-28,Winnipeg Jets,0,Central,Western,60,2,98,0.6122448979591837,62,-2,55,5
2014-15,2015-01-30,Winnipeg Jets,0,Central,Western,60,2,100,0.6,62,-2,55,5
2014-15,2015-02-01,Winnipeg Jets,0,Central,Western,60,2,102,0.5882352941176471,64,-4,57,3
2014-15,2015-02-03,Winnipeg Jets,0,Central,Western,60,2,104,0.5769230769230769,64,-4,57,3
2014-15,2015-02-04,Winnipeg Jets,1,Central,Western,61,2,106,0.5754716981132075,64,-3,59,2
2014-15,2015-02-07,Winnipeg Jets,1,Central,Western,62,2,108,0.5740740740740741,66,-4,59,3
2014-15,2015-02-08,Winnipeg Jets,2,Central,Western,64,2,110,0.5818181818181818,68,-4,61,3
2014-15,2015-02-11,Winnipeg Jets,2,Central,Western,66,2,112,0.5892857142857143,69,-3,61,5
2014-15,2015-02-13,Winnipeg Jets,0,Central,Western,66,2,114,0.5789473684210527,70,-4,63,3
2014-15,2015-02-15,Winnipeg Jets,2,Central,Western,68,2,116,0.5862068965517241,74,-6,65,3
2014-15,2015-02-17,Winnipeg Jets,2,Central,Western,70,2,118,0.5932203389830508,74,-4,66,4
2014-15,2015-02-20,Winnipeg Jets,0,Central,Western,70,2,120,0.5833333333333334,75,-5,68,2
2014-15,2015-02-22,Winnipeg Jets,1,Central,Western,71,2,122,0.5819672131147541,75,-4,68,3
2014-15,2015-02-25,Winnipeg Jets,2,Central,Western,73,2,124,0.5887096774193549,77,-4,69,4
2014-15,2015-02-27,Winnipeg Jets,1,Central,Western,74,2,126,0.5873015873015873,79,-5,70,4
2014-15,2015-03-01,Winnipeg Jets,2,Central,Western,76,2,128,0.59375,79,-3,70,6
2014-15,2015-03-05,Winnipeg Jets,0,Central,Western,76,2,130,0.5846153846153846,81,-5,72,4
2014-15,2015-03-08,Winnipeg Jets,2,Central,Western,78,2,132,0.5909090909090909,84,-6,77,1
2014-15,2015-03-11,Winnipeg Jets,0,Central,Western,78,2,134,0.582089552238806,84,-6,77,1
2014-15,2015-03-12,Winnipeg Jets,0,Central,Western,78,2,136,0.5735294117647058,84,-6,78,0
2014-15,2015-03-14,Winnipeg Jets,2,Central,Western,80,2,138,0.5797101449275363,88,-8,80,0
2014-15,2015-03-18,Winnipeg Jets,2,Central,Western,82,2,140,0.5857142857142857,90,-8,81,1
2014-15,2015-03-20,Winnipeg Jets,2,Central,Western,84,2,142,0.5915492957746479,92,-8,83,1
2014-15,2015-03-21,Winnipeg Jets,2,Central,Western,86,2,144,0.5972222222222222,92,-6,84,2
2014-15,2015-03-24,Winnipeg Jets,2,Central,Western,88,2,146,0.6027397260273972,94,-6,86,2
2014-15,2015-03-25,Winnipeg Jets,0,Central,Western,88,2,148,0.5945945945945946,94,-6,86,2
2014-15,2015-03-27,Winnipeg Jets,2,Central,Western,90,2,150,0.6,94,-4,88,2
2014-15,2015-03-29,Winnipeg Jets,0,Central,Western,90,2,152,0.5921052631578947,96,-6,89,1
2014-15,2015-04-01,Winnipeg Jets,0,Central,Western,90,2,154,0.5844155844155844,98,-8,90,0
2014-15,2015-04-04,Winnipeg Jets,2,Central,Western,92,2,156,0.5897435897435898,100,-8,91,1
2014-15,2015-04-07,Winnipeg Jets,2,Central,Western,94,2,158,0.5949367088607594,102,-8,93,1
2014-15,2015-04-08,Winnipeg Jets,2,Central,Western,96,2,160,0.6,102,-6,95,1
2014-15,2015-04-10,Winnipeg Jets,1,Central,Western,97,2,162,0.5987654320987654,102,-5,97,0
2014-15,2015-04-11,Winnipeg Jets,2,Central,Western,99,2,164,0.6036585365853658,102,-3,97,2
2015-16,2015-10-11,Anaheim Ducks,0,Pacific,Western,0,2,2,0.0,3,-3,2,-2
2015-16,2015-10-13,Anaheim Ducks,1,Pacific,Western,1,2,4,0.25,4,-3,2,-1
2015-16,2015-10-15,Anaheim Ducks,0,Pacific,Western,1,2,6,0.16666666666666666,6,-5,4,-3
2015-16,2015-10-17,Anaheim Ducks,0,Pacific,Western,1,2,8,0.125,6,-5,6,-5
2015-16,2015-10-19,Anaheim Ducks,2,Pacific,Western,3,2,10,0.3,6,-3,6,-3
2015-16,2015-10-23,Anaheim Ducks,0,Pacific,Western,3,2,12,0.25,7,-4,8,-5
2015-16,2015-10-24,Anaheim Ducks,0,Pacific,Western,3,2,14,0.21428571428571427,8,-5,8,-5
2015-16,2015-10-27,Anaheim Ducks,1,Pacific,Western,4,2,16,0.25,10,-6,10,-6
2015-16,2015-10-28,Anaheim Ducks,0,Pacific,Western,4,2,18,0.2222222222222222,11,-7,11,-7
2015-16,2015-10-30,Anaheim Ducks,0,Pacific,Western,4,2,20,0.2,11,-7,12,-8
2015-16,2015-11-02,Anaheim Ducks,2,Pacific,Western,6,2,22,0.2727272727272727,12,-6,12,-6
2015-16,2015-11-05,Anaheim Ducks,2,Pacific,Western,8,2,24,0.3333333333333333,12,-4,15,-7
2015-16,2015-11-07,Anaheim Ducks,2,Pacific,Western,10,2,26,0.38461538461538464,14,-4,15,-5
2015-16,2015-11-08,Anaheim Ducks,2,Pacific,Western,12,2,28,0.42857142857142855,14,-2,15,-3
2015-16,2015-11-10,Anaheim Ducks,1,Pacific,Western,13,2,30,0.43333333333333335,15,-2,17,-4
2015-16,2015-11-12,Anaheim Ducks,1,Pacific,Western,14,2,32,0.4375,17,-3,17,-3
2015-16,2015-11-14,Anaheim Ducks,0,Pacific,Western,14,2,34,0.4117647058823529,19,-5,18,-4
2015-16,2015-11-17,Anaheim Ducks,2,Pacific,Western,16,2,36,0.4444444444444444,19,-3,19,-3
2015-16,2015-11-18,Anaheim Ducks,0,Pacific,Western,16,2,38,0.42105263157894735,20,-4,20,-4
2015-16,2015-11-20,Anaheim Ducks,2,Pacific,Western,18,2,40,0.45,21,-3,21,-3
2015-16,2015-11-22,Anaheim Ducks,0,Pacific,Western,18,2,42,0.42857142857142855,22,-4,22,-4
2015-16,2015-11-25,Anaheim Ducks,2,Pacific,Western,20,2,44,0.45454545454545453,22,-2,22,-2
2015-16,2015-11-26,Anaheim Ducks,0,Pacific,Western,20,2,46,0.43478260869565216,24,-4,24,-4
2015-16,2015-11-27,Anaheim Ducks,1,Pacific,Western,21,2,48,0.4375,24,-3,24,-3
2015-16,2015-12-01,Anaheim Ducks,2,Pacific,Western,23,2,50,0.46,27,-4,26,-3
2015-16,2015-12-03,Anaheim Ducks,0,Pacific,Western,23,2,52,0.4423076923076923,27,-4,27,-4
2015-16,2015-12-05,Anaheim Ducks,2,Pacific,Western,25,2,54,0.46296296296296297,27,-2,28,-3
2015-16,2015-12-07,Anaheim Ducks,2,Pacific,Western,27,2,56,0.48214285714285715,27,0,28,-1
2015-16,2015-12-12,Anaheim Ducks,0,Pacific,Western,27,2,58,0.46551724137931033,29,-2,30,-3
2015-16,2015-12-18,Anaheim Ducks,0,Pacific,Western,27,2,60,0.45,32,-5,33,-6
2015-16,2015-12-20,Anaheim Ducks,2,Pacific,Western,29,2,62,0.46774193548387094,33,-4,33,-4
2015-16,2015-12-22,Anaheim Ducks,0,Pacific,Western,29,2,64,0.453125,33,-4,34,-5
2015-16,2015-12-23,Anaheim Ducks,1,Pacific,Western,30,2,66,0.45454545454545453,35,-5,35,-5
2015-16,2015-12-28,Anaheim Ducks,2,Pacific,Western,32,2,68,0.47058823529411764,37,-5,37,-5
2015-16,2015-12-30,Anaheim Ducks,2,Pacific,Western,34,2,70,0.4857142857142857,37,-3,37,-3
2015-16,2016-01-01,Anaheim Ducks,2,Pacific,Western,36,2,72,0.5,38,-2,39,-3
2015-16,2016-01-02,Anaheim Ducks,1,Pacific,Western,37,2,74,0.5,39,-2,39,-2
2015-16,2016-01-04,Anaheim Ducks,2,Pacific,Western,39,2,76,0.5131578947368421,39,0,39,0
2015-16,2016-01-07,Anaheim Ducks,0,Pacific,Western,39,2,78,0.5,41,-2,42,-3
2015-16,2016-01-09,Anaheim Ducks,2,Pacific,Western,41,2,80,0.5125,41,0,44,-3
2015-16,2016-01-11,Anaheim Ducks,0,Pacific,Western,41,2,82,0.5,42,-1,45,-4
2015-16,2016-01-14,Anaheim Ducks,2,Pacific,Western,43,2,84,0.5119047619047619,44,-1,45,-2
2015-16,2016-01-16,Anaheim Ducks,2,Pacific,Western,45,2,86,0.5232558139534884,46,-1,46,-1
2015-16,2016-01-18,Anaheim Ducks,0,Pacific,Western,45,2,88,0.5113636363636364,48,-3,48,-3
2015-16,2016-01-21,Anaheim Ducks,2,Pacific,Western,47,2,90,0.5222222222222223,49,-2,49,-2
2015-16,2016-01-24,Anaheim Ducks,2,Pacific,Western,49,2,92,0.532608695652174,51,-2,52,-3
2015-16,2016-01-27,Anaheim Ducks,2,Pacific,Western,51,2,94,0.5425531914893617,53,-2,54,-3
2015-16,2016-02-03,Anaheim Ducks,2,Pacific,Western,53,2,96,0.5520833333333334,53,0,55,-2
2015-16,2016-02-05,Anaheim Ducks,2,Pacific,Western,55,2,98,0.5612244897959183,55,0,55,0
2015-16,2016-02-06,Anaheim Ducks,2,Pacific,Western,57,2,100,0.57,57,0,56,1
2015-16,2016-02-09,Anaheim Ducks,0,Pacific,Western,57,2,102,0.5588235294117647,57,0,57,0
2015-16,2016-02-10,Anaheim Ducks,2,Pacific,Western,59,2,104,0.5673076923076923,59,0,58,1
2015-16,2016-02-12,Anaheim Ducks,1,Pacific,Western,60,2,106,0.5660377358490566,60,0,58,2
2015-16,2016-02-14,Anaheim Ducks,2,Pacific,Western,62,2,108,0.5740740740740741,62,0,61,1
2015-16,2016-02-15,Anaheim Ducks,2,Pacific,Western,64,2,110,0.5818181818181818,63,1,61,3
2015-16,2016-02-17,Anaheim Ducks,2,Pacific,Western,66,2,112,0.5892857142857143,65,1,62,4
2015-16,2016-02-19,Anaheim Ducks,2,Pacific,Western,68,2,114,0.5964912280701754,67,1,64,4
2015-16,2016-02-22,Anaheim Ducks,2,Pacific,Western,70,2,116,0.603448275862069,67,3,65,5
2015-16,2016-02-25,Anaheim Ducks,2,Pacific,Western,72,2,118,0.6101694915254238,70,2,68,4
2015-16,2016-02-27,Anaheim Ducks,2,Pacific,Western,74,2,120,0.6166666666666667,70,4,68,6
2015-16,2016-02-29,Anaheim Ducks,2,Pacific,Western,76,2,122,0.6229508196721312,72,4,68,8
2015-16,2016-03-03,Anaheim Ducks,2,Pacific,Western,78,2,124,0.6290322580645161,74,4,68,10
2015-16,2016-03-04,Anaheim Ducks,2,Pacific,Western,80,2,126,0.6349206349206349,76,4,70,10
2015-16,2016-03-05,Anaheim Ducks,2,Pacific,Western,82,2,128,0.640625,76,6,72,10
2015-16,2016-03-08,Anaheim Ducks,1,Pacific,Western,83,2,130,0.6384615384615384,78,5,72,11
2015-16,2016-03-10,Anaheim Ducks,0,Pacific,Western,83,2,132,0.6287878787878788,80,3,74,9
2015-16,2016-03-12,Anaheim Ducks,0,Pacific,Western,83,2,134,0.6194029850746269,80,3,74,9
2015-16,2016-03-15,Anaheim Ducks,2,Pacific,Western,85,2,136,0.625,82,3,75,10
2015-16,2016-03-17,Anaheim Ducks,0,Pacific,Western,85,2,138,0.6159420289855072,84,1,76,9
2015-16,2016-03-19,Anaheim Ducks,2,Pacific,Western,87,2,140,0.6214285714285714,86,1,78,9
2015-16,2016-03-20,Anaheim Ducks,2,Pacific,Western,89,2,142,0.6267605633802817,86,3,78,11
2015-16,2016-03-22,Anaheim Ducks,0,Pacific,Western,89,2,144,0.6180555555555556,88,1,80,9
2015-16,2016-03-24,Anaheim Ducks,1,Pacific,Western,90,2,146,0.6164383561643836,88,2,81,9
2015-16,2016-03-26,Anaheim Ducks,2,Pacific,Western,92,2,148,0.6216216216216216,88,4,85,7
2015-16,2016-03-29,Anaheim Ducks,2,Pacific,Western,94,2,150,0.6266666666666667,90,4,85,9
2015-16,2016-03-31,Anaheim Ducks,2,Pacific,Western,96,2,152,0.631578947368421,92,4,87,9
2015-16,2016-04-02,Anaheim Ducks,0,Pacific,Western,96,2,154,0.6233766233766234,92,4,87,9
2015-16,2016-04-04,Anaheim Ducks,2,Pacific,Western,98,2,156,0.6282051282051282,94,4,87,11
2015-16,2016-04-06,Anaheim Ducks,1,Pacific,Western,99,2,158,0.6265822784810127,96,3,87,12
2015-16,2016-04-08,Anaheim Ducks,0,Pacific,Western,99,2,160,0.61875,96,3,87,12
2015-16,2016-04-09,Anaheim Ducks,2,Pacific,Western,101,2,162,0.6234567901234568,96,5,87,14
2015-16,2016-04-10,Anaheim Ducks,2,Pacific,Western,103,2,164,0.6280487804878049,98,5,87,16
2015-16,2015-10-10,Arizona Coyotes,2,Pacific,Western,2,2,2,1.0,2,0,2,0
2015-16,2015-10-11,Arizona Coyotes,2,Pacific,Western,4,2,4,1.0,3,1,2,2
2015-16,2015-10-15,Arizona Coyotes,2,Pacific,Western,6,2,6,1.0,6,0,4,2
2015-16,2015-10-16,Arizona Coyotes,0,Pacific,Western,6,2,8,0.75,6,0,6,0
2015-16,2015-10-18,Arizona Coyotes,0,Pacific,Western,6,2,10,0.6,6,0,6,0
2015-16,2015-10-20,Arizona Coyotes,1,Pacific,Western,7,2,12,0.5833333333333334,7,0,7,0
2015-16,2015-10-22,Arizona Coyotes,0,Pacific,Western,7,2,14,0.5,7,0,7,0
2015-16,2015-10-24,Arizona Coyotes,2,Pacific,Western,9,2,16,0.5625,8,1,8,1
2015-16,2015-10-26,Arizona Coyotes,2,Pacific,Western,11,2,18,0.6111111111111112,10,1,10,1
2015-16,2015-10-27,Arizona Coyotes,0,Pacific,Western,11,2,20,0.55,10,1,10,1
2015-16,2015-10-31,Arizona Coyotes,0,Pacific,Western,11,2,22,0.5,11,0,12,-1
2015-16,2015-11-06,Arizona Coyotes,2,Pacific,Western,13,2,24,0.5416666666666666,14,-1,15,-2
2015-16,2015-11-08,Arizona Coyotes,0,Pacific,Western,13,2,26,0.5,14,-1,15,-2
2015-16,2015-11-10,Arizona Coyotes,2,Pacific,Western,15,2,28,0.5357142857142857,15,0,17,-2
2015-16,2015-11-11,Arizona Coyotes,2,Pacific,Western,17,2,30,0.5666666666666667,17,0,17,0
2015-16,2015-11-13,Arizona Coyotes,2,Pacific,Western,19,2,32,0.59375,19,0,18,1
2015-16,2015-11-15,Arizona Coyotes,0,Pacific,Western,19,2,34,0.5588235294117647,19,0,19,0
2015-16,2015-11-17,Arizona Coyotes,0,Pacific,Western,19,2,36,0.5277777777777778,19,0,19,0
2015-16,2015-11-20,Arizona Coyotes,2,Pacific,Western,21,2,38,0.5526315789473685,21,0,21,0
2015-16,2015-11-22,Arizona Coyotes,0,Pacific,Western,21,2,40,0.525,22,-1,22,-1
2015-16,2015-11-26,Arizona Coyotes,2,Pacific,Western,23,2,42,0.5476190476190477,24,-1,24,-1
2015-16,2015-11-28,Arizona Coyotes,2,Pacific,Western,25,2,44,0.5681818181818182,25,0,25,0
2015-16,2015-11-29,Arizona Coyotes,2,Pacific,Western,27,2,46,0.5869565217391305,27,0,26,1
2015-16,2015-12-02,Arizona Coyotes,0,Pacific,Western,27,2,48,0.5625,27,0,27,0
2015-16,2015-12-04,Arizona Coyotes,0,Pacific,Western,27,2,50,0.54,27,0,27,0
2015-16,2015-12-05,Arizona Coyotes,0,Pacific,Western,27,2,52,0.5192307692307693,27,0,28,-1
2015-16,2015-12-06,Arizona Coyotes,0,Pacific,Western,27,2,54,0.5,27,0,28,-1
2015-16,2015-12-09,Arizona Coyotes,0,Pacific,Western,27,2,56,0.48214285714285715,28,-1,28,-1
2015-16,2015-12-12,Arizona Coyotes,2,Pacific,Western,29,2,58,0.5,29,0,30,-1
2015-16,2015-12-13,Arizona Coyotes,1,Pacific,Western,30,2,60,0.5,30,0,30,0
2015-16,2015-12-18,Arizona Coyotes,0,Pacific,Western,30,2,62,0.4838709677419355,32,-2,33,-3
2015-16,2015-12-20,Arizona Coyotes,2,Pacific,Western,32,2,64,0.5,33,-1,33,-1
2015-16,2015-12-23,Arizona Coyotes,2,Pacific,Western,34,2,66,0.5151515151515151,35,-1,35,-1
2015-16,2015-12-27,Arizona Coyotes,1,Pacific,Western,35,2,68,0.5147058823529411,36,-1,36,-1
2015-16,2015-12-28,Arizona Coyotes,2,Pacific,Western,37,2,70,0.5285714285714286,37,0,37,0
2015-16,2015-12-30,Arizona Coyotes,0,Pacific,Western,37,2,72,0.5138888888888888,37,0,37,0
2015-16,2016-01-01,Arizona Coyotes,2,Pacific,Western,39,2,74,0.527027027027027,38,1,39,0
2015-16,2016-01-02,Arizona Coyotes,1,Pacific,Western,40,2,76,0.5263157894736842,39,1,39,1
2015-16,2016-01-05,Arizona Coyotes,2,Pacific,Western,42,2,78,0.5384615384615384,39,3,41,1
2015-16,2016-01-08,Arizona Coyotes,2,Pacific,Western,44,2,80,0.55,41,3,43,1
2015-16,2016-01-10,Arizona Coyotes,2,Pacific,Western,46,2,82,0.5609756097560976,42,4,45,1
2015-16,2016-01-13,Arizona Coyotes,2,Pacific,Western,48,2,84,0.5714285714285714,44,4,45,3
2015-16,2016-01-15,Arizona Coyotes,1,Pacific,Western,49,2,86,0.5697674418604651,46,3,46,3
2015-16,2016-01-16,Arizona Coyotes,0,Pacific,Western,49,2,88,0.5568181818181818,46,3,46,3
2015-16,2016-01-19,Arizona Coyotes,0,Pacific,Western,49,2,90,0.5444444444444444,49,0,49,0
2015-16,2016-01-22,Arizona Coyotes,0,Pacific,Western,49,2,92,0.532608695652174,51,-2,51,-2
2015-16,2016-01-24,Arizona Coyotes,2,Pacific,Western,51,2,94,0.5425531914893617,51,0,52,-1
2015-16,2016-01-26,Arizona Coyotes,2,Pacific,Western,53,2,96,0.5520833333333334,53,0,53,0
2015-16,2016-01-27,Arizona Coyotes,0,Pacific,Western,53,2,98,0.5408163265306123,53,0,54,-1
2015-16,2016-02-03,Arizona Coyotes,0,Pacific,Western,53,2,100,0.53,53,0,55,-2
2015-16,2016-02-05,Arizona Coyotes,1,Pacific,Western,54,2,102,0.5294117647058824,55,-1,55,-1
2015-16,2016-02-06,Arizona Coyotes,0,Pacific,Western,54,2,104,0.5192307692307693,57,-3,56,-2
2015-16,2016-02-11,Arizona Coyotes,0,Pacific,Western,54,2,106,0.5094339622641509,59,-5,58,-4
2015-16,2016-02-13,Arizona Coyotes,2,Pacific,Western,56,2,108,0.5185185185185185,60,-4,59,-3
2015-16,2016-02-14,Arizona Coyotes,0,Pacific,Western,56,2,110,0.509090909090909,62,-6,61,-5
2015-16,2016-02-16,Arizona Coyotes,2,Pacific,Western,58,2,112,0.5178571428571429,63,-5,62,-4
2015-16,2016-02-19,Arizona Coyotes,2,Pacific,Western,60,2,114,0.5263157894736842,67,-7,64,-4
2015-16,2016-02-21,Arizona Coyotes,0,Pacific,Western,60,2,116,0.5172413793103449,67,-7,65,-5
2015-16,2016-02-23,Arizona Coyotes,0,Pacific,Western,60,2,118,0.5084745762711864,69,-9,66,-6
2015-16,2016-02-24,Arizona Coyotes,0,Pacific,Western,60,2,120,0.5,69,-9,66,-6
2015-16,2016-02-26,Arizona Coyotes,0,Pacific,Western,60,2,122,0.4918032786885246,70,-10,68,-8
2015-16,2016-02-27,Arizona Coyotes,0,Pacific,Western,60,2,124,0.4838709677419355,70,-10,68,-8
2015-16,2016-03-01,Arizona Coyotes,0,Pacific,Western,60,2,126,0.47619047619047616,74,-14,68,-8
2015-16,2016-03-04,Arizona Coyotes,0,Pacific,Western,60,2,128,0.46875,76,-16,70,-10
2015-16,2016-03-06,Arizona Coyotes,2,Pacific,Western,62,2,130,0.47692307692307695,76,-14,72,-10
2015-16,2016-03-08,Arizona Coyotes,0,Pacific,Western,62,2,132,0.4696969696969697,78,-16,72,-10
2015-16,2016-03-10,Arizona Coyotes,1,Pacific,Western,63,2,134,0.4701492537313433,80,-17,74,-11
2015-16,2016-03-12,Arizona Coyotes,2,Pacific,Western,65,2,136,0.47794117647058826,80,-15,74,-9
2015-16,2016-03-13,Arizona Coyotes,2,Pacific,Western,67,2,138,0.4855072463768116,82,-15,74,-7
2015-16,2016-03-18,Arizona Coyotes,2,Pacific,Western,69,2,140,0.4928571428571429,84,-15,76,-7
2015-16,2016-03-20,Arizona Coyotes,0,Pacific,Western,69,2,142,0.4859154929577465,86,-17,78,-9
2015-16,2016-03-21,Arizona Coyotes,0,Pacific,Western,69,2,144,0.4791666666666667,88,-19,80,-11
2015-16,2016-03-23,Arizona Coyotes,2,Pacific,Western,71,2,146,0.4863013698630137,88,-17,81,-10
2015-16,2016-03-25,Arizona Coyotes,2,Pacific,Western,73,2,148,0.49324324324324326,88,-15,83,-10
2015-16,2016-03-27,Arizona Coyotes,2,Pacific,Western,75,2,150,0.5,88,-13,85,-10
2015-16,2016-03-29,Arizona Coyotes,0,Pacific,Western,75,2,152,0.4934210526315789,90,-15,85,-10
2015-16,2016-04-01,Arizona Coyotes,0,Pacific,Western,75,2,154,0.487012987012987,92,-17,87,-12
2015-16,2016-04-03,Arizona Coyotes,2,Pacific,Western,77,2,156,0.4935897435897436,94,-17,87,-10
2015-16,2016-04-05,Arizona Coyotes,0,Pacific,Western,77,2,158,0.4873417721518987,94,-17,87,-10
2015-16,2016-04-06,Arizona Coyotes,0,Pacific,Western,77,2,160,0.48125,96,-19,87,-10
2015-16,2016-04-08,Arizona Coyotes,1,Pacific,Western,78,2,162,0.48148148148148145,96,-18,87,-9
2015-16,2016-04-10,Arizona Coyotes,0,Pacific,Western,78,2,164,0.47560975609756095,98,-20,87,-9
2015-16,2015-10-08,Boston Bruins,0,Atlantic,Eastern,0,2,2,0.0,2,-2,0,0
2015-16,2015-10-10,Boston Bruins,0,Atlantic,Eastern,0,2,4,0.0,4,-4,1,-1
2015-16,2015-10-12,Boston Bruins,0,Atlantic,Eastern,0,2,6,0.0,4,-4,2,-2
2015-16,2015-10-15,Boston Bruins,2,Atlantic,Eastern,2,2,8,0.25,6,-4,5,-3
2015-16,2015-10-18,Boston Bruins,2,Atlantic,Eastern,4,2,10,0.4,7,-3,6,-2
2015-16,2015-10-22,Boston Bruins,1,Atlantic,Eastern,5,2,12,0.4166666666666667,8,-3,7,-2
2015-16,2015-10-23,Boston Bruins,2,Atlantic,Eastern,7,2,14,0.5,8,-1,7,0
2015-16,2015-10-27,Boston Bruins,2,Atlantic,Eastern,9,2,16,0.5625,11,-2,9,0
2015-16,2015-10-30,Boston Bruins,2,Atlantic,Eastern,11,2,18,0.6111111111111112,12,-1,11,0
2015-16,2015-10-31,Boston Bruins,2,Atlantic,Eastern,13,2,20,0.65,12,1,12,1
2015-16,2015-11-04,Boston Bruins,0,Atlantic,Eastern,13,2,22,0.5909090909090909,14,-1,13,0
2015-16,2015-11-06,Boston Bruins,0,Atlantic,Eastern,13,2,24,0.5416666666666666,16,-3,13,0
2015-16,2015-11-08,Boston Bruins,2,Atlantic,Eastern,15,2,26,0.5769230769230769,16,-1,16,-1
2015-16,2015-11-08,Boston Bruins,0,Atlantic,Eastern,15,2,28,0.5357142857142857,16,-1,16,-1
2015-16,2015-11-13,Boston Bruins,0,Atlantic,Eastern,15,2,30,0.5,18,-3,18,-3
2015-16,2015-11-15,Boston Bruins,2,Atlantic,Eastern,17,2,32,0.53125,19,-2,19,-2
2015-16,2015-11-18,Boston Bruins,0,Atlantic,Eastern,17,2,34,0.5,19,-2,19,-2
2015-16,2015-11-20,Boston Bruins,2,Atlantic,Eastern,19,2,36,0.5277777777777778,21,-2,21,-2
2015-16,2015-11-22,Boston Bruins,2,Atlantic,Eastern,21,2,38,0.5526315789473685,24,-3,23,-2
2015-16,2015-11-24,Boston Bruins,2,Atlantic,Eastern,23,2,40,0.575,24,-1,23,0
2015-16,2015-11-26,Boston Bruins,2,Atlantic,Eastern,25,2,42,0.5952380952380952,25,0,25,0
2015-16,2015-11-27,Boston Bruins,2,Atlantic,Eastern,27,2,44,0.6136363636363636,27,0,25,2
2015-16,2015-12-03,Boston Bruins,1,Atlantic,Eastern,28,2,46,0.6086956521739131,29,-1,28,0
2015-16,2015-12-05,Boston Bruins,1,Atlantic,Eastern,29,2,48,0.6041666666666666,31,-2,30,-1
2015-16,2015-12-06,Boston Bruins,2,Atlantic,Eastern,31,2,50,0.62,33,-2,30,1
2015-16,2015-12-08,Boston Bruins,0,Atlantic,Eastern,31,2,52,0.5961538461538461,33,-2,31,0
2015-16,2015-12-10,Boston Bruins,2,Atlantic,Eastern,33,2,54,0.6111111111111112,35,-2,32,1
2015-16,2015-12-12,Boston Bruins,2,Atlantic,Eastern,35,2,56,0.625,35,0,34,1
2015-16,2015-12-15,Boston Bruins,1,Atlantic,Eastern,36,2,58,0.6206896551724138,37,-1,34,2
2015-16,2015-12-17,Boston Bruins,2,Atlantic,Eastern,38,2,60,0.6333333333333333,38,0,36,2
2015-16,2015-12-19,Boston Bruins,2,Atlantic,Eastern,40,2,62,0.6451612903225806,39,1,38,2
2015-16,2015-12-20,Boston Bruins,2,Atlantic,Eastern,42,2,64,0.65625,40,2,39,3
2015-16,2015-12-23,Boston Bruins,0,Atlantic,Eastern,42,2,66,0.6363636363636364,42,0,40,2
2015-16,2015-12-27,Boston Bruins,0,Atlantic,Eastern,42,2,68,0.6176470588235294,43,-1,42,0
2015-16,2015-12-27,Boston Bruins,0,Atlantic,Eastern,42,2,70,0.6,43,-1,42,0
2015-16,2015-12-30,Boston Bruins,2,Atlantic,Eastern,44,2,72,0.6111111111111112,44,0,42,2
2015-16,2016-01-01,Boston Bruins,0,Atlantic,Eastern,44,2,74,0.5945945945945946,44,0,43,1
2015-16,2016-01-06,Boston Bruins,0,Atlantic,Eastern,44,2,76,0.5789473684210527,47,-3,44,0
2015-16,2016-01-09,Boston Bruins,2,Atlantic,Eastern,46,2,78,0.5897435897435898,49,-3,45,1
2015-16,2016-01-10,Boston Bruins,1,Atlantic,Eastern,47,2,80,0.5875,49,-2,46,1
2015-16,2016-01-12,Boston Bruins,0,Atlantic,Eastern,47,2,82,0.573170731707317,49,-2,47,0
2015-16,2016-01-14,Boston Bruins,0,Atlantic,Eastern,47,2,84,0.5595238095238095,49,-2,47,0
2015-16,2016-01-16,Boston Bruins,2,Atlantic,Eastern,49,2,86,0.5697674418604651,50,-1,49,0
2015-16,2016-01-17,Boston Bruins,2,Atlantic,Eastern,51,2,88,0.5795454545454546,52,-1,50,1
2015-16,2016-01-20,Boston Bruins,2,Atlantic,Eastern,53,2,90,0.5888888888888889,54,-1,51,2
2015-16,2016-01-22,Boston Bruins,0,Atlantic,Eastern,53,2,92,0.5760869565217391,54,-1,53,0
2015-16,2016-01-24,Boston Bruins,2,Atlantic,Eastern,55,2,94,0.5851063829787234,56,-1,55,0
2015-16,2016-01-26,Boston Bruins,2,Atlantic,Eastern,57,2,96,0.59375,57,0,55,2
2015-16,2016-01-27,Boston Bruins,0,Atlantic,Eastern,57,2,98,0.5816326530612245,57,0,55,2
2015-16,2016-02-03,Boston Bruins,1,Atlantic,Eastern,58,2,100,0.58,58,0,57,1
2015-16,2016-02-05,Boston Bruins,2,Atlantic,Eastern,60,2,102,0.5882352941176471,60,0,58,2
2015-16,2016-02-07,Boston Bruins,2,Atlantic,Eastern,62,2,104,0.5961538461538461,62,0,59,3
2015-16,2016-02-10,Boston Bruins,0,Atlantic,Eastern,62,2,106,0.5849056603773585,62,0,61,1
2015-16,2016-02-12,Boston Bruins,2,Atlantic,Eastern,64,2,108,0.5925925925925926,64,0,61,3
2015-16,2016-02-13,Boston Bruins,2,Atlantic,Eastern,66,2,110,0.6,65,1,63,3
2015-16,2016-02-14,Boston Bruins,0,Atlantic,Eastern,66,2,112,0.5892857142857143,66,0,64,2
2015-16,2016-02-17,Boston Bruins,2,Atlantic,Eastern,68,2,114,0.5964912280701754,67,1,64,4
2015-16,2016-02-19,Boston Bruins,0,Atlantic,Eastern,68,2,116,0.5862068965517241,67,1,66,2
2015-16,2016-02-21,Boston Bruins,2,Atlantic,Eastern,70,2,118,0.5932203389830508,68,2,68,2
2015-16,2016-02-23,Boston Bruins,0,Atlantic,Eastern,70,2,120,0.5833333333333334,70,0,68,2
2015-16,2016-02-25,Boston Bruins,2,Atlantic,Eastern,72,2,122,0.5901639344262295,72,0,68,4
2015-16,2016-02-27,Boston Bruins,2,Atlantic,Eastern,74,2,124,0.5967741935483871,74,0,70,4
2015-16,2016-02-28,Boston Bruins,0,Atlantic,Eastern,74,2,126,0.5873015873015873,74,0,70,4
2015-16,2016-03-02,Boston Bruins,2,Atlantic,Eastern,76,2,128,0.59375,76,0,72,4
2015-16,2016-03-04,Boston Bruins,2,Atlantic,Eastern,78,2,130,0.6,78,0,74,4
2015-16,2016-03-06,Boston Bruins,1,Atlantic,Eastern,79,2,132,0.5984848484848485,79,0,75,4
2015-16,2016-03-08,Boston Bruins,2,Atlantic,Eastern,81,2,134,0.6044776119402985,81,0,75,6
2015-16,2016-03-09,Boston Bruins,2,Atlantic,Eastern,83,2,136,0.6102941176470589,81,2,75,8
2015-16,2016-03-11,Boston Bruins,1,Atlantic,Eastern,84,2,138,0.6086956521739131,83,1,76,8
2015-16,2016-03-12,Boston Bruins,2,Atlantic,Eastern,86,2,140,0.6142857142857143,83,3,78,8
2015-16,2016-03-16,Boston Bruins,0,Atlantic,Eastern,86,2,142,0.6056338028169014,85,1,79,7
2015-16,2016-03-19,Boston Bruins,0,Atlantic,Eastern,86,2,144,0.5972222222222222,85,1,83,3
2015-16,2016-03-20,Boston Bruins,0,Atlantic,Eastern,86,2,146,0.589041095890411,86,0,83,3
2015-16,2016-03-24,Boston Bruins,0,Atlantic,Eastern,86,2,148,0.581081081081081,86,0,85,1
2015-16,2016-03-24,Boston Bruins,0,Atlantic,Eastern,86,2,150,0.5733333333333334,86,0,85,1
2015-16,2016-03-26,Boston Bruins,2,Atlantic,Eastern,88,2,152,0.5789473684210527,88,0,85,3
2015-16,2016-03-29,Boston Bruins,0,Atlantic,Eastern,88,2,154,0.5714285714285714,88,0,87,1
2015-16,2016-04-02,Boston Bruins,2,Atlantic,Eastern,90,2,156,0.5769230769230769,91,-1,91,-1
2015-16,2016-04-03,Boston Bruins,0,Atlantic,Eastern,90,2,158,0.569620253164557,91,-1,91,-1
2015-16,2016-04-05,Boston Bruins,1,Atlantic,Eastern,91,2,160,0.56875,91,0,91,0
2015-16,2016-04-07,Boston Bruins,2,Atlantic,Eastern,93,2,162,0.5740740740740741,93,0,93,0
2015-16,2016-04-09,Boston Bruins,0,Atlantic,Eastern,93,2,164,0.5670731707317073,93,0,93,0
2015-16,2015-10-08,Buffalo Sabres,0,Atlantic,Eastern,0,2,2,0.0,2,-2,0,0
2015-16,2015-10-10,Buffalo Sabres,0,Atlantic,Eastern,0,2,4,0.0,4,-4,1,-1
2015-16,2015-10-12,Buffalo Sabres,2,Atlantic,Eastern,2,2,6,0.3333333333333333,4,-2,2,0
2015-16,2015-10-15,Buffalo Sabres,0,Atlantic,Eastern,2,2,8,0.25,6,-4,5,-3
2015-16,2015-10-17,Buffalo Sabres,0,Atlantic,Eastern,2,2,10,0.2,7,-5,6,-4
2015-16,2015-10-21,Buffalo Sabres,2,Atlantic,Eastern,4,2,12,0.3333333333333333,7,-3,6,-2
2015-16,2015-10-23,Buffalo Sabres,0,Atlantic,Eastern,4,2,14,0.2857142857142857,8,-4,7,-3
2015-16,2015-10-24,Buffalo Sabres,0,Atlantic,Eastern,4,2,16,0.25,8,-4,8,-4
2015-16,2015-10-27,Buffalo Sabres,2,Atlantic,Eastern,6,2,18,0.3333333333333333,11,-5,9,-3
2015-16,2015-10-29,Buffalo Sabres,0,Atlantic,Eastern,6,2,20,0.3,11,-5,11,-5
2015-16,2015-10-30,Buffalo Sabres,2,Atlantic,Eastern,8,2,22,0.36363636363636365,12,-4,11,-3
2015-16,2015-11-02,Buffalo Sabres,2,Atlantic,Eastern,10,2,24,0.4166666666666667,13,-3,13,-3
2015-16,2015-11-06,Buffalo Sabres,0,Atlantic,Eastern,10,2,26,0.38461538461538464,16,-6,13,-3
2015-16,2015-11-07,Buffalo Sabres,2,Atlantic,Eastern,12,2,28,0.42857142857142855,16,-4,15,-3
2015-16,2015-11-11,Buffalo Sabres,2,Atlantic,Eastern,14,2,30,0.4666666666666667,17,-3,17,-3
2015-16,2015-11-13,Buffalo Sabres,2,Atlantic,Eastern,16,2,32,0.5,18,-2,18,-2
2015-16,2015-11-15,Buffalo Sabres,1,Atlantic,Eastern,17,2,34,0.5,19,-2,19,-2
2015-16,2015-11-18,Buffalo Sabres,0,Atlantic,Eastern,17,2,36,0.4722222222222222,19,-2,19,-2
2015-16,2015-11-20,Buffalo Sabres,1,Atlantic,Eastern,18,2,38,0.47368421052631576,21,-3,21,-3
2015-16,2015-11-22,Buffalo Sabres,0,Atlantic,Eastern,18,2,40,0.45,24,-6,23,-5
2015-16,2015-11-24,Buffalo Sabres,0,Atlantic,Eastern,18,2,42,0.42857142857142855,24,-6,23,-5
2015-16,2015-11-26,Buffalo Sabres,0,Atlantic,Eastern,18,2,44,0.4090909090909091,25,-7,25,-7
2015-16,2015-11-28,Buffalo Sabres,2,Atlantic,Eastern,20,2,46,0.43478260869565216,27,-7,26,-6
2015-16,2015-11-29,Buffalo Sabres,2,Atlantic,Eastern,22,2,48,0.4583333333333333,28,-6,27,-5
2015-16,2015-12-02,Buffalo Sabres,1,Atlantic,Eastern,23,2,50,0.46,29,-6,27,-4
2015-16,2015-12-05,Buffalo Sabres,2,Atlantic,Eastern,25,2,52,0.4807692307692308,31,-6,30,-5
2015-16,2015-12-07,Buffalo Sabres,0,Atlantic,Eastern,25,2,54,0.46296296296296297,33,-8,31,-6
2015-16,2015-12-08,Buffalo Sabres,0,Atlantic,Eastern,25,2,56,0.44642857142857145,33,-8,31,-6
2015-16,2015-12-11,Buffalo Sabres,0,Atlantic,Eastern,25,2,58,0.43103448275862066,35,-10,32,-7
2015-16,2015-12-13,Buffalo Sabres,2,Atlantic,Eastern,27,2,60,0.45,35,-8,34,-7
2015-16,2015-12-15,Buffalo Sabres,2,Atlantic,Eastern,29,2,62,0.46774193548387094,37,-8,34,-5
2015-16,2015-12-16,Buffalo Sabres,0,Atlantic,Eastern,29,2,64,0.453125,37,-8,36,-7
2015-16,2015-12-18,Buffalo Sabres,2,Atlantic,Eastern,31,2,66,0.4696969696969697,38,-7,36,-5
2015-16,2015-12-19,Buffalo Sabres,1,Atlantic,Eastern,32,2,68,0.47058823529411764,39,-7,38,-6
2015-16,2015-12-27,Buffalo Sabres,2,Atlantic,Eastern,34,2,70,0.4857142857142857,43,-9,42,-8
2015-16,2015-12-29,Buffalo Sabres,0,Atlantic,Eastern,34,2,72,0.4722222222222222,43,-9,42,-8
2015-16,2015-12-31,Buffalo Sabres,0,Atlantic,Eastern,34,2,74,0.4594594594594595,44,-10,43,-9
2015-16,2015-12-31,Buffalo Sabres,0,Atlantic,Eastern,34,2,76,0.4473684210526316,44,-10,43,-9
2015-16,2016-01-02,Buffalo Sabres,0,Atlantic,Eastern,34,2,78,0.4358974358974359,45,-11,43,-9
2015-16,2016-01-06,Buffalo Sabres,0,Atlantic,Eastern,34,2,80,0.425,47,-13,44,-10
2015-16,2016-01-09,Buffalo Sabres,0,Atlantic,Eastern,34,2,82,0.4146341463414634,49,-15,45,-11
2015-16,2016-01-10,Buffalo Sabres,2,Atlantic,Eastern,36,2,84,0.42857142857142855,49,-13,46,-10
2015-16,2016-01-13,Buffalo Sabres,2,Atlantic,Eastern,38,2,86,0.4418604651162791,49,-11,47,-9
2015-16,2016-01-16,Buffalo Sabres,0,Atlantic,Eastern,38,2,88,0.4318181818181818,50,-12,49,-11
2015-16,2016-01-17,Buffalo Sabres,2,Atlantic,Eastern,40,2,90,0.4444444444444444,52,-12,50,-10
2015-16,2016-01-19,Buffalo Sabres,2,Atlantic,Eastern,42,2,92,0.45652173913043476,52,-10,50,-8
2015-16,2016-01-21,Buffalo Sabres,0,Atlantic,Eastern,42,2,94,0.44680851063829785,54,-12,51,-9
2015-16,2016-01-23,Buffalo Sabres,0,Atlantic,Eastern,42,2,96,0.4375,56,-14,53,-11
2015-16,2016-01-26,Buffalo Sabres,0,Atlantic,Eastern,42,2,98,0.42857142857142855,57,-15,55,-13
2015-16,2016-01-27,Buffalo Sabres,2,Atlantic,Eastern,44,2,100,0.44,57,-13,55,-11
2015-16,2016-02-04,Buffalo Sabres,2,Atlantic,Eastern,46,2,102,0.45098039215686275,58,-12,57,-11
2015-16,2016-02-05,Buffalo Sabres,1,Atlantic,Eastern,47,2,104,0.4519230769230769,60,-13,58,-11
2015-16,2016-02-07,Buffalo Sabres,1,Atlantic,Eastern,48,2,106,0.4528301886792453,62,-14,59,-11
2015-16,2016-02-10,Buffalo Sabres,0,Atlantic,Eastern,48,2,108,0.4444444444444444,62,-14,61,-13
2015-16,2016-02-12,Buffalo Sabres,0,Atlantic,Eastern,48,2,110,0.43636363636363634,64,-16,61,-13
2015-16,2016-02-13,Buffalo Sabres,2,Atlantic,Eastern,50,2,112,0.44642857142857145,65,-15,63,-13
2015-16,2016-02-14,Buffalo Sabres,2,Atlantic,Eastern,52,2,114,0.45614035087719296,66,-14,64,-12
2015-16,2016-02-17,Buffalo Sabres,1,Atlantic,Eastern,53,2,116,0.45689655172413796,67,-14,64,-11
2015-16,2016-02-20,Buffalo Sabres,2,Atlantic,Eastern,55,2,118,0.4661016949152542,68,-13,66,-11
2015-16,2016-02-21,Buffalo Sabres,0,Atlantic,Eastern,55,2,120,0.4583333333333333,68,-13,68,-13
2015-16,2016-02-25,Buffalo Sabres,0,Atlantic,Eastern,55,2,122,0.45081967213114754,72,-17,68,-13
2015-16,2016-02-27,Buffalo Sabres,2,Atlantic,Eastern,57,2,124,0.4596774193548387,74,-17,70,-13
2015-16,2016-02-28,Buffalo Sabres,0,Atlantic,Eastern,57,2,126,0.4523809523809524,74,-17,70,-13
2015-16,2016-03-02,Buffalo Sabres,1,Atlantic,Eastern,58,2,128,0.453125,76,-18,72,-14
2015-16,2016-03-04,Buffalo Sabres,2,Atlantic,Eastern,60,2,130,0.46153846153846156,78,-18,74,-14
2015-16,2016-03-05,Buffalo Sabres,1,Atlantic,Eastern,61,2,132,0.4621212121212121,78,-17,74,-13
2015-16,2016-03-08,Buffalo Sabres,2,Atlantic,Eastern,63,2,134,0.4701492537313433,81,-18,75,-12
2015-16,2016-03-09,Buffalo Sabres,0,Atlantic,Eastern,63,2,136,0.4632352941176471,81,-18,75,-12
2015-16,2016-03-11,Buffalo Sabres,0,Atlantic,Eastern,63,2,138,0.45652173913043476,83,-20,76,-13
2015-16,2016-03-12,Buffalo Sabres,2,Atlantic,Eastern,65,2,140,0.4642857142857143,83,-18,78,-13
2015-16,2016-03-16,Buffalo Sabres,1,Atlantic,Eastern,66,2,142,0.4647887323943662,85,-19,79,-13
2015-16,2016-03-18,Buffalo Sabres,2,Atlantic,Eastern,68,2,144,0.4722222222222222,85,-17,81,-13
2015-16,2016-03-19,Buffalo Sabres,0,Atlantic,Eastern,68,2,146,0.4657534246575342,85,-17,83,-15
2015-16,2016-03-22,Buffalo Sabres,2,Atlantic,Eastern,70,2,148,0.47297297297297297,86,-16,83,-13
2015-16,2016-03-26,Buffalo Sabres,2,Atlantic,Eastern,72,2,150,0.48,88,-16,85,-13
2015-16,2016-03-28,Buffalo Sabres,0,Atlantic,Eastern,72,2,152,0.47368421052631576,88,-16,87,-15
2015-16,2016-03-29,Buffalo Sabres,1,Atlantic,Eastern,73,2,154,0.474025974025974,88,-15,87,-14
2015-16,2016-03-31,Buffalo Sabres,2,Atlantic,Eastern,75,2,156,0.4807692307692308,88,-13,88,-13
2015-16,2016-04-02,Buffalo Sabres,2,Atlantic,Eastern,77,2,158,0.4873417721518987,91,-14,91,-14
2015-16,2016-04-05,Buffalo Sabres,2,Atlantic,Eastern,79,2,160,0.49375,91,-12,91,-12
2015-16,2016-04-08,Buffalo Sabres,0,Atlantic,Eastern,79,2,162,0.4876543209876543,93,-14,92,-13
2015-16,2016-04-09,Buffalo Sabres,2,Atlantic,Eastern,81,2,164,0.49390243902439024,93,-12,93,-12
2015-16,2015-10-08,Calgary Flames,0,Pacific,Western,0,2,2,0.0,0,0,0,0
2015-16,2015-10-11,Calgary Flames,2,Pacific,Western,2,2,4,0.5,3,-1,2,0
2015-16,2015-10-14,Calgary Flames,0,Pacific,Western,2,2,6,0.3333333333333333,4,-2,4,-2
2015-16,2015-10-17,Calgary Flames,0,Pacific,Western,2,2,8,0.25,6,-4,6,-4
2015-16,2015-10-18,Calgary Flames,0,Pacific,Western,2,2,10,0.2,6,-4,6,-4
2015-16,2015-10-21,Calgary Flames,0,Pacific,Western,2,2,12,0.16666666666666666,7,-5,7,-5
2015-16,2015-10-24,Calgary Flames,2,Pacific,Western,4,2,14,0.2857142857142857,8,-4,8,-4
2015-16,2015-10-25,Calgary Flames,0,Pacific,Western,4,2,16,0.25,9,-5,9,-5
2015-16,2015-10-26,Calgary Flames,0,Pacific,Western,4,2,18,0.2222222222222222,10,-6,10,-6
2015-16,2015-10-28,Calgary Flames,1,Pacific,Western,5,2,20,0.25,11,-6,11,-6
2015-16,2015-10-31,Calgary Flames,0,Pacific,Western,5,2,22,0.22727272727272727,11,-6,12,-7
2015-16,2015-11-01,Calgary Flames,2,Pacific,Western,7,2,24,0.2916666666666667,12,-5,12,-5
2015-16,2015-11-04,Calgary Flames,0,Pacific,Western,7,2,26,0.2692307692307692,12,-5,14,-7
2015-16,2015-11-06,Calgary Flames,2,Pacific,Western,9,2,28,0.32142857142857145,14,-5,15,-6
2015-16,2015-11-08,Calgary Flames,2,Pacific,Western,11,2,30,0.36666666666666664,14,-3,15,-4
2015-16,2015-11-11,Calgary Flames,0,Pacific,Western,11,2,32,0.34375,17,-6,17,-6
2015-16,2015-11-13,Calgary Flames,0,Pacific,Western,11,2,34,0.3235294117647059,19,-8,18,-7
2015-16,2015-11-14,Calgary Flames,2,Pacific,Western,13,2,36,0.3611111111111111,19,-6,18,-5
2015-16,2015-11-16,Calgary Flames,0,Pacific,Western,13,2,38,0.34210526315789475,19,-6,19,-6
2015-16,2015-11-18,Calgary Flames,2,Pacific,Western,15,2,40,0.375,20,-5,20,-5
2015-16,2015-11-21,Calgary Flames,2,Pacific,Western,17,2,42,0.40476190476190477,21,-4,21,-4
2015-16,2015-11-25,Calgary Flames,0,Pacific,Western,17,2,44,0.38636363636363635,22,-5,22,-5
2015-16,2015-11-28,Calgary Flames,1,Pacific,Western,18,2,46,0.391304347826087,25,-7,25,-7
2015-16,2015-11-29,Calgary Flames,0,Pacific,Western,18,2,48,0.375,27,-9,26,-8
2015-16,2015-12-02,Calgary Flames,2,Pacific,Western,20,2,50,0.4,27,-7,27,-7
2015-16,2015-12-05,Calgary Flames,2,Pacific,Western,22,2,52,0.4230769230769231,27,-5,28,-6
2015-16,2015-12-09,Calgary Flames,2,Pacific,Western,24,2,54,0.4444444444444444,28,-4,28,-4
2015-16,2015-12-11,Calgary Flames,2,Pacific,Western,26,2,56,0.4642857142857143,29,-3,30,-4
2015-16,2015-12-13,Calgary Flames,2,Pacific,Western,28,2,58,0.4827586206896552,30,-2,30,-2
2015-16,2015-12-16,Calgary Flames,2,Pacific,Western,30,2,60,0.5,30,0,31,-1
2015-16,2015-12-18,Calgary Flames,2,Pacific,Western,32,2,62,0.5161290322580645,32,0,33,-1
2015-16,2015-12-19,Calgary Flames,0,Pacific,Western,32,2,64,0.5,32,0,33,-1
2015-16,2015-12-21,Calgary Flames,0,Pacific,Western,32,2,66,0.48484848484848486,33,-1,34,-2
2015-16,2015-12-23,Calgary Flames,2,Pacific,Western,34,2,68,0.5,35,-1,35,-1
2015-16,2015-12-28,Calgary Flames,2,Pacific,Western,36,2,70,0.5142857142857142,37,-1,37,-1
2015-16,2015-12-30,Calgary Flames,0,Pacific,Western,36,2,72,0.5,37,-1,37,-1
2015-16,2016-01-01,Calgary Flames,0,Pacific,Western,36,2,74,0.4864864864864865,38,-2,39,-3
2015-16,2016-01-03,Calgary Flames,2,Pacific,Western,38,2,76,0.5,39,-1,39,-1
2015-16,2016-01-06,Calgary Flames,2,Pacific,Western,40,2,78,0.5128205128205128,40,0,41,-1
2015-16,2016-01-08,Calgary Flames,0,Pacific,Western,40,2,80,0.5,41,-1,43,-3
2015-16,2016-01-12,Calgary Flames,0,Pacific,Western,40,2,82,0.4878048780487805,44,-4,45,-5
2015-16,2016-01-14,Calgary Flames,2,Pacific,Western,42,2,84,0.5,44,-2,45,-3
2015-16,2016-01-17,Calgary Flames,1,Pacific,Western,43,2,86,0.5,48,-5,48,-5
2015-16,2016-01-20,Calgary Flames,0,Pacific,Western,43,2,88,0.48863636363636365,49,-6,49,-6
2015-16,2016-01-22,Calgary Flames,2,Pacific,Western,45,2,90,0.5,51,-6,51,-6
2015-16,2016-01-24,Calgary Flames,0,Pacific,Western,45,2,92,0.4891304347826087,51,-6,52,-7
2015-16,2016-01-26,Calgary Flames,0,Pacific,Western,45,2,94,0.4787234042553192,53,-8,53,-8
2015-16,2016-01-28,Calgary Flames,0,Pacific,Western,45,2,96,0.46875,53,-8,55,-10
2015-16,2016-02-04,Calgary Flames,2,Pacific,Western,47,2,98,0.47959183673469385,53,-6,55,-8
2015-16,2016-02-06,Calgary Flames,0,Pacific,Western,47,2,100,0.47,57,-10,56,-9
2015-16,2016-02-07,Calgary Flames,2,Pacific,Western,49,2,102,0.4803921568627451,57,-8,57,-8
2015-16,2016-02-10,Calgary Flames,2,Pacific,Western,51,2,104,0.49038461538461536,59,-8,58,-7
2015-16,2016-02-12,Calgary Flames,2,Pacific,Western,53,2,106,0.5,60,-7,58,-5
2015-16,2016-02-13,Calgary Flames,0,Pacific,Western,53,2,108,0.49074074074074076,60,-7,59,-6
2015-16,2016-02-15,Calgary Flames,0,Pacific,Western,53,2,110,0.4818181818181818,63,-10,61,-8
2015-16,2016-02-18,Calgary Flames,0,Pacific,Western,53,2,112,0.4732142857142857,65,-12,62,-9
2015-16,2016-02-20,Calgary Flames,2,Pacific,Western,55,2,114,0.4824561403508772,67,-12,64,-9
2015-16,2016-02-22,Calgary Flames,0,Pacific,Western,55,2,116,0.47413793103448276,67,-12,65,-10
2015-16,2016-02-24,Calgary Flames,0,Pacific,Western,55,2,118,0.4661016949152542,69,-14,66,-11
2015-16,2016-02-26,Calgary Flames,1,Pacific,Western,56,2,120,0.4666666666666667,70,-14,68,-12
2015-16,2016-02-28,Calgary Flames,0,Pacific,Western,56,2,122,0.45901639344262296,70,-14,68,-12
2015-16,2016-03-01,Calgary Flames,0,Pacific,Western,56,2,124,0.45161290322580644,74,-18,68,-12
2015-16,2016-03-02,Calgary Flames,0,Pacific,Western,56,2,126,0.4444444444444444,74,-18,68,-12
2015-16,2016-03-04,Calgary Flames,0,Pacific,Western,56,2,128,0.4375,76,-20,70,-14
2015-16,2016-03-05,Calgary Flames,2,Pacific,Western,58,2,130,0.4461538461538462,76,-18,72,-14
2015-16,2016-03-08,Calgary Flames,1,Pacific,Western,59,2,132,0.44696969696969696,78,-19,72,-13
2015-16,2016-03-10,Calgary Flames,2,Pacific,Western,61,2,134,0.4552238805970149,80,-19,74,-13
2015-16,2016-03-12,Calgary Flames,0,Pacific,Western,61,2,136,0.4485294117647059,80,-19,74,-13
2015-16,2016-03-15,Calgary Flames,2,Pacific,Western,63,2,138,0.45652173913043476,82,-19,75,-12
2015-16,2016-03-17,Calgary Flames,2,Pacific,Western,65,2,140,0.4642857142857143,84,-19,76,-11
2015-16,2016-03-19,Calgary Flames,1,Pacific,Western,66,2,142,0.4647887323943662,86,-20,78,-12
2015-16,2016-03-20,Calgary Flames,2,Pacific,Western,68,2,144,0.4722222222222222,86,-18,78,-10
2015-16,2016-03-21,Calgary Flames,0,Pacific,Western,68,2,146,0.4657534246575342,88,-20,80,-12
2015-16,2016-03-25,Calgary Flames,0,Pacific,Western,68,2,148,0.4594594594594595,88,-20,83,-15
2015-16,2016-03-27,Calgary Flames,0,Pacific,Western,68,2,150,0.4533333333333333,88,-20,85,-17
2015-16,2016-03-29,Calgary Flames,2,Pacific,Western,70,2,152,0.4605263157894737,90,-20,85,-15
2015-16,2016-03-31,Calgary Flames,0,Pacific,Western,70,2,154,0.45454545454545453,92,-22,87,-17
2015-16,2016-04-01,Calgary Flames,0,Pacific,Western,70,2,156,0.44871794871794873,92,-22,87,-17
2015-16,2016-04-03,Calgary Flames,2,Pacific,Western,72,2,158,0.45569620253164556,94,-22,87,-15
2015-16,2016-04-06,Calgary Flames,1,Pacific,Western,73,2,160,0.45625,96,-23,87,-14
2015-16,2016-04-08,Calgary Flames,2,Pacific,Western,75,2,162,0.46296296296296297,96,-21,87,-12
2015-16,2016-04-09,Calgary Flames,2,Pacific,Western,77,2,164,0.4695121951219512,96,-19,87,-10
2015-16,2015-10-09,Carolina Hurricanes,0,Metropolitan,Eastern,0,2,2,0.0,1,-1,0,0
2015-16,2015-10-10,Carolina Hurricanes,0,Metropolitan,Eastern,0,2,4,0.0,1,-1,1,-1
2015-16,2015-10-13,Carolina Hurricanes,0,Metropolitan,Eastern,0,2,6,0.0,3,-3,3,-3
2015-16,2015-10-16,Carolina Hurricanes,2,Metropolitan,Eastern,2,2,8,0.25,5,-3,5,-3
2015-16,2015-10-17,Carolina Hurricanes,0,Metropolitan,Eastern,2,2,10,0.2,6,-4,6,-4
2015-16,2015-10-22,Carolina Hurricanes,2,Metropolitan,Eastern,4,2,12,0.3333333333333333,8,-4,7,-3
2015-16,2015-10-24,Carolina Hurricanes,0,Metropolitan,Eastern,4,2,14,0.2857142857142857,9,-5,8,-4
2015-16,2015-10-25,Carolina Hurricanes,0,Metropolitan,Eastern,4,2,16,0.25,11,-7,9,-5
2015-16,2015-10-27,Carolina Hurricanes,2,Metropolitan,Eastern,6,2,18,0.3333333333333333,12,-6,9,-3
2015-16,2015-10-29,Carolina Hurricanes,2,Metropolitan,Eastern,8,2,20,0.4,12,-4,11,-3
2015-16,2015-10-30,Carolina Hurricanes,2,Metropolitan,Eastern,10,2,22,0.45454545454545453,14,-4,11,-1
2015-16,2015-11-01,Carolina Hurricanes,0,Metropolitan,Eastern,10,2,24,0.4166666666666667,15,-5,13,-3
2015-16,2015-11-07,Carolina Hurricanes,0,Metropolitan,Eastern,10,2,26,0.38461538461538464,18,-8,15,-5
2015-16,2015-11-08,Carolina Hurricanes,2,Metropolitan,Eastern,12,2,28,0.42857142857142855,18,-6,16,-4
2015-16,2015-11-11,Carolina Hurricanes,0,Metropolitan,Eastern,12,2,30,0.4,19,-7,17,-5
2015-16,2015-11-13,Carolina Hurricanes,1,Metropolitan,Eastern,13,2,32,0.40625,20,-7,18,-5
2015-16,2015-11-15,Carolina Hurricanes,1,Metropolitan,Eastern,14,2,34,0.4117647058823529,21,-7,19,-5
2015-16,2015-11-17,Carolina Hurricanes,0,Metropolitan,Eastern,14,2,36,0.3888888888888889,23,-9,19,-5
2015-16,2015-11-21,Carolina Hurricanes,1,Metropolitan,Eastern,15,2,38,0.39473684210526316,24,-9,21,-6
2015-16,2015-11-22,Carolina Hurricanes,2,Metropolitan,Eastern,17,2,40,0.425,24,-7,23,-6
2015-16,2015-11-24,Carolina Hurricanes,1,Metropolitan,Eastern,18,2,42,0.42857142857142855,24,-6,23,-5
2015-16,2015-11-26,Carolina Hurricanes,2,Metropolitan,Eastern,20,2,44,0.45454545454545453,26,-6,25,-5
2015-16,2015-11-28,Carolina Hurricanes,0,Metropolitan,Eastern,20,2,46,0.43478260869565216,27,-7,26,-6
2015-16,2015-12-01,Carolina Hurricanes,0,Metropolitan,Eastern,20,2,48,0.4166666666666667,30,-10,27,-7
2015-16,2015-12-04,Carolina Hurricanes,0,Metropolitan,Eastern,20,2,50,0.4,32,-12,28,-8
2015-16,2015-12-06,Carolina Hurricanes,2,Metropolitan,Eastern,22,2,52,0.4230769230769231,35,-13,30,-8
2015-16,2015-12-06,Carolina Hurricanes,2,Metropolitan,Eastern,24,2,54,0.4444444444444444,35,-11,30,-6
2015-16,2015-12-09,Carolina Hurricanes,0,Metropolitan,Eastern,24,2,56,0.42857142857142855,37,-13,31,-7
2015-16,2015-12-12,Carolina Hurricanes,2,Metropolitan,Eastern,26,2,58,0.4482758620689655,37,-11,34,-8
2015-16,2015-12-13,Carolina Hurricanes,2,Metropolitan,Eastern,28,2,60,0.4666666666666667,39,-11,34,-6
2015-16,2015-12-16,Carolina Hurricanes,1,Metropolitan,Eastern,29,2,62,0.46774193548387094,41,-12,36,-7
2015-16,2015-12-19,Carolina Hurricanes,0,Metropolitan,Eastern,29,2,64,0.453125,41,-12,38,-9
2015-16,2015-12-20,Carolina Hurricanes,2,Metropolitan,Eastern,31,2,66,0.4696969696969697,41,-10,39,-8
2015-16,2015-12-22,Carolina Hurricanes,0,Metropolitan,Eastern,31,2,68,0.45588235294117646,42,-11,39,-8
2015-16,2015-12-27,Carolina Hurricanes,2,Metropolitan,Eastern,33,2,70,0.4714285714285714,43,-10,42,-9
2015-16,2015-12-28,Carolina Hurricanes,2,Metropolitan,Eastern,35,2,72,0.4861111111111111,43,-8,42,-7
2015-16,2015-12-30,Carolina Hurricanes,0,Metropolitan,Eastern,35,2,74,0.47297297297297297,44,-9,42,-7
2015-16,2015-12-31,Carolina Hurricanes,2,Metropolitan,Eastern,37,2,76,0.4868421052631579,46,-9,43,-6
2015-16,2016-01-03,Carolina Hurricanes,1,Metropolitan,Eastern,38,2,78,0.48717948717948717,46,-8,44,-6
2015-16,2016-01-05,Carolina Hurricanes,1,Metropolitan,Eastern,39,2,80,0.4875,46,-7,44,-5
2015-16,2016-01-07,Carolina Hurricanes,0,Metropolitan,Eastern,39,2,82,0.47560975609756095,48,-9,44,-5
2015-16,2016-01-09,Carolina Hurricanes,2,Metropolitan,Eastern,41,2,84,0.4880952380952381,49,-8,45,-4
2015-16,2016-01-10,Carolina Hurricanes,2,Metropolitan,Eastern,43,2,86,0.5,49,-6,46,-3
2015-16,2016-01-13,Carolina Hurricanes,2,Metropolitan,Eastern,45,2,88,0.5113636363636364,51,-6,47,-2
2015-16,2016-01-15,Carolina Hurricanes,2,Metropolitan,Eastern,47,2,90,0.5222222222222223,51,-4,47,0
2015-16,2016-01-16,Carolina Hurricanes,1,Metropolitan,Eastern,48,2,92,0.5217391304347826,53,-5,49,-1
2015-16,2016-01-17,Carolina Hurricanes,0,Metropolitan,Eastern,48,2,94,0.5106382978723404,53,-5,50,-2
2015-16,2016-01-22,Carolina Hurricanes,2,Metropolitan,Eastern,50,2,96,0.5208333333333334,54,-4,53,-3
2015-16,2016-01-23,Carolina Hurricanes,0,Metropolitan,Eastern,50,2,98,0.5102040816326531,56,-6,53,-3
2015-16,2016-01-24,Carolina Hurricanes,2,Metropolitan,Eastern,52,2,100,0.52,56,-4,55,-3
2015-16,2016-01-27,Carolina Hurricanes,2,Metropolitan,Eastern,54,2,102,0.5294117647058824,56,-2,55,-1
2015-16,2016-02-04,Carolina Hurricanes,0,Metropolitan,Eastern,54,2,104,0.5192307692307693,58,-4,57,-3
2015-16,2016-02-06,Carolina Hurricanes,2,Metropolitan,Eastern,56,2,106,0.5283018867924528,59,-3,58,-2
2015-16,2016-02-07,Carolina Hurricanes,1,Metropolitan,Eastern,57,2,108,0.5277777777777778,60,-3,59,-2
2015-16,2016-02-13,Carolina Hurricanes,1,Metropolitan,Eastern,58,2,110,0.5272727272727272,64,-6,63,-5
2015-16,2016-02-14,Carolina Hurricanes,2,Metropolitan,Eastern,60,2,112,0.5357142857142857,65,-5,64,-4
2015-16,2016-02-17,Carolina Hurricanes,2,Metropolitan,Eastern,62,2,114,0.543859649122807,66,-4,64,-2
2015-16,2016-02-19,Carolina Hurricanes,0,Metropolitan,Eastern,62,2,116,0.5344827586206896,67,-5,66,-4
2015-16,2016-02-20,Carolina Hurricanes,2,Metropolitan,Eastern,64,2,118,0.5423728813559322,69,-5,66,-2
2015-16,2016-02-22,Carolina Hurricanes,0,Metropolitan,Eastern,64,2,120,0.5333333333333333,69,-5,68,-4
2015-16,2016-02-24,Carolina Hurricanes,2,Metropolitan,Eastern,66,2,122,0.5409836065573771,71,-5,68,-2
2015-16,2016-02-26,Carolina Hurricanes,0,Metropolitan,Eastern,66,2,124,0.532258064516129,73,-7,68,-2
2015-16,2016-02-27,Carolina Hurricanes,0,Metropolitan,Eastern,66,2,126,0.5238095238095238,73,-7,70,-4
2015-16,2016-02-28,Carolina Hurricanes,0,Metropolitan,Eastern,66,2,128,0.515625,73,-7,70,-4
2015-16,2016-03-02,Carolina Hurricanes,2,Metropolitan,Eastern,68,2,130,0.5230769230769231,75,-7,72,-4
2015-16,2016-03-06,Carolina Hurricanes,1,Metropolitan,Eastern,69,2,132,0.5227272727272727,79,-10,75,-6
2015-16,2016-03-09,Carolina Hurricanes,2,Metropolitan,Eastern,71,2,134,0.5298507462686567,81,-10,75,-4
2015-16,2016-03-11,Carolina Hurricanes,2,Metropolitan,Eastern,73,2,136,0.5367647058823529,82,-9,76,-3
2015-16,2016-03-12,Carolina Hurricanes,1,Metropolitan,Eastern,74,2,138,0.5362318840579711,82,-8,78,-4
2015-16,2016-03-15,Carolina Hurricanes,1,Metropolitan,Eastern,75,2,140,0.5357142857142857,85,-10,79,-4
2015-16,2016-03-17,Carolina Hurricanes,0,Metropolitan,Eastern,75,2,142,0.528169014084507,85,-10,81,-6
2015-16,2016-03-19,Carolina Hurricanes,1,Metropolitan,Eastern,76,2,144,0.5277777777777778,86,-10,83,-7
2015-16,2016-03-22,Carolina Hurricanes,0,Metropolitan,Eastern,76,2,146,0.5205479452054794,88,-12,83,-7
2015-16,2016-03-24,Carolina Hurricanes,2,Metropolitan,Eastern,78,2,148,0.527027027027027,88,-10,85,-7
2015-16,2016-03-26,Carolina Hurricanes,1,Metropolitan,Eastern,79,2,150,0.5266666666666666,90,-11,85,-6
2015-16,2016-03-27,Carolina Hurricanes,2,Metropolitan,Eastern,81,2,152,0.5328947368421053,92,-11,85,-4
2015-16,2016-03-29,Carolina Hurricanes,1,Metropolitan,Eastern,82,2,154,0.5324675324675324,94,-12,87,-5
2015-16,2016-03-31,Carolina Hurricanes,2,Metropolitan,Eastern,84,2,156,0.5384615384615384,95,-11,88,-4
2015-16,2016-04-02,Carolina Hurricanes,0,Metropolitan,Eastern,84,2,158,0.5316455696202531,95,-11,91,-7
2015-16,2016-04-05,Carolina Hurricanes,2,Metropolitan,Eastern,86,2,160,0.5375,99,-13,91,-5
2015-16,2016-04-07,Carolina Hurricanes,0,Metropolitan,Eastern,86,2,162,0.5308641975308642,99,-13,93,-7
2015-16,2016-04-09,Carolina Hurricanes,0,Metropolitan,Eastern,86,2,164,0.524390243902439,101,-15,93,-7
2015-16,2015-10-08,Chicago Blackhawks,0,Central,Western,0,2,2,0.0,0,0,0,0
2015-16,2015-10-09,Chicago Blackhawks,2,Central,Western,2,2,4,0.5,2,0,2,0
2015-16,2015-10-11,Chicago Blackhawks,2,Central,Western,4,2,6,0.6666666666666666,4,0,2,2
2015-16,2015-10-15,Chicago Blackhawks,0,Central,Western,4,2,8,0.5,6,-2,4,0
2015-16,2015-10-15,Chicago Blackhawks,0,Central,Western,4,2,10,0.4,6,-2,4,0
2015-16,2015-10-18,Chicago Blackhawks,2,Central,Western,6,2,12,0.5,8,-2,6,0
2015-16,2015-10-23,Chicago Blackhawks,2,Central,Western,8,2,14,0.5714285714285714,10,-2,8,0
2015-16,2015-10-25,Chicago Blackhawks,2,Central,Western,10,2,16,0.625,11,-1,9,1
2015-16,2015-10-27,Chicago Blackhawks,2,Central,Western,12,2,18,0.6666666666666666,12,0,10,2
2015-16,2015-10-30,Chicago Blackhawks,0,Central,Western,12,2,20,0.6,15,-3,12,0
2015-16,2015-10-31,Chicago Blackhawks,0,Central,Western,12,2,22,0.5454545454545454,16,-4,12,0
2015-16,2015-11-03,Chicago Blackhawks,2,Central,Western,14,2,24,0.5833333333333334,16,-2,14,0
2015-16,2015-11-05,Chicago Blackhawks,1,Central,Western,15,2,26,0.5769230769230769,17,-2,15,0
2015-16,2015-11-07,Chicago Blackhawks,0,Central,Western,15,2,28,0.5357142857142857,18,-3,15,0
2015-16,2015-11-09,Chicago Blackhawks,2,Central,Western,17,2,30,0.5666666666666667,18,-1,17,0
2015-16,2015-11-13,Chicago Blackhawks,0,Central,Western,17,2,32,0.53125,22,-5,18,-1
2015-16,2015-11-15,Chicago Blackhawks,2,Central,Western,19,2,34,0.5588235294117647,23,-4,19,0
2015-16,2015-11-16,Chicago Blackhawks,2,Central,Western,21,2,36,0.5833333333333334,23,-2,19,2
2015-16,2015-11-19,Chicago Blackhawks,2,Central,Western,23,2,38,0.6052631578947368,25,-2,20,3
2015-16,2015-11-21,Chicago Blackhawks,1,Central,Western,24,2,40,0.6,25,-1,21,3
2015-16,2015-11-22,Chicago Blackhawks,0,Central,Western,24,2,42,0.5714285714285714,25,-1,22,2
2015-16,2015-11-26,Chicago Blackhawks,2,Central,Western,26,2,44,0.5909090909090909,27,-1,24,2
2015-16,2015-11-27,Chicago Blackhawks,2,Central,Western,28,2,46,0.6086956521739131,28,0,24,4
2015-16,2015-11-29,Chicago Blackhawks,1,Central,Western,29,2,48,0.6041666666666666,29,0,26,3
2015-16,2015-12-02,Chicago Blackhawks,0,Central,Western,29,2,50,0.58,30,-1,27,2
2015-16,2015-12-04,Chicago Blackhawks,1,Central,Western,30,2,52,0.5769230769230769,30,0,27,3
2015-16,2015-12-06,Chicago Blackhawks,2,Central,Western,32,2,54,0.5925925925925926,32,0,28,4
2015-16,2015-12-09,Chicago Blackhawks,2,Central,Western,34,2,56,0.6071428571428571,34,0,28,6
2015-16,2015-12-11,Chicago Blackhawks,0,Central,Western,34,2,58,0.5862068965517241,35,-1,30,4
2015-16,2015-12-12,Chicago Blackhawks,2,Central,Western,36,2,60,0.6,36,0,30,6
2015-16,2015-12-14,Chicago Blackhawks,2,Central,Western,38,2,62,0.6129032258064516,38,0,30,8
2015-16,2015-12-16,Chicago Blackhawks,0,Central,Western,38,2,64,0.59375,38,0,31,7
2015-16,2015-12-18,Chicago Blackhawks,2,Central,Western,40,2,66,0.6060606060606061,40,0,33,7
2015-16,2015-12-19,Chicago Blackhawks,2,Central,Western,42,2,68,0.6176470588235294,42,0,33,9
2015-16,2015-12-21,Chicago Blackhawks,2,Central,Western,44,2,70,0.6285714285714286,44,0,34,10
2015-16,2015-12-23,Chicago Blackhawks,0,Central,Western,44,2,72,0.6111111111111112,44,0,35,9
2015-16,2015-12-28,Chicago Blackhawks,0,Central,Western,44,2,74,0.5945945945945946,44,0,37,7
2015-16,2015-12-30,Chicago Blackhawks,2,Central,Western,46,2,76,0.6052631578947368,46,0,37,9
2015-16,2016-01-01,Chicago Blackhawks,2,Central,Western,48,2,78,0.6153846153846154,48,0,39,9
2015-16,2016-01-04,Chicago Blackhawks,2,Central,Western,50,2,80,0.625,50,0,39,11
2015-16,2016-01-06,Chicago Blackhawks,2,Central,Western,52,2,82,0.6341463414634146,51,1,41,11
2015-16,2016-01-07,Chicago Blackhawks,2,Central,Western,54,2,84,0.6428571428571429,52,2,42,12
2015-16,2016-01-09,Chicago Blackhawks,2,Central,Western,56,2,86,0.6511627906976745,53,3,44,12
2015-16,2016-01-11,Chicago Blackhawks,2,Central,Western,58,2,88,0.6590909090909091,55,3,45,13
2015-16,2016-01-13,Chicago Blackhawks,2,Central,Western,60,2,90,0.6666666666666666,57,3,45,15
2015-16,2016-01-15,Chicago Blackhawks,2,Central,Western,62,2,92,0.6739130434782609,57,5,46,16
2015-16,2016-01-16,Chicago Blackhawks,2,Central,Western,64,2,94,0.6808510638297872,57,7,46,18
2015-16,2016-01-18,Chicago Blackhawks,2,Central,Western,66,2,96,0.6875,59,7,48,18
2015-16,2016-01-20,Chicago Blackhawks,2,Central,Western,68,2,98,0.6938775510204082,61,7,49,19
2015-16,2016-01-22,Chicago Blackhawks,0,Central,Western,68,2,100,0.68,63,5,51,17
2015-16,2016-01-23,Chicago Blackhawks,0,Central,Western,68,2,102,0.6666666666666666,64,4,51,17
2015-16,2016-01-25,Chicago Blackhawks,2,Central,Western,70,2,104,0.6730769230769231,64,6,52,18
2015-16,2016-01-27,Chicago Blackhawks,0,Central,Western,70,2,106,0.660377358490566,64,6,54,16
2015-16,2016-02-03,Chicago Blackhawks,2,Central,Western,72,2,108,0.6666666666666666,66,6,55,17
2015-16,2016-02-05,Chicago Blackhawks,2,Central,Western,74,2,110,0.6727272727272727,66,8,55,19
2015-16,2016-02-07,Chicago Blackhawks,2,Central,Western,76,2,112,0.6785714285714286,68,8,57,19
2015-16,2016-02-10,Chicago Blackhawks,0,Central,Western,76,2,114,0.6666666666666666,69,7,58,18
2015-16,2016-02-12,Chicago Blackhawks,0,Central,Western,76,2,116,0.6551724137931034,69,7,58,18
2015-16,2016-02-14,Chicago Blackhawks,1,Central,Western,77,2,118,0.652542372881356,73,4,61,16
2015-16,2016-02-16,Chicago Blackhawks,2,Central,Western,79,2,120,0.6583333333333333,73,6,62,17
2015-16,2016-02-18,Chicago Blackhawks,2,Central,Western,81,2,122,0.6639344262295082,75,6,62,19
2015-16,2016-02-21,Chicago Blackhawks,0,Central,Western,81,2,124,0.6532258064516129,79,2,65,16
2015-16,2016-02-26,Chicago Blackhawks,0,Central,Western,81,2,126,0.6428571428571429,79,2,68,13
2015-16,2016-02-28,Chicago Blackhawks,2,Central,Western,83,2,128,0.6484375,81,2,68,15
2015-16,2016-03-03,Chicago Blackhawks,2,Central,Western,85,2,130,0.6538461538461539,83,2,68,17
2015-16,2016-03-04,Chicago Blackhawks,0,Central,Western,85,2,132,0.6439393939393939,83,2,70,15
2015-16,2016-03-06,Chicago Blackhawks,2,Central,Western,87,2,134,0.6492537313432836,83,4,72,15
2015-16,2016-03-10,Chicago Blackhawks,1,Central,Western,88,2,136,0.6470588235294118,87,1,74,14
2015-16,2016-03-12,Chicago Blackhawks,0,Central,Western,88,2,138,0.6376811594202898,88,0,74,14
2015-16,2016-03-15,Chicago Blackhawks,0,Central,Western,88,2,140,0.6285714285714286,88,0,75,13
2015-16,2016-03-17,Chicago Blackhawks,0,Central,Western,88,2,142,0.6197183098591549,88,0,76,12
2015-16,2016-03-19,Chicago Blackhawks,2,Central,Western,90,2,144,0.625,90,0,78,12
2015-16,2016-03-21,Chicago Blackhawks,1,Central,Western,91,2,146,0.6232876712328768,91,0,80,11
2015-16,2016-03-23,Chicago Blackhawks,0,Central,Western,91,2,148,0.6148648648648649,91,0,81,10
2015-16,2016-03-27,Chicago Blackhawks,2,Central,Western,93,2,150,0.62,93,0,85,8
2015-16,2016-03-28,Chicago Blackhawks,2,Central,Western,95,2,152,0.625,95,0,85,10
2015-16,2016-03-30,Chicago Blackhawks,0,Central,Western,95,2,154,0.6168831168831169,95,0,87,8
2015-16,2016-04-02,Chicago Blackhawks,2,Central,Western,97,2,156,0.6217948717948718,97,0,87,10
2015-16,2016-04-03,Chicago Blackhawks,2,Central,Western,99,2,158,0.6265822784810127,99,0,87,12
2015-16,2016-04-06,Chicago Blackhawks,2,Central,Western,101,2,160,0.63125,101,0,87,14
2015-16,2016-04-08,Chicago Blackhawks,1,Central,Western,102,2,162,0.6296296296296297,102,0,87,15
2015-16,2016-04-09,Chicago Blackhawks,1,Central,Western,103,2,164,0.6280487804878049,103,0,87,16
2015-16,2015-10-09,Colorado Avalanche,0,Central,Western,0,2,2,0.0,2,-2,2,-2
2015-16,2015-10-11,Colorado Avalanche,2,Central,Western,2,2,4,0.5,4,-2,2,0
2015-16,2015-10-15,Colorado Avalanche,0,Central,Western,2,2,6,0.3333333333333333,6,-4,4,-2
2015-16,2015-10-17,Colorado Avalanche,2,Central,Western,4,2,8,0.5,8,-4,6,-2
2015-16,2015-10-19,Colorado Avalanche,0,Central,Western,4,2,10,0.4,8,-4,6,-2
2015-16,2015-10-22,Colorado Avalanche,1,Central,Western,5,2,12,0.4166666666666667,10,-5,7,-2
2015-16,2015-10-25,Colorado Avalanche,0,Central,Western,5,2,14,0.35714285714285715,11,-6,9,-4
2015-16,2015-10-27,Colorado Avalanche,0,Central,Western,5,2,16,0.3125,12,-7,10,-5
2015-16,2015-10-29,Colorado Avalanche,2,Central,Western,7,2,18,0.3888888888888889,13,-6,11,-4
2015-16,2015-10-30,Colorado Avalanche,0,Central,Western,7,2,20,0.35,15,-8,12,-5
2015-16,2015-11-01,Colorado Avalanche,0,Central,Western,7,2,22,0.3181818181818182,16,-9,12,-5
2015-16,2015-11-04,Colorado Avalanche,2,Central,Western,9,2,24,0.375,16,-7,14,-5
2015-16,2015-11-06,Colorado Avalanche,0,Central,Western,9,2,26,0.34615384615384615,18,-9,15,-6
2015-16,2015-11-07,Colorado Avalanche,0,Central,Western,9,2,28,0.32142857142857145,18,-9,15,-6
2015-16,2015-11-11,Colorado Avalanche,2,Central,Western,11,2,30,0.36666666666666664,20,-9,17,-6
2015-16,2015-11-13,Colorado Avalanche,2,Central,Western,13,2,32,0.40625,22,-9,18,-5
2015-16,2015-11-15,Colorado Avalanche,2,Central,Western,15,2,34,0.4411764705882353,23,-8,19,-4
2015-16,2015-11-18,Colorado Avalanche,0,Central,Western,15,2,36,0.4166666666666667,25,-10,20,-5
2015-16,2015-11-20,Colorado Avalanche,0,Central,Western,15,2,38,0.39473684210526316,25,-10,21,-6
2015-16,2015-11-22,Colorado Avalanche,0,Central,Western,15,2,40,0.375,25,-10,22,-7
2015-16,2015-11-24,Colorado Avalanche,2,Central,Western,17,2,42,0.40476190476190477,25,-8,22,-5
2015-16,2015-11-26,Colorado Avalanche,0,Central,Western,17,2,44,0.38636363636363635,27,-10,24,-7
2015-16,2015-11-29,Colorado Avalanche,2,Central,Western,19,2,46,0.41304347826086957,29,-10,26,-7
2015-16,2015-12-01,Colorado Avalanche,0,Central,Western,19,2,48,0.3958333333333333,29,-10,26,-7
2015-16,2015-12-02,Colorado Avalanche,2,Central,Western,21,2,50,0.42,30,-9,27,-6
2015-16,2015-12-04,Colorado Avalanche,2,Central,Western,23,2,52,0.4423076923076923,30,-7,27,-4
2015-16,2015-12-06,Colorado Avalanche,0,Central,Western,23,2,54,0.42592592592592593,32,-9,28,-5
2015-16,2015-12-08,Colorado Avalanche,2,Central,Western,25,2,56,0.44642857142857145,33,-8,28,-3
2015-16,2015-12-10,Colorado Avalanche,0,Central,Western,25,2,58,0.43103448275862066,34,-9,29,-4
2015-16,2015-12-13,Colorado Avalanche,2,Central,Western,27,2,60,0.45,36,-9,30,-3
2015-16,2015-12-13,Colorado Avalanche,2,Central,Western,29,2,62,0.46774193548387094,36,-7,30,-1
2015-16,2015-12-16,Colorado Avalanche,2,Central,Western,31,2,64,0.484375,38,-7,31,0
2015-16,2015-12-18,Colorado Avalanche,2,Central,Western,33,2,66,0.5,40,-7,33,0
2015-16,2015-12-20,Colorado Avalanche,2,Central,Western,35,2,68,0.5147058823529411,42,-7,33,2
2015-16,2015-12-22,Colorado Avalanche,0,Central,Western,35,2,70,0.5,44,-9,34,1
2015-16,2015-12-28,Colorado Avalanche,1,Central,Western,36,2,72,0.5,44,-8,37,-1
2015-16,2015-12-29,Colorado Avalanche,2,Central,Western,38,2,74,0.5135135135135135,44,-6,37,1
2015-16,2016-01-01,Colorado Avalanche,1,Central,Western,39,2,76,0.5131578947368421,48,-9,39,0
2015-16,2016-01-03,Colorado Avalanche,0,Central,Western,39,2,78,0.5,48,-9,39,0
2015-16,2016-01-05,Colorado Avalanche,2,Central,Western,41,2,80,0.5125,50,-9,41,0
2015-16,2016-01-07,Colorado Avalanche,2,Central,Western,43,2,82,0.524390243902439,52,-9,42,1
2015-16,2016-01-09,Colorado Avalanche,2,Central,Western,45,2,84,0.5357142857142857,53,-8,44,1
2015-16,2016-01-11,Colorado Avalanche,0,Central,Western,45,2,86,0.5232558139534884,55,-10,45,0
2015-16,2016-01-13,Colorado Avalanche,0,Central,Western,45,2,88,0.5113636363636364,57,-12,45,0
2015-16,2016-01-15,Colorado Avalanche,2,Central,Western,47,2,90,0.5222222222222223,57,-10,46,1
2015-16,2016-01-17,Colorado Avalanche,0,Central,Western,47,2,92,0.5108695652173914,59,-12,48,-1
2015-16,2016-01-19,Colorado Avalanche,2,Central,Western,49,2,94,0.5212765957446809,61,-12,49,0
2015-16,2016-01-21,Colorado Avalanche,2,Central,Western,51,2,96,0.53125,63,-12,49,2
2015-16,2016-01-23,Colorado Avalanche,2,Central,Western,53,2,98,0.5408163265306123,64,-11,51,2
2015-16,2016-01-24,Colorado Avalanche,2,Central,Western,55,2,100,0.55,64,-9,52,3
2015-16,2016-01-27,Colorado Avalanche,0,Central,Western,55,2,102,0.5392156862745098,64,-9,54,1
2015-16,2016-01-28,Colorado Avalanche,2,Central,Western,57,2,104,0.5480769230769231,64,-7,55,2
2015-16,2016-02-03,Colorado Avalanche,0,Central,Western,57,2,106,0.5377358490566038,66,-9,55,2
2015-16,2016-02-05,Colorado Avalanche,1,Central,Western,58,2,108,0.5370370370370371,66,-8,55,3
2015-16,2016-02-07,Colorado Avalanche,0,Central,Western,58,2,110,0.5272727272727272,68,-10,57,1
2015-16,2016-02-10,Colorado Avalanche,0,Central,Western,58,2,112,0.5178571428571429,69,-11,58,0
2015-16,2016-02-12,Colorado Avalanche,2,Central,Western,60,2,114,0.5263157894736842,69,-9,58,2
2015-16,2016-02-13,Colorado Avalanche,2,Central,Western,62,2,116,0.5344827586206896,71,-9,59,3
2015-16,2016-02-14,Colorado Avalanche,0,Central,Western,62,2,118,0.5254237288135594,73,-11,61,1
2015-16,2016-02-18,Colorado Avalanche,2,Central,Western,64,2,120,0.5333333333333333,75,-11,62,2
2015-16,2016-02-21,Colorado Avalanche,2,Central,Western,66,2,122,0.5409836065573771,79,-13,65,1
2015-16,2016-02-22,Colorado Avalanche,0,Central,Western,66,2,124,0.532258064516129,79,-13,65,1
2015-16,2016-02-25,Colorado Avalanche,2,Central,Western,68,2,126,0.5396825396825397,79,-11,68,0
2015-16,2016-02-28,Colorado Avalanche,0,Central,Western,68,2,128,0.53125,81,-13,68,0
2015-16,2016-03-02,Colorado Avalanche,0,Central,Western,68,2,130,0.5230769230769231,83,-15,68,0
2015-16,2016-03-04,Colorado Avalanche,2,Central,Western,70,2,132,0.5303030303030303,83,-13,70,0
2015-16,2016-03-05,Colorado Avalanche,0,Central,Western,70,2,134,0.5223880597014925,83,-13,72,-2
2015-16,2016-03-08,Colorado Avalanche,2,Central,Western,72,2,136,0.5294117647058824,85,-13,72,0
2015-16,2016-03-10,Colorado Avalanche,2,Central,Western,74,2,138,0.5362318840579711,87,-13,74,0
2015-16,2016-03-13,Colorado Avalanche,0,Central,Western,74,2,140,0.5285714285714286,88,-14,74,0
2015-16,2016-03-17,Colorado Avalanche,2,Central,Western,76,2,142,0.5352112676056338,88,-12,76,0
2015-16,2016-03-19,Colorado Avalanche,2,Central,Western,78,2,144,0.5416666666666666,90,-12,78,0
2015-16,2016-03-21,Colorado Avalanche,2,Central,Western,80,2,146,0.547945205479452,91,-11,80,0
2015-16,2016-03-25,Colorado Avalanche,0,Central,Western,80,2,148,0.5405405405405406,91,-11,83,-3
2015-16,2016-03-26,Colorado Avalanche,0,Central,Western,80,2,150,0.5333333333333333,91,-11,85,-5
2015-16,2016-03-29,Colorado Avalanche,2,Central,Western,82,2,152,0.5394736842105263,95,-13,85,-3
2015-16,2016-03-30,Colorado Avalanche,0,Central,Western,82,2,154,0.5324675324675324,95,-13,87,-5
2015-16,2016-04-02,Colorado Avalanche,0,Central,Western,82,2,156,0.5256410256410257,97,-15,87,-5
2015-16,2016-04-04,Colorado Avalanche,0,Central,Western,82,2,158,0.5189873417721519,99,-17,87,-5
2015-16,2016-04-06,Colorado Avalanche,0,Central,Western,82,2,160,0.5125,101,-19,87,-5
2015-16,2016-04-08,Colorado Avalanche,0,Central,Western,82,2,162,0.5061728395061729,102,-20,87,-5
2015-16,2016-04-09,Colorado Avalanche,0,Central,Western,82,2,164,0.5,103,-21,87,-5
2015-16,2015-10-09,Columbus Blue Jackets,0,Metropolitan,Eastern,0,2,2,0.0,1,-1,0,0
2015-16,2015-10-10,Columbus Blue Jackets,0,Metropolitan,Eastern,0,2,4,0.0,1,-1,1,-1
2015-16,2015-10-12,Columbus Blue Jackets,0,Metropolitan,Eastern,0,2,6,0.0,3,-3,2,-2
2015-16,2015-10-14,Columbus Blue Jackets,0,Metropolitan,Eastern,0,2,8,0.0,3,-3,3,-3
2015-16,2015-10-16,Columbus Blue Jackets,0,Metropolitan,Eastern,0,2,10,0.0,5,-5,5,-5
2015-16,2015-10-18,Columbus Blue Jackets,0,Metropolitan,Eastern,0,2,12,0.0,6,-6,6,-6
2015-16,2015-10-20,Columbus Blue Jackets,0,Metropolitan,Eastern,0,2,14,0.0,6,-6,6,-6
2015-16,2015-10-23,Columbus Blue Jackets,0,Metropolitan,Eastern,0,2,16,0.0,9,-9,7,-7
2015-16,2015-10-25,Columbus Blue Jackets,2,Metropolitan,Eastern,2,2,18,0.1111111111111111,11,-9,9,-7
2015-16,2015-10-27,Columbus Blue Jackets,2,Metropolitan,Eastern,4,2,20,0.2,12,-8,9,-5
2015-16,2015-10-30,Columbus Blue Jackets,0,Metropolitan,Eastern,4,2,22,0.18181818181818182,14,-10,11,-7
2015-16,2015-10-31,Columbus Blue Jackets,0,Metropolitan,Eastern,4,2,24,0.16666666666666666,15,-11,12,-8
2015-16,2015-11-04,Columbus Blue Jackets,2,Metropolitan,Eastern,6,2,26,0.23076923076923078,16,-10,13,-7
2015-16,2015-11-06,Columbus Blue Jackets,2,Metropolitan,Eastern,8,2,28,0.2857142857142857,17,-9,13,-5
2015-16,2015-11-07,Columbus Blue Jackets,0,Metropolitan,Eastern,8,2,30,0.26666666666666666,18,-10,15,-7
2015-16,2015-11-11,Columbus Blue Jackets,0,Metropolitan,Eastern,8,2,32,0.25,19,-11,17,-9
2015-16,2015-11-14,Columbus Blue Jackets,2,Metropolitan,Eastern,10,2,34,0.29411764705882354,21,-11,18,-8
2015-16,2015-11-15,Columbus Blue Jackets,2,Metropolitan,Eastern,12,2,36,0.3333333333333333,21,-9,19,-7
2015-16,2015-11-18,Columbus Blue Jackets,2,Metropolitan,Eastern,14,2,38,0.3684210526315789,23,-9,19,-5
2015-16,2015-11-20,Columbus Blue Jackets,0,Metropolitan,Eastern,14,2,40,0.35,24,-10,21,-7
2015-16,2015-11-21,Columbus Blue Jackets,2,Metropolitan,Eastern,16,2,42,0.38095238095238093,24,-8,21,-5
2015-16,2015-11-22,Columbus Blue Jackets,0,Metropolitan,Eastern,16,2,44,0.36363636363636365,24,-8,23,-7
2015-16,2015-11-26,Columbus Blue Jackets,2,Metropolitan,Eastern,18,2,46,0.391304347826087,26,-8,25,-7
2015-16,2015-11-28,Columbus Blue Jackets,2,Metropolitan,Eastern,20,2,48,0.4166666666666667,27,-7,26,-6
2015-16,2015-11-29,Columbus Blue Jackets,0,Metropolitan,Eastern,20,2,50,0.4,28,-8,27,-7
2015-16,2015-12-02,Columbus Blue Jackets,0,Metropolitan,Eastern,20,2,52,0.38461538461538464,30,-10,27,-7
2015-16,2015-12-05,Columbus Blue Jackets,1,Metropolitan,Eastern,21,2,54,0.3888888888888889,34,-13,30,-9
2015-16,2015-12-06,Columbus Blue Jackets,2,Metropolitan,Eastern,23,2,56,0.4107142857142857,35,-12,30,-7
2015-16,2015-12-09,Columbus Blue Jackets,1,Metropolitan,Eastern,24,2,58,0.41379310344827586,37,-13,31,-7
2015-16,2015-12-11,Columbus Blue Jackets,0,Metropolitan,Eastern,24,2,60,0.4,37,-13,32,-8
2015-16,2015-12-13,Columbus Blue Jackets,1,Metropolitan,Eastern,25,2,62,0.4032258064516129,39,-14,34,-9
2015-16,2015-12-15,Columbus Blue Jackets,0,Metropolitan,Eastern,25,2,64,0.390625,40,-15,34,-9
2015-16,2015-12-16,Columbus Blue Jackets,0,Metropolitan,Eastern,25,2,66,0.3787878787878788,41,-16,36,-11
2015-16,2015-12-18,Columbus Blue Jackets,2,Metropolitan,Eastern,27,2,68,0.39705882352941174,41,-14,36,-9
2015-16,2015-12-20,Columbus Blue Jackets,2,Metropolitan,Eastern,29,2,70,0.4142857142857143,41,-12,39,-10
2015-16,2015-12-22,Columbus Blue Jackets,0,Metropolitan,Eastern,29,2,72,0.4027777777777778,42,-13,39,-10
2015-16,2015-12-27,Columbus Blue Jackets,0,Metropolitan,Eastern,29,2,74,0.3918918918918919,43,-14,42,-13
2015-16,2015-12-27,Columbus Blue Jackets,0,Metropolitan,Eastern,29,2,76,0.3815789473684211,43,-14,42,-13
2015-16,2015-12-30,Columbus Blue Jackets,2,Metropolitan,Eastern,31,2,78,0.3974358974358974,44,-13,42,-11
2015-16,2016-01-03,Columbus Blue Jackets,2,Metropolitan,Eastern,33,2,80,0.4125,46,-13,44,-11
2015-16,2016-01-06,Columbus Blue Jackets,0,Metropolitan,Eastern,33,2,82,0.4024390243902439,48,-15,44,-11
2015-16,2016-01-09,Columbus Blue Jackets,0,Metropolitan,Eastern,33,2,84,0.39285714285714285,49,-16,45,-12
2015-16,2016-01-10,Columbus Blue Jackets,1,Metropolitan,Eastern,34,2,86,0.3953488372093023,49,-15,46,-12
2015-16,2016-01-13,Columbus Blue Jackets,0,Metropolitan,Eastern,34,2,88,0.38636363636363635,51,-17,47,-13
2015-16,2016-01-14,Columbus Blue Jackets,2,Metropolitan,Eastern,36,2,90,0.4,51,-15,47,-11
2015-16,2016-01-17,Columbus Blue Jackets,2,Metropolitan,Eastern,38,2,92,0.41304347826086957,53,-15,50,-12
2015-16,2016-01-20,Columbus Blue Jackets,0,Metropolitan,Eastern,38,2,94,0.40425531914893614,54,-16,51,-13
2015-16,2016-01-22,Columbus Blue Jackets,0,Metropolitan,Eastern,38,2,96,0.3958333333333333,54,-16,53,-15
2015-16,2016-01-24,Columbus Blue Jackets,1,Metropolitan,Eastern,39,2,98,0.3979591836734694,56,-17,55,-16
2015-16,2016-01-26,Columbus Blue Jackets,2,Metropolitan,Eastern,41,2,100,0.41,56,-15,55,-14
2015-16,2016-01-27,Columbus Blue Jackets,2,Metropolitan,Eastern,43,2,102,0.4215686274509804,56,-13,55,-12
2015-16,2016-02-03,Columbus Blue Jackets,0,Metropolitan,Eastern,43,2,104,0.41346153846153844,58,-15,57,-14
2015-16,2016-02-05,Columbus Blue Jackets,2,Metropolitan,Eastern,45,2,106,0.42452830188679247,58,-13,58,-13
2015-16,2016-02-06,Columbus Blue Jackets,2,Metropolitan,Eastern,47,2,108,0.4351851851851852,59,-12,58,-11
2015-16,2016-02-10,Columbus Blue Jackets,1,Metropolitan,Eastern,48,2,110,0.43636363636363634,62,-14,61,-13
2015-16,2016-02-12,Columbus Blue Jackets,2,Metropolitan,Eastern,50,2,112,0.44642857142857145,64,-14,61,-11
2015-16,2016-02-14,Columbus Blue Jackets,2,Metropolitan,Eastern,52,2,114,0.45614035087719296,65,-13,64,-12
2015-16,2016-02-17,Columbus Blue Jackets,1,Metropolitan,Eastern,53,2,116,0.45689655172413796,66,-13,64,-11
2015-16,2016-02-20,Columbus Blue Jackets,0,Metropolitan,Eastern,53,2,118,0.4491525423728814,69,-16,66,-13
2015-16,2016-02-23,Columbus Blue Jackets,2,Metropolitan,Eastern,55,2,120,0.4583333333333333,69,-14,68,-13
2015-16,2016-02-24,Columbus Blue Jackets,1,Metropolitan,Eastern,56,2,122,0.45901639344262296,71,-15,68,-12
2015-16,2016-02-26,Columbus Blue Jackets,2,Metropolitan,Eastern,58,2,124,0.46774193548387094,73,-15,68,-10
2015-16,2016-02-27,Columbus Blue Jackets,2,Metropolitan,Eastern,60,2,126,0.47619047619047616,73,-13,70,-10
2015-16,2016-03-01,Columbus Blue Jackets,0,Metropolitan,Eastern,60,2,128,0.46875,73,-13,72,-12
2015-16,2016-03-05,Columbus Blue Jackets,2,Metropolitan,Eastern,62,2,130,0.47692307692307695,77,-15,74,-12
2015-16,2016-03-06,Columbus Blue Jackets,0,Metropolitan,Eastern,62,2,132,0.4696969696969697,79,-17,75,-13
2015-16,2016-03-09,Columbus Blue Jackets,2,Metropolitan,Eastern,64,2,134,0.47761194029850745,81,-17,75,-11
2015-16,2016-03-12,Columbus Blue Jackets,0,Metropolitan,Eastern,64,2,136,0.47058823529411764,82,-18,78,-14
2015-16,2016-03-13,Columbus Blue Jackets,0,Metropolitan,Eastern,64,2,138,0.463768115942029,82,-18,79,-15
2015-16,2016-03-17,Columbus Blue Jackets,0,Metropolitan,Eastern,64,2,140,0.45714285714285713,85,-21,81,-17
2015-16,2016-03-19,Columbus Blue Jackets,2,Metropolitan,Eastern,66,2,142,0.4647887323943662,86,-20,83,-17
2015-16,2016-03-20,Columbus Blue Jackets,0,Metropolitan,Eastern,66,2,144,0.4583333333333333,88,-22,83,-17
2015-16,2016-03-22,Columbus Blue Jackets,2,Metropolitan,Eastern,68,2,146,0.4657534246575342,88,-20,83,-15
2015-16,2016-03-24,Columbus Blue Jackets,0,Metropolitan,Eastern,68,2,148,0.4594594594594595,88,-20,85,-17
2015-16,2016-03-27,Columbus Blue Jackets,0,Metropolitan,Eastern,68,2,150,0.4533333333333333,92,-24,85,-17
2015-16,2016-03-28,Columbus Blue Jackets,0,Metropolitan,Eastern,68,2,152,0.4473684210526316,92,-24,87,-19
2015-16,2016-03-31,Columbus Blue Jackets,0,Metropolitan,Eastern,68,2,154,0.44155844155844154,95,-27,88,-20
2015-16,2016-04-02,Columbus Blue Jackets,2,Metropolitan,Eastern,70,2,156,0.44871794871794873,95,-25,91,-21
2015-16,2016-04-04,Columbus Blue Jackets,0,Metropolitan,Eastern,70,2,158,0.4430379746835443,97,-27,91,-21
2015-16,2016-04-06,Columbus Blue Jackets,2,Metropolitan,Eastern,72,2,160,0.45,99,-27,91,-19
2015-16,2016-04-08,Columbus Blue Jackets,2,Metropolitan,Eastern,74,2,162,0.4567901234567901,99,-25,92,-18
2015-16,2016-04-09,Columbus Blue Jackets,2,Metropolitan,Eastern,76,2,164,0.4634146341463415,101,-25,93,-17
2015-16,2015-10-09,Dallas Stars,2,Central,Western,2,2,2,1.0,2,0,2,0
2015-16,2015-10-11,Dallas Stars,0,Central,Western,2,2,4,0.5,4,-2,2,0
2015-16,2015-10-14,Dallas Stars,2,Central,Western,4,2,6,0.6666666666666666,4,0,4,0
2015-16,2015-10-15,Dallas Stars,2,Central,Western,6,2,8,0.75,6,0,4,2
2015-16,2015-10-17,Dallas Stars,2,Central,Western,8,2,10,0.8,8,0,6,2
2015-16,2015-10-20,Dallas Stars,2,Central,Western,10,2,12,0.8333333333333334,8,2,7,3
2015-16,2015-10-22,Dallas Stars,2,Central,Western,12,2,14,0.8571428571428571,10,2,7,5
2015-16,2015-10-25,Dallas Stars,0,Central,Western,12,2,16,0.75,11,1,9,3
2015-16,2015-10-28,Dallas Stars,2,Central,Western,14,2,18,0.7777777777777778,13,1,11,3
2015-16,2015-10-30,Dallas Stars,2,Central,Western,16,2,20,0.8,15,1,12,4
2015-16,2015-10-31,Dallas Stars,2,Central,Western,18,2,22,0.8181818181818182,16,2,12,6
2015-16,2015-11-03,Dallas Stars,0,Central,Western,18,2,24,0.75,16,2,14,4
2015-16,2015-11-04,Dallas Stars,2,Central,Western,20,2,26,0.7692307692307693,16,4,14,6
2015-16,2015-11-07,Dallas Stars,2,Central,Western,22,2,28,0.7857142857142857,18,4,15,7
2015-16,2015-11-08,Dallas Stars,2,Central,Western,24,2,30,0.8,18,6,15,9
2015-16,2015-11-11,Dallas Stars,0,Central,Western,24,2,32,0.75,20,4,17,7
2015-16,2015-11-13,Dallas Stars,2,Central,Western,26,2,34,0.7647058823529411,22,4,18,8
2015-16,2015-11-15,Dallas Stars,2,Central,Western,28,2,36,0.7777777777777778,23,5,19,9
2015-16,2015-11-18,Dallas Stars,2,Central,Western,30,2,38,0.7894736842105263,25,5,20,10
2015-16,2015-11-20,Dallas Stars,2,Central,Western,32,2,40,0.8,25,7,21,11
2015-16,2015-11-22,Dallas Stars,2,Central,Western,34,2,42,0.8095238095238095,25,9,22,12
2015-16,2015-11-25,Dallas Stars,0,Central,Western,34,2,44,0.7727272727272727,25,9,22,12
2015-16,2015-11-28,Dallas Stars,2,Central,Western,36,2,46,0.782608695652174,28,8,25,11
2015-16,2015-11-29,Dallas Stars,2,Central,Western,38,2,48,0.7916666666666666,29,9,26,12
2015-16,2015-12-02,Dallas Stars,1,Central,Western,39,2,50,0.78,30,9,27,12
2015-16,2015-12-04,Dallas Stars,2,Central,Western,41,2,52,0.7884615384615384,30,11,27,14
2015-16,2015-12-05,Dallas Stars,1,Central,Western,42,2,54,0.7777777777777778,30,12,28,14
2015-16,2015-12-09,Dallas Stars,2,Central,Western,44,2,56,0.7857142857142857,34,10,28,16
2015-16,2015-12-12,Dallas Stars,2,Central,Western,46,2,58,0.7931034482758621,36,10,30,16
2015-16,2015-12-13,Dallas Stars,0,Central,Western,46,2,60,0.7666666666666667,36,10,30,16
2015-16,2015-12-16,Dallas Stars,2,Central,Western,48,2,62,0.7741935483870968,38,10,31,17
2015-16,2015-12-18,Dallas Stars,0,Central,Western,48,2,64,0.75,40,8,33,15
2015-16,2015-12-20,Dallas Stars,2,Central,Western,50,2,66,0.7575757575757576,42,8,33,17
2015-16,2015-12-22,Dallas Stars,2,Central,Western,52,2,68,0.7647058823529411,44,8,34,18
2015-16,2015-12-23,Dallas Stars,2,Central,Western,54,2,70,0.7714285714285715,44,10,35,19
2015-16,2015-12-27,Dallas Stars,2,Central,Western,56,2,72,0.7777777777777778,44,12,36,20
2015-16,2015-12-27,Dallas Stars,1,Central,Western,57,2,74,0.7702702702702703,44,13,36,21
2015-16,2015-12-30,Dallas Stars,0,Central,Western,57,2,76,0.75,46,11,37,20
2015-16,2016-01-01,Dallas Stars,2,Central,Western,59,2,78,0.7564102564102564,48,11,39,20
2015-16,2016-01-03,Dallas Stars,1,Central,Western,60,2,80,0.75,48,12,39,21
2015-16,2016-01-03,Dallas Stars,0,Central,Western,60,2,82,0.7317073170731707,48,12,39,21
2015-16,2016-01-06,Dallas Stars,0,Central,Western,60,2,84,0.7142857142857143,51,9,41,19
2015-16,2016-01-08,Dallas Stars,2,Central,Western,62,2,86,0.7209302325581395,52,10,43,19
2015-16,2016-01-10,Dallas Stars,0,Central,Western,62,2,88,0.7045454545454546,55,7,45,17
2015-16,2016-01-16,Dallas Stars,0,Central,Western,62,2,90,0.6888888888888889,57,5,46,16
2015-16,2016-01-17,Dallas Stars,1,Central,Western,63,2,92,0.6847826086956522,59,4,48,15
2015-16,2016-01-20,Dallas Stars,0,Central,Western,63,2,94,0.6702127659574468,61,2,49,14
2015-16,2016-01-22,Dallas Stars,2,Central,Western,65,2,96,0.6770833333333334,63,2,51,14
2015-16,2016-01-24,Dallas Stars,0,Central,Western,65,2,98,0.6632653061224489,64,1,52,13
2015-16,2016-01-26,Dallas Stars,2,Central,Western,67,2,100,0.67,64,3,53,14
2015-16,2016-02-03,Dallas Stars,2,Central,Western,69,2,102,0.6764705882352942,66,3,55,14
2015-16,2016-02-05,Dallas Stars,2,Central,Western,71,2,104,0.6826923076923077,66,5,55,16
2015-16,2016-02-07,Dallas Stars,0,Central,Western,71,2,106,0.6698113207547169,68,3,57,14
2015-16,2016-02-10,Dallas Stars,2,Central,Western,73,2,108,0.6759259259259259,69,4,58,15
2015-16,2016-02-12,Dallas Stars,2,Central,Western,75,2,110,0.6818181818181818,69,6,58,17
2015-16,2016-02-14,Dallas Stars,2,Central,Western,77,2,112,0.6875,73,4,61,16
2015-16,2016-02-16,Dallas Stars,2,Central,Western,79,2,114,0.6929824561403509,73,6,62,17
2015-16,2016-02-17,Dallas Stars,1,Central,Western,80,2,116,0.6896551724137931,75,5,62,18
2015-16,2016-02-19,Dallas Stars,0,Central,Western,80,2,118,0.6779661016949152,77,3,64,16
2015-16,2016-02-21,Dallas Stars,0,Central,Western,80,2,120,0.6666666666666666,79,1,65,15
2015-16,2016-02-24,Dallas Stars,2,Central,Western,82,2,122,0.6721311475409836,79,3,66,16
2015-16,2016-02-26,Dallas Stars,0,Central,Western,82,2,124,0.6612903225806451,79,3,68,14
2015-16,2016-02-27,Dallas Stars,0,Central,Western,82,2,126,0.6507936507936508,79,3,68,14
2015-16,2016-03-01,Dallas Stars,1,Central,Western,83,2,128,0.6484375,81,2,68,15
2015-16,2016-03-02,Dallas Stars,0,Central,Western,83,2,130,0.6384615384615384,83,0,68,15
2015-16,2016-03-05,Dallas Stars,2,Central,Western,85,2,132,0.6439393939393939,83,2,72,13
2015-16,2016-03-06,Dallas Stars,2,Central,Western,87,2,134,0.6492537313432836,83,4,72,15
2015-16,2016-03-09,Dallas Stars,1,Central,Western,88,2,136,0.6470588235294118,85,3,72,16
2015-16,2016-03-12,Dallas Stars,2,Central,Western,90,2,138,0.6521739130434783,88,2,74,16
2015-16,2016-03-13,Dallas Stars,1,Central,Western,91,2,140,0.65,88,3,74,17
2015-16,2016-03-16,Dallas Stars,0,Central,Western,91,2,142,0.6408450704225352,88,3,75,16
2015-16,2016-03-18,Dallas Stars,2,Central,Western,93,2,144,0.6458333333333334,88,5,76,17
2015-16,2016-03-20,Dallas Stars,2,Central,Western,95,2,146,0.6506849315068494,90,5,78,17
2015-16,2016-03-23,Dallas Stars,2,Central,Western,97,2,148,0.6554054054054054,91,6,81,16
2015-16,2016-03-25,Dallas Stars,0,Central,Western,97,2,150,0.6466666666666666,91,6,83,14
2015-16,2016-03-26,Dallas Stars,2,Central,Western,99,2,152,0.6513157894736842,91,8,85,14
2015-16,2016-03-30,Dallas Stars,2,Central,Western,101,2,154,0.6558441558441559,95,6,87,14
2015-16,2016-04-01,Dallas Stars,2,Central,Western,103,2,156,0.6602564102564102,95,8,87,16
2015-16,2016-04-02,Dallas Stars,2,Central,Western,105,2,158,0.6645569620253164,97,8,87,18
2015-16,2016-04-04,Dallas Stars,0,Central,Western,105,2,160,0.65625,99,6,87,18
2015-16,2016-04-08,Dallas Stars,2,Central,Western,107,2,162,0.6604938271604939,102,5,87,20
2015-16,2016-04-10,Dallas Stars,2,Central,Western,109,2,164,0.6646341463414634,103,6,87,22
2015-16,2015-10-09,Detroit Red Wings,2,Atlantic,Eastern,2,2,2,1.0,2,0,0,2
2015-16,2015-10-10,Detroit Red Wings,2,Atlantic,Eastern,4,2,4,1.0,4,0,1,3
2015-16,2015-10-13,Detroit Red Wings,2,Atlantic,Eastern,6,2,6,1.0,6,0,3,3
2015-16,2015-10-16,Detroit Red Wings,0,Atlantic,Eastern,6,2,8,0.75,6,0,5,1
2015-16,2015-10-17,Detroit Red Wings,0,Atlantic,Eastern,6,2,10,0.6,7,-1,6,0
2015-16,2015-10-22,Detroit Red Wings,0,Atlantic,Eastern,6,2,12,0.5,8,-2,7,-1
2015-16,2015-10-24,Detroit Red Wings,1,Atlantic,Eastern,7,2,14,0.5,8,-1,8,-1
2015-16,2015-10-25,Detroit Red Wings,2,Atlantic,Eastern,9,2,16,0.5625,9,0,9,0
2015-16,2015-10-27,Detroit Red Wings,0,Atlantic,Eastern,9,2,18,0.5,11,-2,9,0
2015-16,2015-10-30,Detroit Red Wings,0,Atlantic,Eastern,9,2,20,0.45,12,-3,11,-2
2015-16,2015-10-31,Detroit Red Wings,2,Atlantic,Eastern,11,2,22,0.5,12,-1,12,-1
2015-16,2015-11-04,Detroit Red Wings,2,Atlantic,Eastern,13,2,24,0.5416666666666666,14,-1,13,0
2015-16,2015-11-07,Detroit Red Wings,2,Atlantic,Eastern,15,2,26,0.5769230769230769,16,-1,15,0
2015-16,2015-11-08,Detroit Red Wings,0,Atlantic,Eastern,15,2,28,0.5357142857142857,16,-1,16,-1
2015-16,2015-11-11,Detroit Red Wings,2,Atlantic,Eastern,17,2,30,0.5666666666666667,17,0,17,0
2015-16,2015-11-14,Detroit Red Wings,0,Atlantic,Eastern,17,2,32,0.53125,18,-1,18,-1
2015-16,2015-11-15,Detroit Red Wings,0,Atlantic,Eastern,17,2,34,0.5,19,-2,19,-2
2015-16,2015-11-17,Detroit Red Wings,2,Atlantic,Eastern,19,2,36,0.5277777777777778,19,0,19,0
2015-16,2015-11-19,Detroit Red Wings,1,Atlantic,Eastern,20,2,38,0.5263157894736842,20,0,20,0
2015-16,2015-11-21,Detroit Red Wings,2,Atlantic,Eastern,22,2,40,0.55,22,0,21,1
2015-16,2015-11-22,Detroit Red Wings,2,Atlantic,Eastern,24,2,42,0.5714285714285714,24,0,23,1
2015-16,2015-11-26,Detroit Red Wings,1,Atlantic,Eastern,25,2,44,0.5681818181818182,25,0,25,0
2015-16,2015-11-28,Detroit Red Wings,2,Atlantic,Eastern,27,2,46,0.5869565217391305,27,0,26,1
2015-16,2015-11-29,Detroit Red Wings,1,Atlantic,Eastern,28,2,48,0.5833333333333334,28,0,27,1
2015-16,2015-12-02,Detroit Red Wings,2,Atlantic,Eastern,30,2,50,0.6,29,1,27,3
2015-16,2015-12-04,Detroit Red Wings,2,Atlantic,Eastern,32,2,52,0.6153846153846154,31,1,28,4
2015-16,2015-12-06,Detroit Red Wings,2,Atlantic,Eastern,34,2,54,0.6296296296296297,33,1,30,4
2015-16,2015-12-09,Detroit Red Wings,1,Atlantic,Eastern,35,2,56,0.625,35,0,31,4
2015-16,2015-12-11,Detroit Red Wings,2,Atlantic,Eastern,37,2,58,0.6379310344827587,35,2,32,5
2015-16,2015-12-12,Detroit Red Wings,1,Atlantic,Eastern,38,2,60,0.6333333333333333,35,3,34,4
2015-16,2015-12-15,Detroit Red Wings,0,Atlantic,Eastern,38,2,62,0.6129032258064516,37,1,34,4
2015-16,2015-12-19,Detroit Red Wings,1,Atlantic,Eastern,39,2,64,0.609375,39,0,38,1
2015-16,2015-12-21,Detroit Red Wings,2,Atlantic,Eastern,41,2,66,0.6212121212121212,41,0,39,2
2015-16,2015-12-23,Detroit Red Wings,0,Atlantic,Eastern,41,2,68,0.6029411764705882,42,-1,40,1
2015-16,2015-12-27,Detroit Red Wings,2,Atlantic,Eastern,43,2,70,0.6142857142857143,43,0,42,1
2015-16,2015-12-29,Detroit Red Wings,0,Atlantic,Eastern,43,2,72,0.5972222222222222,43,0,42,1
2015-16,2015-12-30,Detroit Red Wings,0,Atlantic,Eastern,43,2,74,0.581081081081081,44,-1,42,1
2015-16,2015-12-31,Detroit Red Wings,0,Atlantic,Eastern,43,2,76,0.5657894736842105,44,-1,43,0
2015-16,2016-01-02,Detroit Red Wings,2,Atlantic,Eastern,45,2,78,0.5769230769230769,45,0,43,2
2015-16,2016-01-05,Detroit Red Wings,2,Atlantic,Eastern,47,2,80,0.5875,47,0,44,3
2015-16,2016-01-08,Detroit Red Wings,2,Atlantic,Eastern,49,2,82,0.5975609756097561,49,0,44,5
2015-16,2016-01-11,Detroit Red Wings,2,Atlantic,Eastern,51,2,84,0.6071428571428571,49,2,47,4
2015-16,2016-01-12,Detroit Red Wings,0,Atlantic,Eastern,51,2,86,0.5930232558139535,49,2,47,4
2015-16,2016-01-15,Detroit Red Wings,2,Atlantic,Eastern,53,2,88,0.6022727272727273,49,4,47,6
2015-16,2016-01-18,Detroit Red Wings,1,Atlantic,Eastern,54,2,90,0.6,52,2,50,4
2015-16,2016-01-21,Detroit Red Wings,0,Atlantic,Eastern,54,2,92,0.5869565217391305,54,0,51,3
2015-16,2016-01-23,Detroit Red Wings,2,Atlantic,Eastern,56,2,94,0.5957446808510638,56,0,53,3
2015-16,2016-01-24,Detroit Red Wings,0,Atlantic,Eastern,56,2,96,0.5833333333333334,56,0,55,1
2015-16,2016-01-26,Detroit Red Wings,2,Atlantic,Eastern,58,2,98,0.5918367346938775,57,1,55,3
2015-16,2016-02-04,Detroit Red Wings,0,Atlantic,Eastern,58,2,100,0.58,58,0,57,1
2015-16,2016-02-05,Detroit Red Wings,0,Atlantic,Eastern,58,2,102,0.5686274509803921,60,-2,58,0
2015-16,2016-02-06,Detroit Red Wings,2,Atlantic,Eastern,60,2,104,0.5769230769230769,60,0,58,2
2015-16,2016-02-09,Detroit Red Wings,2,Atlantic,Eastern,62,2,106,0.5849056603773585,62,0,60,2
2015-16,2016-02-11,Detroit Red Wings,2,Atlantic,Eastern,64,2,108,0.5925925925925926,62,2,61,3
2015-16,2016-02-13,Detroit Red Wings,1,Atlantic,Eastern,65,2,110,0.5909090909090909,65,0,63,2
2015-16,2016-02-14,Detroit Red Wings,2,Atlantic,Eastern,67,2,112,0.5982142857142857,66,1,64,3
2015-16,2016-02-15,Detroit Red Wings,0,Atlantic,Eastern,67,2,114,0.5877192982456141,66,1,64,3
2015-16,2016-02-19,Detroit Red Wings,0,Atlantic,Eastern,67,2,116,0.5775862068965517,67,0,66,1
2015-16,2016-02-21,Detroit Red Wings,1,Atlantic,Eastern,68,2,118,0.576271186440678,68,0,68,0
2015-16,2016-02-22,Detroit Red Wings,1,Atlantic,Eastern,69,2,120,0.575,70,-1,68,1
2015-16,2016-02-24,Detroit Red Wings,2,Atlantic,Eastern,71,2,122,0.5819672131147541,71,0,68,3
2015-16,2016-02-28,Detroit Red Wings,2,Atlantic,Eastern,73,2,124,0.5887096774193549,74,-1,70,3
2015-16,2016-03-01,Detroit Red Wings,2,Atlantic,Eastern,75,2,126,0.5952380952380952,75,0,72,3
2015-16,2016-03-03,Detroit Red Wings,0,Atlantic,Eastern,75,2,128,0.5859375,76,-1,72,3
2015-16,2016-03-06,Detroit Red Wings,0,Atlantic,Eastern,75,2,130,0.5769230769230769,79,-4,75,0
2015-16,2016-03-09,Detroit Red Wings,0,Atlantic,Eastern,75,2,132,0.5681818181818182,81,-6,75,0
2015-16,2016-03-11,Detroit Red Wings,2,Atlantic,Eastern,77,2,134,0.5746268656716418,83,-6,76,1
2015-16,2016-03-12,Detroit Red Wings,2,Atlantic,Eastern,79,2,136,0.5808823529411765,83,-4,78,1
2015-16,2016-03-13,Detroit Red Wings,0,Atlantic,Eastern,79,2,138,0.572463768115942,85,-6,79,0
2015-16,2016-03-15,Detroit Red Wings,0,Atlantic,Eastern,79,2,140,0.5642857142857143,85,-6,79,0
2015-16,2016-03-17,Detroit Red Wings,2,Atlantic,Eastern,81,2,142,0.5704225352112676,85,-4,81,0
2015-16,2016-03-19,Detroit Red Wings,2,Atlantic,Eastern,83,2,144,0.5763888888888888,85,-2,83,0
2015-16,2016-03-22,Detroit Red Wings,0,Atlantic,Eastern,83,2,146,0.5684931506849316,86,-3,83,0
2015-16,2016-03-24,Detroit Red Wings,2,Atlantic,Eastern,85,2,148,0.5743243243243243,86,-1,85,0
2015-16,2016-03-26,Detroit Red Wings,0,Atlantic,Eastern,85,2,150,0.5666666666666667,88,-3,85,0
2015-16,2016-03-28,Detroit Red Wings,2,Atlantic,Eastern,87,2,152,0.5723684210526315,88,-1,87,0
2015-16,2016-03-29,Detroit Red Wings,0,Atlantic,Eastern,87,2,154,0.564935064935065,88,-1,87,0
2015-16,2016-04-01,Detroit Red Wings,2,Atlantic,Eastern,89,2,156,0.5705128205128205,89,0,89,0
2015-16,2016-04-02,Detroit Red Wings,2,Atlantic,Eastern,91,2,158,0.5759493670886076,91,0,91,0
2015-16,2016-04-07,Detroit Red Wings,0,Atlantic,Eastern,91,2,160,0.56875,93,-2,93,-2
2015-16,2016-04-07,Detroit Red Wings,2,Atlantic,Eastern,93,2,162,0.5740740740740741,93,0,93,0
2015-16,2016-04-09,Detroit Red Wings,0,Atlantic,Eastern,93,2,164,0.5670731707317073,93,0,93,0
2015-16,2015-10-09,Edmonton Oilers,0,Pacific,Western,0,2,2,0.0,0,0,2,-2
2015-16,2015-10-10,Edmonton Oilers,0,Pacific,Western,0,2,4,0.0,2,-2,2,-2
2015-16,2015-10-14,Edmonton Oilers,0,Pacific,Western,0,2,6,0.0,4,-4,4,-4
2015-16,2015-10-16,Edmonton Oilers,0,Pacific,Western,0,2,8,0.0,6,-6,6,-6
2015-16,2015-10-18,Edmonton Oilers,2,Pacific,Western,2,2,10,0.2,6,-4,6,-4
2015-16,2015-10-19,Edmonton Oilers,2,Pacific,Western,4,2,12,0.3333333333333333,6,-2,6,-2
2015-16,2015-10-22,Edmonton Oilers,2,Pacific,Western,6,2,14,0.42857142857142855,7,-1,7,-1
2015-16,2015-10-24,Edmonton Oilers,0,Pacific,Western,6,2,16,0.375,8,-2,8,-2
2015-16,2015-10-26,Edmonton Oilers,0,Pacific,Western,6,2,18,0.3333333333333333,10,-4,10,-4
2015-16,2015-10-28,Edmonton Oilers,0,Pacific,Western,6,2,20,0.3,11,-5,11,-5
2015-16,2015-10-30,Edmonton Oilers,2,Pacific,Western,8,2,22,0.36363636363636365,11,-3,12,-4
2015-16,2015-11-01,Edmonton Oilers,0,Pacific,Western,8,2,24,0.3333333333333333,12,-4,12,-4
2015-16,2015-11-04,Edmonton Oilers,2,Pacific,Western,10,2,26,0.38461538461538464,12,-2,14,-4
2015-16,2015-11-07,Edmonton Oilers,0,Pacific,Western,10,2,28,0.35714285714285715,14,-4,15,-5
2015-16,2015-11-09,Edmonton Oilers,0,Pacific,Western,10,2,30,0.3333333333333333,14,-4,17,-7
2015-16,2015-11-12,Edmonton Oilers,2,Pacific,Western,12,2,32,0.375,17,-5,17,-5
2015-16,2015-11-13,Edmonton Oilers,0,Pacific,Western,12,2,34,0.35294117647058826,19,-7,18,-6
2015-16,2015-11-15,Edmonton Oilers,0,Pacific,Western,12,2,36,0.3333333333333333,19,-7,19,-7
2015-16,2015-11-19,Edmonton Oilers,1,Pacific,Western,13,2,38,0.34210526315789475,20,-7,20,-7
2015-16,2015-11-21,Edmonton Oilers,2,Pacific,Western,15,2,40,0.375,21,-6,21,-6
2015-16,2015-11-24,Edmonton Oilers,0,Pacific,Western,15,2,42,0.35714285714285715,22,-7,22,-7
2015-16,2015-11-26,Edmonton Oilers,0,Pacific,Western,15,2,44,0.3409090909090909,24,-9,24,-9
2015-16,2015-11-28,Edmonton Oilers,1,Pacific,Western,16,2,46,0.34782608695652173,25,-9,25,-9
2015-16,2015-11-29,Edmonton Oilers,2,Pacific,Western,18,2,48,0.375,27,-9,26,-8
2015-16,2015-12-01,Edmonton Oilers,0,Pacific,Western,18,2,50,0.36,27,-9,26,-8
2015-16,2015-12-03,Edmonton Oilers,2,Pacific,Western,20,2,52,0.38461538461538464,27,-7,27,-7
2015-16,2015-12-05,Edmonton Oilers,2,Pacific,Western,22,2,54,0.4074074074074074,27,-5,28,-6
2015-16,2015-12-07,Edmonton Oilers,2,Pacific,Western,24,2,56,0.42857142857142855,27,-3,28,-4
2015-16,2015-12-10,Edmonton Oilers,2,Pacific,Western,26,2,58,0.4482758620689655,29,-3,29,-3
2015-16,2015-12-12,Edmonton Oilers,2,Pacific,Western,28,2,60,0.4666666666666667,29,-1,30,-2
2015-16,2015-12-15,Edmonton Oilers,2,Pacific,Western,30,2,62,0.4838709677419355,30,0,30,0
2015-16,2015-12-16,Edmonton Oilers,0,Pacific,Western,30,2,64,0.46875,30,0,31,-1
2015-16,2015-12-18,Edmonton Oilers,0,Pacific,Western,30,2,66,0.45454545454545453,32,-2,33,-3
2015-16,2015-12-20,Edmonton Oilers,0,Pacific,Western,30,2,68,0.4411764705882353,33,-3,33,-3
2015-16,2015-12-22,Edmonton Oilers,2,Pacific,Western,32,2,70,0.45714285714285713,33,-1,34,-2
2015-16,2015-12-27,Edmonton Oilers,1,Pacific,Western,33,2,72,0.4583333333333333,36,-3,36,-3
2015-16,2015-12-28,Edmonton Oilers,0,Pacific,Western,33,2,74,0.44594594594594594,37,-4,37,-4
2015-16,2015-12-30,Edmonton Oilers,0,Pacific,Western,33,2,76,0.4342105263157895,37,-4,37,-4
2015-16,2016-01-01,Edmonton Oilers,0,Pacific,Western,33,2,78,0.4230769230769231,38,-5,39,-6
2015-16,2016-01-02,Edmonton Oilers,2,Pacific,Western,35,2,80,0.4375,39,-4,39,-4
2015-16,2016-01-05,Edmonton Oilers,2,Pacific,Western,37,2,82,0.45121951219512196,39,-2,41,-4
2015-16,2016-01-09,Edmonton Oilers,0,Pacific,Western,37,2,84,0.44047619047619047,41,-4,44,-7
2015-16,2016-01-11,Edmonton Oilers,0,Pacific,Western,37,2,86,0.43023255813953487,42,-5,45,-8
2015-16,2016-01-13,Edmonton Oilers,1,Pacific,Western,38,2,88,0.4318181818181818,44,-6,45,-7
2015-16,2016-01-15,Edmonton Oilers,1,Pacific,Western,39,2,90,0.43333333333333335,46,-7,46,-7
2015-16,2016-01-17,Edmonton Oilers,2,Pacific,Western,41,2,92,0.44565217391304346,48,-7,48,-7
2015-16,2016-01-19,Edmonton Oilers,2,Pacific,Western,43,2,94,0.4574468085106383,49,-6,49,-6
2015-16,2016-01-20,Edmonton Oilers,0,Pacific,Western,43,2,96,0.4479166666666667,49,-6,49,-6
2015-16,2016-01-22,Edmonton Oilers,0,Pacific,Western,43,2,98,0.4387755102040816,51,-8,51,-8
2015-16,2016-01-24,Edmonton Oilers,0,Pacific,Western,43,2,100,0.43,51,-8,52,-9
2015-16,2016-02-03,Edmonton Oilers,2,Pacific,Western,45,2,102,0.4411764705882353,53,-8,55,-10
2015-16,2016-02-05,Edmonton Oilers,2,Pacific,Western,47,2,104,0.4519230769230769,55,-8,55,-8
2015-16,2016-02-06,Edmonton Oilers,0,Pacific,Western,47,2,106,0.44339622641509435,57,-10,56,-9
2015-16,2016-02-07,Edmonton Oilers,0,Pacific,Western,47,2,108,0.4351851851851852,57,-10,57,-10
2015-16,2016-02-10,Edmonton Oilers,0,Pacific,Western,47,2,110,0.42727272727272725,59,-12,58,-11
2015-16,2016-02-12,Edmonton Oilers,2,Pacific,Western,49,2,112,0.4375,60,-11,58,-9
2015-16,2016-02-14,Edmonton Oilers,1,Pacific,Western,50,2,114,0.43859649122807015,62,-12,61,-11
2015-16,2016-02-17,Edmonton Oilers,0,Pacific,Western,50,2,116,0.43103448275862066,65,-15,62,-12
2015-16,2016-02-19,Edmonton Oilers,0,Pacific,Western,50,2,118,0.423728813559322,67,-17,64,-14
2015-16,2016-02-21,Edmonton Oilers,0,Pacific,Western,50,2,120,0.4166666666666667,67,-17,65,-15
2015-16,2016-02-24,Edmonton Oilers,0,Pacific,Western,50,2,122,0.4098360655737705,69,-19,66,-16
2015-16,2016-02-26,Edmonton Oilers,0,Pacific,Western,50,2,124,0.4032258064516129,70,-20,68,-18
2015-16,2016-02-27,Edmonton Oilers,1,Pacific,Western,51,2,126,0.40476190476190477,70,-19,68,-17
2015-16,2016-02-29,Edmonton Oilers,2,Pacific,Western,53,2,128,0.4140625,72,-19,68,-15
2015-16,2016-03-02,Edmonton Oilers,2,Pacific,Western,55,2,130,0.4230769230769231,74,-19,68,-13
2015-16,2016-03-04,Edmonton Oilers,2,Pacific,Western,57,2,132,0.4318181818181818,76,-19,70,-13
2015-16,2016-03-05,Edmonton Oilers,0,Pacific,Western,57,2,134,0.4253731343283582,76,-19,72,-15
2015-16,2016-03-07,Edmonton Oilers,2,Pacific,Western,59,2,136,0.4338235294117647,76,-17,72,-13
2015-16,2016-03-09,Edmonton Oilers,0,Pacific,Western,59,2,138,0.427536231884058,80,-21,72,-13
2015-16,2016-03-11,Edmonton Oilers,2,Pacific,Western,61,2,140,0.4357142857142857,80,-19,74,-13
2015-16,2016-03-13,Edmonton Oilers,0,Pacific,Western,61,2,142,0.4295774647887324,82,-21,74,-13
2015-16,2016-03-15,Edmonton Oilers,0,Pacific,Western,61,2,144,0.4236111111111111,82,-21,75,-14
2015-16,2016-03-17,Edmonton Oilers,2,Pacific,Western,63,2,146,0.4315068493150685,84,-21,76,-13
2015-16,2016-03-19,Edmonton Oilers,2,Pacific,Western,65,2,148,0.4391891891891892,86,-21,78,-13
2015-16,2016-03-21,Edmonton Oilers,0,Pacific,Western,65,2,150,0.43333333333333335,88,-23,80,-15
2015-16,2016-03-23,Edmonton Oilers,0,Pacific,Western,65,2,152,0.4276315789473684,88,-23,81,-16
2015-16,2016-03-25,Edmonton Oilers,2,Pacific,Western,67,2,154,0.43506493506493504,88,-21,83,-16
2015-16,2016-03-27,Edmonton Oilers,0,Pacific,Western,67,2,156,0.42948717948717946,88,-21,85,-18
2015-16,2016-03-29,Edmonton Oilers,0,Pacific,Western,67,2,158,0.4240506329113924,90,-23,85,-18
2015-16,2016-04-03,Edmonton Oilers,0,Pacific,Western,67,2,160,0.41875,94,-27,87,-20
2015-16,2016-04-06,Edmonton Oilers,2,Pacific,Western,69,2,162,0.42592592592592593,96,-27,87,-18
2015-16,2016-04-10,Edmonton Oilers,1,Pacific,Western,70,2,164,0.4268292682926829,98,-28,87,-17
2015-16,2015-10-10,Florida Panthers,2,Atlantic,Eastern,2,2,2,1.0,4,-2,1,1
2015-16,2015-10-12,Florida Panthers,0,Atlantic,Eastern,2,2,4,0.5,4,-2,2,0
2015-16,2015-10-13,Florida Panthers,2,Atlantic,Eastern,4,2,6,0.6666666666666666,6,-2,3,1
2015-16,2015-10-15,Florida Panthers,2,Atlantic,Eastern,6,2,8,0.75,6,0,5,1
2015-16,2015-10-17,Florida Panthers,0,Atlantic,Eastern,6,2,10,0.6,7,-1,6,0
2015-16,2015-10-20,Florida Panthers,1,Atlantic,Eastern,7,2,12,0.5833333333333334,7,0,6,1
2015-16,2015-10-23,Florida Panthers,0,Atlantic,Eastern,7,2,14,0.5,8,-1,7,0
2015-16,2015-10-25,Florida Panthers,2,Atlantic,Eastern,9,2,16,0.5625,9,0,9,0
2015-16,2015-10-27,Florida Panthers,2,Atlantic,Eastern,11,2,18,0.6111111111111112,11,0,9,2
2015-16,2015-10-30,Florida Panthers,0,Atlantic,Eastern,11,2,20,0.55,12,-1,11,0
2015-16,2015-10-31,Florida Panthers,1,Atlantic,Eastern,12,2,22,0.5454545454545454,12,0,12,0
2015-16,2015-11-05,Florida Panthers,1,Atlantic,Eastern,13,2,24,0.5416666666666666,14,-1,13,0
2015-16,2015-11-06,Florida Panthers,0,Atlantic,Eastern,13,2,26,0.5,16,-3,13,0
2015-16,2015-11-07,Florida Panthers,0,Atlantic,Eastern,13,2,28,0.4642857142857143,16,-3,15,-2
2015-16,2015-11-11,Florida Panthers,2,Atlantic,Eastern,15,2,30,0.5,17,-2,17,-2
2015-16,2015-11-13,Florida Panthers,0,Atlantic,Eastern,15,2,32,0.46875,18,-3,18,-3
2015-16,2015-11-15,Florida Panthers,2,Atlantic,Eastern,17,2,34,0.5,19,-2,19,-2
2015-16,2015-11-17,Florida Panthers,2,Atlantic,Eastern,19,2,36,0.5277777777777778,19,0,19,0
2015-16,2015-11-20,Florida Panthers,0,Atlantic,Eastern,19,2,38,0.5,21,-2,21,-2
2015-16,2015-11-22,Florida Panthers,1,Atlantic,Eastern,20,2,40,0.5,24,-4,23,-3
2015-16,2015-11-24,Florida Panthers,0,Atlantic,Eastern,20,2,42,0.47619047619047616,24,-4,23,-3
2015-16,2015-11-28,Florida Panthers,2,Atlantic,Eastern,22,2,44,0.5,27,-5,26,-4
2015-16,2015-11-29,Florida Panthers,2,Atlantic,Eastern,24,2,46,0.5217391304347826,28,-4,27,-3
2015-16,2015-12-02,Florida Panthers,2,Atlantic,Eastern,26,2,48,0.5416666666666666,29,-3,27,-1
2015-16,2015-12-04,Florida Panthers,2,Atlantic,Eastern,28,2,50,0.56,31,-3,28,0
2015-16,2015-12-05,Florida Panthers,2,Atlantic,Eastern,30,2,52,0.5769230769230769,31,-1,30,0
2015-16,2015-12-07,Florida Panthers,0,Atlantic,Eastern,30,2,54,0.5555555555555556,33,-3,31,-1
2015-16,2015-12-09,Florida Panthers,0,Atlantic,Eastern,30,2,56,0.5357142857142857,35,-5,31,-1
2015-16,2015-12-11,Florida Panthers,2,Atlantic,Eastern,32,2,58,0.5517241379310345,35,-3,32,0
2015-16,2015-12-12,Florida Panthers,0,Atlantic,Eastern,32,2,60,0.5333333333333333,35,-3,34,-2
2015-16,2015-12-16,Florida Panthers,2,Atlantic,Eastern,34,2,62,0.5483870967741935,37,-3,36,-2
2015-16,2015-12-18,Florida Panthers,2,Atlantic,Eastern,36,2,64,0.5625,38,-2,36,0
2015-16,2015-12-19,Florida Panthers,2,Atlantic,Eastern,38,2,66,0.5757575757575758,39,-1,38,0
2015-16,2015-12-20,Florida Panthers,2,Atlantic,Eastern,40,2,68,0.5882352941176471,40,0,39,1
2015-16,2015-12-23,Florida Panthers,2,Atlantic,Eastern,42,2,70,0.6,42,0,40,2
2015-16,2015-12-27,Florida Panthers,2,Atlantic,Eastern,44,2,72,0.6111111111111112,43,1,42,2
2015-16,2015-12-30,Florida Panthers,2,Atlantic,Eastern,46,2,74,0.6216216216216216,44,2,42,4
2015-16,2016-01-03,Florida Panthers,2,Atlantic,Eastern,48,2,76,0.631578947368421,45,3,44,4
2015-16,2016-01-03,Florida Panthers,2,Atlantic,Eastern,50,2,78,0.6410256410256411,45,5,44,6
2015-16,2016-01-06,Florida Panthers,2,Atlantic,Eastern,52,2,80,0.65,47,5,44,8
2015-16,2016-01-08,Florida Panthers,2,Atlantic,Eastern,54,2,82,0.6585365853658537,49,5,44,10
2015-16,2016-01-11,Florida Panthers,2,Atlantic,Eastern,56,2,84,0.6666666666666666,49,7,47,9
2015-16,2016-01-12,Florida Panthers,1,Atlantic,Eastern,57,2,86,0.6627906976744186,49,8,47,10
2015-16,2016-01-14,Florida Panthers,0,Atlantic,Eastern,57,2,88,0.6477272727272727,49,8,47,10
2015-16,2016-01-17,Florida Panthers,0,Atlantic,Eastern,57,2,90,0.6333333333333333,52,5,50,7
2015-16,2016-01-19,Florida Panthers,0,Atlantic,Eastern,57,2,92,0.6195652173913043,52,5,50,7
2015-16,2016-01-23,Florida Panthers,2,Atlantic,Eastern,59,2,94,0.6276595744680851,56,3,53,6
2015-16,2016-01-24,Florida Panthers,2,Atlantic,Eastern,61,2,96,0.6354166666666666,56,5,55,6
2015-16,2016-01-27,Florida Panthers,2,Atlantic,Eastern,63,2,98,0.6428571428571429,57,6,55,8
2015-16,2016-02-03,Florida Panthers,2,Atlantic,Eastern,65,2,100,0.65,58,7,57,8
2015-16,2016-02-05,Florida Panthers,2,Atlantic,Eastern,67,2,102,0.6568627450980392,60,7,58,9
2015-16,2016-02-07,Florida Panthers,1,Atlantic,Eastern,68,2,104,0.6538461538461539,62,6,59,9
2015-16,2016-02-09,Florida Panthers,0,Atlantic,Eastern,68,2,106,0.6415094339622641,62,6,60,8
2015-16,2016-02-10,Florida Panthers,2,Atlantic,Eastern,70,2,108,0.6481481481481481,62,8,61,9
2015-16,2016-02-13,Florida Panthers,0,Atlantic,Eastern,70,2,110,0.6363636363636364,65,5,63,7
2015-16,2016-02-14,Florida Panthers,0,Atlantic,Eastern,70,2,112,0.625,66,4,64,6
2015-16,2016-02-16,Florida Panthers,2,Atlantic,Eastern,72,2,114,0.631578947368421,66,6,64,8
2015-16,2016-02-19,Florida Panthers,1,Atlantic,Eastern,73,2,116,0.6293103448275862,67,6,66,7
2015-16,2016-02-21,Florida Panthers,2,Atlantic,Eastern,75,2,118,0.635593220338983,68,7,68,7
2015-16,2016-02-26,Florida Panthers,2,Atlantic,Eastern,77,2,120,0.6416666666666667,72,5,68,9
2015-16,2016-02-27,Florida Panthers,1,Atlantic,Eastern,78,2,122,0.639344262295082,74,4,70,8
2015-16,2016-02-28,Florida Panthers,0,Atlantic,Eastern,78,2,124,0.6290322580645161,74,4,70,8
2015-16,2016-03-02,Florida Panthers,2,Atlantic,Eastern,80,2,126,0.6349206349206349,76,4,72,8
2015-16,2016-03-04,Florida Panthers,0,Atlantic,Eastern,80,2,128,0.625,78,2,74,6
2015-16,2016-03-06,Florida Panthers,0,Atlantic,Eastern,80,2,130,0.6153846153846154,79,1,75,5
2015-16,2016-03-08,Florida Panthers,1,Atlantic,Eastern,81,2,132,0.6136363636363636,81,0,75,6
2015-16,2016-03-11,Florida Panthers,2,Atlantic,Eastern,83,2,134,0.6194029850746269,83,0,76,7
2015-16,2016-03-13,Florida Panthers,2,Atlantic,Eastern,85,2,136,0.625,85,0,79,6
2015-16,2016-03-14,Florida Panthers,0,Atlantic,Eastern,85,2,138,0.6159420289855072,85,0,79,6
2015-16,2016-03-15,Florida Panthers,2,Atlantic,Eastern,87,2,140,0.6214285714285714,85,2,79,8
2015-16,2016-03-17,Florida Panthers,2,Atlantic,Eastern,89,2,142,0.6267605633802817,85,4,81,8
2015-16,2016-03-19,Florida Panthers,0,Atlantic,Eastern,89,2,144,0.6180555555555556,85,4,83,6
2015-16,2016-03-21,Florida Panthers,0,Atlantic,Eastern,89,2,146,0.6095890410958904,86,3,83,6
2015-16,2016-03-24,Florida Panthers,2,Atlantic,Eastern,91,2,148,0.6148648648648649,86,5,85,6
2015-16,2016-03-26,Florida Panthers,2,Atlantic,Eastern,93,2,150,0.62,88,5,85,8
2015-16,2016-03-29,Florida Panthers,0,Atlantic,Eastern,93,2,152,0.6118421052631579,88,5,87,6
2015-16,2016-03-31,Florida Panthers,2,Atlantic,Eastern,95,2,154,0.6168831168831169,88,7,88,7
2015-16,2016-04-02,Florida Panthers,2,Atlantic,Eastern,97,2,156,0.6217948717948718,91,6,91,6
2015-16,2016-04-04,Florida Panthers,2,Atlantic,Eastern,99,2,158,0.6265822784810127,91,8,91,8
2015-16,2016-04-05,Florida Panthers,2,Atlantic,Eastern,101,2,160,0.63125,91,10,91,10
2015-16,2016-04-07,Florida Panthers,0,Atlantic,Eastern,101,2,162,0.6234567901234568,93,8,93,8
2015-16,2016-04-09,Florida Panthers,2,Atlantic,Eastern,103,2,164,0.6280487804878049,93,10,93,10
2015-16,2015-10-08,Los Angeles Kings,0,Pacific,Western,0,2,2,0.0,0,0,0,0
2015-16,2015-10-10,Los Angeles Kings,0,Pacific,Western,0,2,4,0.0,2,-2,2,-2
2015-16,2015-10-14,Los Angeles Kings,0,Pacific,Western,0,2,6,0.0,4,-4,4,-4
2015-16,2015-10-17,Los Angeles Kings,2,Pacific,Western,2,2,8,0.25,6,-4,6,-4
2015-16,2015-10-19,Los Angeles Kings,2,Pacific,Western,4,2,10,0.4,6,-2,6,-2
2015-16,2015-10-23,Los Angeles Kings,2,Pacific,Western,6,2,12,0.5,7,-1,8,-2
2015-16,2015-10-24,Los Angeles Kings,2,Pacific,Western,8,2,14,0.5714285714285714,8,0,8,0
2015-16,2015-10-26,Los Angeles Kings,2,Pacific,Western,10,2,16,0.625,10,0,10,0
2015-16,2015-10-28,Los Angeles Kings,2,Pacific,Western,12,2,18,0.6666666666666666,11,1,11,1
2015-16,2015-10-31,Los Angeles Kings,2,Pacific,Western,14,2,20,0.7,11,3,12,2
2015-16,2015-11-03,Los Angeles Kings,0,Pacific,Western,14,2,22,0.6363636363636364,12,2,14,0
2015-16,2015-11-04,Los Angeles Kings,2,Pacific,Western,16,2,24,0.6666666666666666,12,4,14,2
2015-16,2015-11-06,Los Angeles Kings,0,Pacific,Western,16,2,26,0.6153846153846154,14,2,15,1
2015-16,2015-11-07,Los Angeles Kings,2,Pacific,Western,18,2,28,0.6428571428571429,14,4,15,3
2015-16,2015-11-11,Los Angeles Kings,0,Pacific,Western,18,2,30,0.6,17,1,17,1
2015-16,2015-11-13,Los Angeles Kings,2,Pacific,Western,20,2,32,0.625,19,1,18,2
2015-16,2015-11-15,Los Angeles Kings,2,Pacific,Western,22,2,34,0.6470588235294118,19,3,19,3
2015-16,2015-11-18,Los Angeles Kings,2,Pacific,Western,24,2,36,0.6666666666666666,20,4,20,4
2015-16,2015-11-21,Los Angeles Kings,0,Pacific,Western,24,2,38,0.631578947368421,21,3,21,3
2015-16,2015-11-22,Los Angeles Kings,0,Pacific,Western,24,2,40,0.6,22,2,22,2
2015-16,2015-11-24,Los Angeles Kings,2,Pacific,Western,26,2,42,0.6190476190476191,22,4,22,4
2015-16,2015-11-26,Los Angeles Kings,1,Pacific,Western,27,2,44,0.6136363636363636,24,3,24,3
2015-16,2015-11-29,Los Angeles Kings,2,Pacific,Western,29,2,46,0.6304347826086957,27,2,26,3
2015-16,2015-12-02,Los Angeles Kings,2,Pacific,Western,31,2,48,0.6458333333333334,27,4,27,4
2015-16,2015-12-05,Los Angeles Kings,2,Pacific,Western,33,2,50,0.66,27,6,28,5
2015-16,2015-12-07,Los Angeles Kings,2,Pacific,Western,35,2,52,0.6730769230769231,27,8,28,7
2015-16,2015-12-09,Los Angeles Kings,2,Pacific,Western,37,2,54,0.6851851851851852,28,9,28,9
2015-16,2015-12-12,Los Angeles Kings,2,Pacific,Western,39,2,56,0.6964285714285714,29,10,30,9
2015-16,2015-12-13,Los Angeles Kings,1,Pacific,Western,40,2,58,0.6896551724137931,30,10,30,10
2015-16,2015-12-15,Los Angeles Kings,0,Pacific,Western,40,2,60,0.6666666666666666,30,10,30,10
2015-16,2015-12-18,Los Angeles Kings,2,Pacific,Western,42,2,62,0.6774193548387096,32,10,33,9
2015-16,2015-12-20,Los Angeles Kings,0,Pacific,Western,42,2,64,0.65625,33,9,33,9
2015-16,2015-12-23,Los Angeles Kings,0,Pacific,Western,42,2,66,0.6363636363636364,35,7,35,7
2015-16,2015-12-27,Los Angeles Kings,2,Pacific,Western,44,2,68,0.6470588235294118,36,8,36,8
2015-16,2015-12-29,Los Angeles Kings,2,Pacific,Western,46,2,70,0.6571428571428571,37,9,37,9
2015-16,2015-12-30,Los Angeles Kings,2,Pacific,Western,48,2,72,0.6666666666666666,37,11,37,11
2015-16,2016-01-01,Los Angeles Kings,2,Pacific,Western,50,2,74,0.6756756756756757,38,12,39,11
2015-16,2016-01-02,Los Angeles Kings,2,Pacific,Western,52,2,76,0.6842105263157895,39,13,39,13
2015-16,2016-01-05,Los Angeles Kings,0,Pacific,Western,52,2,78,0.6666666666666666,39,13,41,11
2015-16,2016-01-08,Los Angeles Kings,2,Pacific,Western,54,2,80,0.675,41,13,43,11
2015-16,2016-01-10,Los Angeles Kings,1,Pacific,Western,55,2,82,0.6707317073170732,42,13,45,10
2015-16,2016-01-12,Los Angeles Kings,2,Pacific,Western,57,2,84,0.6785714285714286,44,13,45,12
2015-16,2016-01-16,Los Angeles Kings,0,Pacific,Western,57,2,86,0.6627906976744186,46,11,46,11
2015-16,2016-01-18,Los Angeles Kings,2,Pacific,Western,59,2,88,0.6704545454545454,48,11,48,11
2015-16,2016-01-20,Los Angeles Kings,2,Pacific,Western,61,2,90,0.6777777777777778,49,12,49,12
2015-16,2016-01-22,Los Angeles Kings,0,Pacific,Western,61,2,92,0.6630434782608695,51,10,51,10
2015-16,2016-01-24,Los Angeles Kings,0,Pacific,Western,61,2,94,0.648936170212766,51,10,52,9
2015-16,2016-01-25,Los Angeles Kings,2,Pacific,Western,63,2,96,0.65625,51,12,52,11
2015-16,2016-01-28,Los Angeles Kings,0,Pacific,Western,63,2,98,0.6428571428571429,53,10,55,8
2015-16,2016-02-03,Los Angeles Kings,2,Pacific,Western,65,2,100,0.65,53,12,55,10
2015-16,2016-02-05,Los Angeles Kings,0,Pacific,Western,65,2,102,0.6372549019607843,55,10,55,10
2015-16,2016-02-10,Los Angeles Kings,2,Pacific,Western,67,2,104,0.6442307692307693,59,8,58,9
2015-16,2016-02-12,Los Angeles Kings,0,Pacific,Western,67,2,106,0.6320754716981132,60,7,58,9
2015-16,2016-02-13,Los Angeles Kings,2,Pacific,Western,69,2,108,0.6388888888888888,60,9,59,10
2015-16,2016-02-14,Los Angeles Kings,0,Pacific,Western,69,2,110,0.6272727272727273,62,7,61,8
2015-16,2016-02-17,Los Angeles Kings,0,Pacific,Western,69,2,112,0.6160714285714286,65,4,62,7
2015-16,2016-02-19,Los Angeles Kings,1,Pacific,Western,70,2,114,0.6140350877192983,67,3,64,6
2015-16,2016-02-21,Los Angeles Kings,2,Pacific,Western,72,2,116,0.6206896551724138,67,5,65,7
2015-16,2016-02-24,Los Angeles Kings,2,Pacific,Western,74,2,118,0.6271186440677966,69,5,66,8
2015-16,2016-02-26,Los Angeles Kings,2,Pacific,Western,76,2,120,0.6333333333333333,70,6,68,8
2015-16,2016-02-28,Los Angeles Kings,2,Pacific,Western,78,2,122,0.639344262295082,70,8,68,10
2015-16,2016-02-29,Los Angeles Kings,0,Pacific,Western,78,2,124,0.6290322580645161,72,6,68,10
2015-16,2016-03-04,Los Angeles Kings,2,Pacific,Western,80,2,126,0.6349206349206349,76,4,70,10
2015-16,2016-03-05,Los Angeles Kings,0,Pacific,Western,80,2,128,0.625,76,4,72,8
2015-16,2016-03-08,Los Angeles Kings,2,Pacific,Western,82,2,130,0.6307692307692307,78,4,72,10
2015-16,2016-03-10,Los Angeles Kings,2,Pacific,Western,84,2,132,0.6363636363636364,80,4,74,10
2015-16,2016-03-13,Los Angeles Kings,1,Pacific,Western,85,2,134,0.6343283582089553,82,3,74,11
2015-16,2016-03-15,Los Angeles Kings,2,Pacific,Western,87,2,136,0.6397058823529411,82,5,75,12
2015-16,2016-03-16,Los Angeles Kings,2,Pacific,Western,89,2,138,0.644927536231884,84,5,75,14
2015-16,2016-03-18,Los Angeles Kings,2,Pacific,Western,91,2,140,0.65,84,7,76,15
2015-16,2016-03-20,Los Angeles Kings,2,Pacific,Western,93,2,142,0.6549295774647887,86,7,78,15
2015-16,2016-03-22,Los Angeles Kings,0,Pacific,Western,93,2,144,0.6458333333333334,88,5,80,13
2015-16,2016-03-23,Los Angeles Kings,0,Pacific,Western,93,2,146,0.636986301369863,88,5,81,12
2015-16,2016-03-25,Los Angeles Kings,0,Pacific,Western,93,2,148,0.6283783783783784,88,5,83,10
2015-16,2016-03-27,Los Angeles Kings,2,Pacific,Western,95,2,150,0.6333333333333333,88,7,85,10
2015-16,2016-03-29,Los Angeles Kings,0,Pacific,Western,95,2,152,0.625,90,5,85,10
2015-16,2016-04-01,Los Angeles Kings,2,Pacific,Western,97,2,154,0.6298701298701299,92,5,87,10
2015-16,2016-04-02,Los Angeles Kings,0,Pacific,Western,97,2,156,0.6217948717948718,92,5,87,10
2015-16,2016-04-05,Los Angeles Kings,0,Pacific,Western,97,2,158,0.6139240506329114,94,3,87,10
2015-16,2016-04-06,Los Angeles Kings,2,Pacific,Western,99,2,160,0.61875,96,3,87,12
2015-16,2016-04-08,Los Angeles Kings,2,Pacific,Western,101,2,162,0.6234567901234568,96,5,87,14
2015-16,2016-04-10,Los Angeles Kings,1,Pacific,Western,102,2,164,0.6219512195121951,98,4,87,15
2015-16,2015-10-09,Minnesota Wild,2,Central,Western,2,2,2,1.0,2,0,2,0
2015-16,2015-10-11,Minnesota Wild,2,Central,Western,4,2,4,1.0,4,0,2,2
2015-16,2015-10-16,Minnesota Wild,2,Central,Western,6,2,6,1.0,6,0,6,0
2015-16,2015-10-17,Minnesota Wild,1,Central,Western,7,2,8,0.875,8,-1,6,1
2015-16,2015-10-19,Minnesota Wild,0,Central,Western,7,2,10,0.7,8,-1,6,1
2015-16,2015-10-23,Minnesota Wild,2,Central,Western,9,2,12,0.75,10,-1,8,1
2015-16,2015-10-24,Minnesota Wild,2,Central,Western,11,2,14,0.7857142857142857,11,0,8,3
2015-16,2015-10-25,Minnesota Wild,0,Central,Western,11,2,16,0.6875,11,0,9,2
2015-16,2015-10-28,Minnesota Wild,2,Central,Western,13,2,18,0.7222222222222222,13,0,11,2
2015-16,2015-10-31,Minnesota Wild,1,Central,Western,14,2,20,0.7,16,-2,12,2
2015-16,2015-10-31,Minnesota Wild,2,Central,Western,16,2,22,0.7272727272727273,16,0,12,4
2015-16,2015-11-06,Minnesota Wild,0,Central,Western,16,2,24,0.6666666666666666,18,-2,15,1
2015-16,2015-11-08,Minnesota Wild,2,Central,Western,18,2,26,0.6923076923076923,18,0,15,3
2015-16,2015-11-11,Minnesota Wild,2,Central,Western,20,2,28,0.7142857142857143,20,0,17,3
2015-16,2015-11-13,Minnesota Wild,2,Central,Western,22,2,30,0.7333333333333333,22,0,18,4
2015-16,2015-11-15,Minnesota Wild,1,Central,Western,23,2,32,0.71875,23,0,19,4
2015-16,2015-11-18,Minnesota Wild,0,Central,Western,23,2,34,0.6764705882352942,25,-2,20,3
2015-16,2015-11-20,Minnesota Wild,0,Central,Western,23,2,36,0.6388888888888888,25,-2,21,2
2015-16,2015-11-22,Minnesota Wild,2,Central,Western,25,2,38,0.6578947368421053,25,0,22,3
2015-16,2015-11-26,Minnesota Wild,0,Central,Western,25,2,40,0.625,27,-2,24,1
2015-16,2015-11-27,Minnesota Wild,0,Central,Western,25,2,42,0.5952380952380952,28,-3,24,1
2015-16,2015-11-29,Minnesota Wild,1,Central,Western,26,2,44,0.5909090909090909,29,-3,26,0
2015-16,2015-12-02,Minnesota Wild,2,Central,Western,28,2,46,0.6086956521739131,30,-2,27,1
2015-16,2015-12-04,Minnesota Wild,2,Central,Western,30,2,48,0.625,30,0,27,3
2015-16,2015-12-06,Minnesota Wild,2,Central,Western,32,2,50,0.64,32,0,28,4
2015-16,2015-12-08,Minnesota Wild,1,Central,Western,33,2,52,0.6346153846153846,33,0,28,5
2015-16,2015-12-12,Minnesota Wild,1,Central,Western,34,2,54,0.6296296296296297,36,-2,30,4
2015-16,2015-12-13,Minnesota Wild,2,Central,Western,36,2,56,0.6428571428571429,36,0,30,6
2015-16,2015-12-16,Minnesota Wild,2,Central,Western,38,2,58,0.6551724137931034,38,0,31,7
2015-16,2015-12-18,Minnesota Wild,2,Central,Western,40,2,60,0.6666666666666666,40,0,33,7
2015-16,2015-12-20,Minnesota Wild,0,Central,Western,40,2,62,0.6451612903225806,42,-2,33,7
2015-16,2015-12-22,Minnesota Wild,0,Central,Western,40,2,64,0.625,44,-4,34,6
2015-16,2015-12-23,Minnesota Wild,2,Central,Western,42,2,66,0.6363636363636364,44,-2,35,7
2015-16,2015-12-27,Minnesota Wild,0,Central,Western,42,2,68,0.6176470588235294,44,-2,36,6
2015-16,2015-12-29,Minnesota Wild,2,Central,Western,44,2,70,0.6285714285714286,44,0,37,7
2015-16,2016-01-01,Minnesota Wild,2,Central,Western,46,2,72,0.6388888888888888,48,-2,39,7
2015-16,2016-01-03,Minnesota Wild,1,Central,Western,47,2,74,0.6351351351351351,48,-1,39,8
2015-16,2016-01-03,Minnesota Wild,0,Central,Western,47,2,76,0.618421052631579,48,-1,39,8
2015-16,2016-01-06,Minnesota Wild,2,Central,Western,49,2,78,0.6282051282051282,51,-2,41,8
2015-16,2016-01-08,Minnesota Wild,1,Central,Western,50,2,80,0.625,52,-2,43,7
2015-16,2016-01-10,Minnesota Wild,2,Central,Western,52,2,82,0.6341463414634146,55,-3,45,7
2015-16,2016-01-11,Minnesota Wild,0,Central,Western,52,2,84,0.6190476190476191,55,-3,45,7
2015-16,2016-01-13,Minnesota Wild,0,Central,Western,52,2,86,0.6046511627906976,57,-5,45,7
2015-16,2016-01-16,Minnesota Wild,0,Central,Western,52,2,88,0.5909090909090909,57,-5,46,6
2015-16,2016-01-17,Minnesota Wild,0,Central,Western,52,2,90,0.5777777777777777,59,-7,48,4
2015-16,2016-01-21,Minnesota Wild,0,Central,Western,52,2,92,0.5652173913043478,63,-11,49,3
2015-16,2016-01-22,Minnesota Wild,2,Central,Western,54,2,94,0.574468085106383,63,-9,51,3
2015-16,2016-01-23,Minnesota Wild,0,Central,Western,54,2,96,0.5625,64,-10,51,3
2015-16,2016-01-26,Minnesota Wild,1,Central,Western,55,2,98,0.5612244897959183,64,-9,53,2
2015-16,2016-02-03,Minnesota Wild,0,Central,Western,55,2,100,0.55,66,-11,55,0
2015-16,2016-02-05,Minnesota Wild,0,Central,Western,55,2,102,0.5392156862745098,66,-11,55,0
2015-16,2016-02-07,Minnesota Wild,0,Central,Western,55,2,104,0.5288461538461539,68,-13,57,-2
2015-16,2016-02-10,Minnesota Wild,1,Central,Western,56,2,106,0.5283018867924528,69,-13,58,-2
2015-16,2016-02-12,Minnesota Wild,0,Central,Western,56,2,108,0.5185185185185185,69,-13,58,-2
2015-16,2016-02-13,Minnesota Wild,0,Central,Western,56,2,110,0.509090909090909,71,-15,59,-3
2015-16,2016-02-16,Minnesota Wild,2,Central,Western,58,2,112,0.5178571428571429,73,-15,62,-4
2015-16,2016-02-18,Minnesota Wild,2,Central,Western,60,2,114,0.5263157894736842,75,-15,62,-2
2015-16,2016-02-19,Minnesota Wild,2,Central,Western,62,2,116,0.5344827586206896,77,-15,64,-2
2015-16,2016-02-21,Minnesota Wild,2,Central,Western,64,2,118,0.5423728813559322,79,-15,65,-1
2015-16,2016-02-24,Minnesota Wild,0,Central,Western,64,2,120,0.5333333333333333,79,-15,66,-2
2015-16,2016-02-26,Minnesota Wild,0,Central,Western,64,2,122,0.5245901639344263,79,-15,68,-4
2015-16,2016-02-27,Minnesota Wild,0,Central,Western,64,2,124,0.5161290322580645,79,-15,68,-4
2015-16,2016-02-28,Minnesota Wild,2,Central,Western,66,2,126,0.5238095238095238,81,-15,68,-2
2015-16,2016-03-02,Minnesota Wild,2,Central,Western,68,2,128,0.53125,83,-15,68,0
2015-16,2016-03-04,Minnesota Wild,2,Central,Western,70,2,130,0.5384615384615384,83,-13,70,0
2015-16,2016-03-05,Minnesota Wild,2,Central,Western,72,2,132,0.5454545454545454,83,-11,72,0
2015-16,2016-03-07,Minnesota Wild,0,Central,Western,72,2,134,0.5373134328358209,85,-13,72,0
2015-16,2016-03-11,Minnesota Wild,0,Central,Western,72,2,136,0.5294117647058824,87,-15,74,-2
2015-16,2016-03-13,Minnesota Wild,2,Central,Western,74,2,138,0.5362318840579711,88,-14,74,0
2015-16,2016-03-15,Minnesota Wild,1,Central,Western,75,2,140,0.5357142857142857,88,-13,75,0
2015-16,2016-03-17,Minnesota Wild,0,Central,Western,75,2,142,0.528169014084507,88,-13,76,-1
2015-16,2016-03-19,Minnesota Wild,2,Central,Western,77,2,144,0.5347222222222222,90,-13,78,-1
2015-16,2016-03-21,Minnesota Wild,2,Central,Western,79,2,146,0.541095890410959,91,-12,80,-1
2015-16,2016-03-23,Minnesota Wild,2,Central,Western,81,2,148,0.5472972972972973,91,-10,81,0
2015-16,2016-03-25,Minnesota Wild,2,Central,Western,83,2,150,0.5533333333333333,91,-8,83,0
2015-16,2016-03-26,Minnesota Wild,2,Central,Western,85,2,152,0.5592105263157895,91,-6,85,0
2015-16,2016-03-30,Minnesota Wild,2,Central,Western,87,2,154,0.564935064935065,95,-8,87,0
2015-16,2016-04-01,Minnesota Wild,0,Central,Western,87,2,156,0.5576923076923077,95,-8,87,0
2015-16,2016-04-01,Minnesota Wild,0,Central,Western,87,2,158,0.5506329113924051,95,-8,87,0
2015-16,2016-04-04,Minnesota Wild,0,Central,Western,87,2,160,0.54375,99,-12,87,0
2015-16,2016-04-06,Minnesota Wild,0,Central,Western,87,2,162,0.5370370370370371,101,-14,87,0
2015-16,2016-04-09,Minnesota Wild,0,Central,Western,87,2,164,0.5304878048780488,103,-16,87,0
2015-16,2015-10-07,Montréal Canadiens,2,Atlantic,Eastern,2,2,2,1.0,0,2,0,2
2015-16,2015-10-10,Montréal Canadiens,2,Atlantic,Eastern,4,2,4,1.0,4,0,1,3
2015-16,2015-10-11,Montréal Canadiens,2,Atlantic,Eastern,6,2,6,1.0,4,2,1,5
2015-16,2015-10-13,Montréal Canadiens,2,Atlantic,Eastern,8,2,8,1.0,6,2,3,5
2015-16,2015-10-15,Montréal Canadiens,2,Atlantic,Eastern,10,2,10,1.0,6,4,5,5
2015-16,2015-10-17,Montréal Canadiens,2,Atlantic,Eastern,12,2,12,1.0,7,5,6,6
2015-16,2015-10-20,Montréal Canadiens,2,Atlantic,Eastern,14,2,14,1.0,7,7,6,8
2015-16,2015-10-23,Montréal Canadiens,2,Atlantic,Eastern,16,2,16,1.0,8,8,7,9
2015-16,2015-10-24,Montréal Canadiens,2,Atlantic,Eastern,18,2,18,1.0,8,10,8,10
2015-16,2015-10-28,Montréal Canadiens,0,Atlantic,Eastern,18,2,20,0.9,11,7,10,8
2015-16,2015-10-30,Montréal Canadiens,0,Atlantic,Eastern,18,2,22,0.8181818181818182,12,6,11,7
2015-16,2015-10-31,Montréal Canadiens,2,Atlantic,Eastern,20,2,24,0.8333333333333334,12,8,12,8
2015-16,2015-11-02,Montréal Canadiens,2,Atlantic,Eastern,22,2,26,0.8461538461538461,13,9,13,9
2015-16,2015-11-04,Montréal Canadiens,1,Atlantic,Eastern,23,2,28,0.8214285714285714,14,9,13,10
2015-16,2015-11-06,Montréal Canadiens,2,Atlantic,Eastern,25,2,30,0.8333333333333334,16,9,13,12
2015-16,2015-11-08,Montréal Canadiens,2,Atlantic,Eastern,27,2,32,0.84375,16,11,16,11
2015-16,2015-11-12,Montréal Canadiens,1,Atlantic,Eastern,28,2,34,0.8235294117647058,17,11,17,11
2015-16,2015-11-15,Montréal Canadiens,0,Atlantic,Eastern,28,2,36,0.7777777777777778,19,9,19,9
2015-16,2015-11-17,Montréal Canadiens,2,Atlantic,Eastern,30,2,38,0.7894736842105263,19,11,19,11
2015-16,2015-11-20,Montréal Canadiens,0,Atlantic,Eastern,30,2,40,0.75,21,9,21,9
2015-16,2015-11-21,Montréal Canadiens,2,Atlantic,Eastern,32,2,42,0.7619047619047619,22,10,21,11
2015-16,2015-11-23,Montréal Canadiens,2,Atlantic,Eastern,34,2,44,0.7727272727272727,24,10,23,11
2015-16,2015-11-26,Montréal Canadiens,2,Atlantic,Eastern,36,2,46,0.782608695652174,25,11,25,11
2015-16,2015-11-28,Montréal Canadiens,2,Atlantic,Eastern,38,2,48,0.7916666666666666,27,11,26,12
2015-16,2015-11-29,Montréal Canadiens,1,Atlantic,Eastern,39,2,50,0.78,28,11,27,12
2015-16,2015-12-02,Montréal Canadiens,2,Atlantic,Eastern,41,2,52,0.7884615384615384,29,12,27,14
2015-16,2015-12-04,Montréal Canadiens,0,Atlantic,Eastern,41,2,54,0.7592592592592593,31,10,28,13
2015-16,2015-12-06,Montréal Canadiens,0,Atlantic,Eastern,41,2,56,0.7321428571428571,33,8,30,11
2015-16,2015-12-10,Montréal Canadiens,0,Atlantic,Eastern,41,2,58,0.7068965517241379,35,6,32,9
2015-16,2015-12-11,Montréal Canadiens,0,Atlantic,Eastern,41,2,60,0.6833333333333333,35,6,32,9
2015-16,2015-12-13,Montréal Canadiens,2,Atlantic,Eastern,43,2,62,0.6935483870967742,35,8,34,9
2015-16,2015-12-16,Montréal Canadiens,0,Atlantic,Eastern,43,2,64,0.671875,37,6,36,7
2015-16,2015-12-18,Montréal Canadiens,0,Atlantic,Eastern,43,2,66,0.6515151515151515,38,5,36,7
2015-16,2015-12-20,Montréal Canadiens,0,Atlantic,Eastern,43,2,68,0.6323529411764706,40,3,39,4
2015-16,2015-12-22,Montréal Canadiens,0,Atlantic,Eastern,43,2,70,0.6142857142857143,41,2,39,4
2015-16,2015-12-23,Montréal Canadiens,0,Atlantic,Eastern,43,2,72,0.5972222222222222,42,1,40,3
2015-16,2015-12-27,Montréal Canadiens,0,Atlantic,Eastern,43,2,74,0.581081081081081,43,0,42,1
2015-16,2015-12-29,Montréal Canadiens,2,Atlantic,Eastern,45,2,76,0.5921052631578947,43,2,42,3
2015-16,2015-12-30,Montréal Canadiens,0,Atlantic,Eastern,45,2,78,0.5769230769230769,44,1,42,3
2015-16,2016-01-01,Montréal Canadiens,2,Atlantic,Eastern,47,2,80,0.5875,44,3,43,4
2015-16,2016-01-06,Montréal Canadiens,0,Atlantic,Eastern,47,2,82,0.573170731707317,47,0,44,3
2015-16,2016-01-07,Montréal Canadiens,2,Atlantic,Eastern,49,2,84,0.5833333333333334,47,2,44,5
2015-16,2016-01-10,Montréal Canadiens,0,Atlantic,Eastern,49,2,86,0.5697674418604651,49,0,46,3
2015-16,2016-01-15,Montréal Canadiens,0,Atlantic,Eastern,49,2,88,0.5568181818181818,49,0,47,2
2015-16,2016-01-17,Montréal Canadiens,1,Atlantic,Eastern,50,2,90,0.5555555555555556,52,-2,50,0
2015-16,2016-01-18,Montréal Canadiens,0,Atlantic,Eastern,50,2,92,0.5434782608695652,52,-2,50,0
2015-16,2016-01-20,Montréal Canadiens,0,Atlantic,Eastern,50,2,94,0.5319148936170213,54,-4,51,-1
2015-16,2016-01-24,Montréal Canadiens,2,Atlantic,Eastern,52,2,96,0.5416666666666666,56,-4,55,-3
2015-16,2016-01-26,Montréal Canadiens,0,Atlantic,Eastern,52,2,98,0.5306122448979592,57,-5,55,-3
2015-16,2016-01-27,Montréal Canadiens,0,Atlantic,Eastern,52,2,100,0.52,57,-5,55,-3
2015-16,2016-02-03,Montréal Canadiens,0,Atlantic,Eastern,52,2,102,0.5098039215686274,58,-6,57,-5
2015-16,2016-02-04,Montréal Canadiens,0,Atlantic,Eastern,52,2,104,0.5,58,-6,57,-5
2015-16,2016-02-06,Montréal Canadiens,2,Atlantic,Eastern,54,2,106,0.5094339622641509,60,-6,58,-4
2015-16,2016-02-07,Montréal Canadiens,2,Atlantic,Eastern,56,2,108,0.5185185185185185,62,-6,59,-3
2015-16,2016-02-10,Montréal Canadiens,2,Atlantic,Eastern,58,2,110,0.5272727272727272,62,-4,61,-3
2015-16,2016-02-13,Montréal Canadiens,0,Atlantic,Eastern,58,2,112,0.5178571428571429,65,-7,63,-5
2015-16,2016-02-16,Montréal Canadiens,0,Atlantic,Eastern,58,2,114,0.5087719298245614,66,-8,64,-6
2015-16,2016-02-18,Montréal Canadiens,0,Atlantic,Eastern,58,2,116,0.5,67,-9,64,-6
2015-16,2016-02-20,Montréal Canadiens,2,Atlantic,Eastern,60,2,118,0.5084745762711864,68,-8,66,-6
2015-16,2016-02-23,Montréal Canadiens,1,Atlantic,Eastern,61,2,120,0.5083333333333333,70,-9,68,-7
2015-16,2016-02-25,Montréal Canadiens,2,Atlantic,Eastern,63,2,122,0.5163934426229508,72,-9,68,-5
2015-16,2016-02-28,Montréal Canadiens,2,Atlantic,Eastern,65,2,124,0.5241935483870968,74,-9,70,-5
2015-16,2016-03-01,Montréal Canadiens,0,Atlantic,Eastern,65,2,126,0.5158730158730159,75,-10,72,-7
2015-16,2016-03-03,Montréal Canadiens,1,Atlantic,Eastern,66,2,128,0.515625,76,-10,72,-6
2015-16,2016-03-04,Montréal Canadiens,0,Atlantic,Eastern,66,2,130,0.5076923076923077,78,-12,74,-8
2015-16,2016-03-06,Montréal Canadiens,0,Atlantic,Eastern,66,2,132,0.5,79,-13,75,-9
2015-16,2016-03-09,Montréal Canadiens,2,Atlantic,Eastern,68,2,134,0.5074626865671642,81,-13,75,-7
2015-16,2016-03-11,Montréal Canadiens,2,Atlantic,Eastern,70,2,136,0.5147058823529411,83,-13,76,-6
2015-16,2016-03-13,Montréal Canadiens,0,Atlantic,Eastern,70,2,138,0.5072463768115942,85,-15,79,-9
2015-16,2016-03-15,Montréal Canadiens,0,Atlantic,Eastern,70,2,140,0.5,85,-15,79,-9
2015-16,2016-03-16,Montréal Canadiens,2,Atlantic,Eastern,72,2,142,0.5070422535211268,85,-13,79,-7
2015-16,2016-03-19,Montréal Canadiens,0,Atlantic,Eastern,72,2,144,0.5,85,-13,83,-11
2015-16,2016-03-20,Montréal Canadiens,0,Atlantic,Eastern,72,2,146,0.4931506849315068,86,-14,83,-11
2015-16,2016-03-22,Montréal Canadiens,2,Atlantic,Eastern,74,2,148,0.5,86,-12,83,-9
2015-16,2016-03-24,Montréal Canadiens,0,Atlantic,Eastern,74,2,150,0.49333333333333335,86,-12,85,-11
2015-16,2016-03-26,Montréal Canadiens,0,Atlantic,Eastern,74,2,152,0.4868421052631579,88,-14,85,-11
2015-16,2016-03-29,Montréal Canadiens,2,Atlantic,Eastern,76,2,154,0.4935064935064935,88,-12,87,-11
2015-16,2016-03-31,Montréal Canadiens,2,Atlantic,Eastern,78,2,156,0.5,88,-10,88,-10
2015-16,2016-04-02,Montréal Canadiens,0,Atlantic,Eastern,78,2,158,0.4936708860759494,91,-13,91,-13
2015-16,2016-04-05,Montréal Canadiens,0,Atlantic,Eastern,78,2,160,0.4875,91,-13,91,-13
2015-16,2016-04-07,Montréal Canadiens,2,Atlantic,Eastern,80,2,162,0.49382716049382713,93,-13,93,-13
2015-16,2016-04-09,Montréal Canadiens,2,Atlantic,Eastern,82,2,164,0.5,93,-11,93,-11
2015-16,2015-10-09,Nashville Predators,2,Central,Western,2,2,2,1.0,2,0,2,0
2015-16,2015-10-10,Nashville Predators,2,Central,Western,4,2,4,1.0,2,2,2,2
2015-16,2015-10-13,Nashville Predators,2,Central,Western,6,2,6,1.0,4,2,2,4
2015-16,2015-10-15,Nashville Predators,0,Central,Western,6,2,8,0.75,6,0,4,2
2015-16,2015-10-17,Nashville Predators,2,Central,Western,8,2,10,0.8,8,0,6,2
2015-16,2015-10-21,Nashville Predators,2,Central,Western,10,2,12,0.8333333333333334,10,0,7,3
2015-16,2015-10-23,Nashville Predators,2,Central,Western,12,2,14,0.8571428571428571,10,2,8,4
2015-16,2015-10-25,Nashville Predators,1,Central,Western,13,2,16,0.8125,11,2,9,4
2015-16,2015-10-29,Nashville Predators,2,Central,Western,15,2,18,0.8333333333333334,13,2,11,4
2015-16,2015-10-31,Nashville Predators,1,Central,Western,16,2,20,0.8,16,0,12,4
2015-16,2015-11-02,Nashville Predators,0,Central,Western,16,2,22,0.7272727272727273,16,0,12,4
2015-16,2015-11-06,Nashville Predators,2,Central,Western,18,2,24,0.75,18,0,15,3
2015-16,2015-11-08,Nashville Predators,0,Central,Western,18,2,26,0.6923076923076923,18,0,15,3
2015-16,2015-11-11,Nashville Predators,2,Central,Western,20,2,28,0.7142857142857143,20,0,17,3
2015-16,2015-11-13,Nashville Predators,1,Central,Western,21,2,30,0.7,22,-1,18,3
2015-16,2015-11-15,Nashville Predators,2,Central,Western,23,2,32,0.71875,23,0,19,4
2015-16,2015-11-18,Nashville Predators,2,Central,Western,25,2,34,0.7352941176470589,25,0,20,5
2015-16,2015-11-21,Nashville Predators,0,Central,Western,25,2,36,0.6944444444444444,25,0,21,4
2015-16,2015-11-22,Nashville Predators,0,Central,Western,25,2,38,0.6578947368421053,25,0,22,3
2015-16,2015-11-24,Nashville Predators,0,Central,Western,25,2,40,0.625,25,0,22,3
2015-16,2015-11-26,Nashville Predators,2,Central,Western,27,2,42,0.6428571428571429,27,0,24,3
2015-16,2015-11-27,Nashville Predators,1,Central,Western,28,2,44,0.6363636363636364,28,0,24,4
2015-16,2015-11-29,Nashville Predators,0,Central,Western,28,2,46,0.6086956521739131,29,-1,26,2
2015-16,2015-12-02,Nashville Predators,2,Central,Western,30,2,48,0.625,30,0,27,3
2015-16,2015-12-04,Nashville Predators,0,Central,Western,30,2,50,0.6,30,0,27,3
2015-16,2015-12-06,Nashville Predators,1,Central,Western,31,2,52,0.5961538461538461,32,-1,28,3
2015-16,2015-12-08,Nashville Predators,2,Central,Western,33,2,54,0.6111111111111112,33,0,28,5
2015-16,2015-12-09,Nashville Predators,0,Central,Western,33,2,56,0.5892857142857143,34,-1,28,5
2015-16,2015-12-11,Nashville Predators,2,Central,Western,35,2,58,0.603448275862069,35,0,30,5
2015-16,2015-12-13,Nashville Predators,0,Central,Western,35,2,60,0.5833333333333334,36,-1,30,5
2015-16,2015-12-16,Nashville Predators,1,Central,Western,36,2,62,0.5806451612903226,38,-2,31,5
2015-16,2015-12-18,Nashville Predators,0,Central,Western,36,2,64,0.5625,40,-4,33,3
2015-16,2015-12-20,Nashville Predators,2,Central,Western,38,2,66,0.5757575757575758,42,-4,33,5
2015-16,2015-12-22,Nashville Predators,2,Central,Western,40,2,68,0.5882352941176471,44,-4,34,6
2015-16,2015-12-27,Nashville Predators,0,Central,Western,40,2,70,0.5714285714285714,44,-4,36,4
2015-16,2015-12-29,Nashville Predators,2,Central,Western,42,2,72,0.5833333333333334,44,-2,37,5
2015-16,2015-12-30,Nashville Predators,1,Central,Western,43,2,74,0.581081081081081,46,-3,37,6
2015-16,2016-01-01,Nashville Predators,0,Central,Western,43,2,76,0.5657894736842105,48,-5,39,4
2015-16,2016-01-03,Nashville Predators,2,Central,Western,45,2,78,0.5769230769230769,48,-3,39,6
2015-16,2016-01-06,Nashville Predators,0,Central,Western,45,2,80,0.5625,51,-6,41,4
2015-16,2016-01-09,Nashville Predators,0,Central,Western,45,2,82,0.5487804878048781,53,-8,44,1
2015-16,2016-01-10,Nashville Predators,0,Central,Western,45,2,84,0.5357142857142857,55,-10,45,0
2015-16,2016-01-13,Nashville Predators,0,Central,Western,45,2,86,0.5232558139534884,57,-12,45,0
2015-16,2016-01-15,Nashville Predators,1,Central,Western,46,2,88,0.5227272727272727,57,-11,46,0
2015-16,2016-01-17,Nashville Predators,2,Central,Western,48,2,90,0.5333333333333333,59,-11,48,0
2015-16,2016-01-20,Nashville Predators,0,Central,Western,48,2,92,0.5217391304347826,61,-13,49,-1
2015-16,2016-01-22,Nashville Predators,2,Central,Western,50,2,94,0.5319148936170213,63,-13,51,-1
2015-16,2016-01-24,Nashville Predators,2,Central,Western,52,2,96,0.5416666666666666,64,-12,52,0
2015-16,2016-01-27,Nashville Predators,2,Central,Western,54,2,98,0.5510204081632653,64,-10,54,0
2015-16,2016-01-28,Nashville Predators,2,Central,Western,56,2,100,0.56,64,-8,55,1
2015-16,2016-02-03,Nashville Predators,0,Central,Western,56,2,102,0.5490196078431373,66,-10,55,1
2015-16,2016-02-05,Nashville Predators,0,Central,Western,56,2,104,0.5384615384615384,66,-10,55,1
2015-16,2016-02-07,Nashville Predators,2,Central,Western,58,2,106,0.5471698113207547,68,-10,57,1
2015-16,2016-02-10,Nashville Predators,0,Central,Western,58,2,108,0.5370370370370371,69,-11,58,0
2015-16,2016-02-13,Nashville Predators,1,Central,Western,59,2,110,0.5363636363636364,71,-12,59,0
2015-16,2016-02-14,Nashville Predators,2,Central,Western,61,2,112,0.5446428571428571,73,-12,61,0
2015-16,2016-02-16,Nashville Predators,1,Central,Western,62,2,114,0.543859649122807,73,-11,62,0
2015-16,2016-02-19,Nashville Predators,2,Central,Western,64,2,116,0.5517241379310345,77,-13,64,0
2015-16,2016-02-21,Nashville Predators,1,Central,Western,65,2,118,0.5508474576271186,79,-14,65,0
2015-16,2016-02-23,Nashville Predators,2,Central,Western,67,2,120,0.5583333333333333,79,-12,66,1
2015-16,2016-02-24,Nashville Predators,2,Central,Western,69,2,122,0.5655737704918032,79,-10,66,3
2015-16,2016-02-26,Nashville Predators,2,Central,Western,71,2,124,0.5725806451612904,79,-8,68,3
2015-16,2016-02-27,Nashville Predators,2,Central,Western,73,2,126,0.5793650793650794,79,-6,68,5
2015-16,2016-03-02,Nashville Predators,2,Central,Western,75,2,128,0.5859375,83,-8,68,7
2015-16,2016-03-04,Nashville Predators,1,Central,Western,76,2,130,0.5846153846153846,83,-7,70,6
2015-16,2016-03-05,Nashville Predators,2,Central,Western,78,2,132,0.5909090909090909,83,-5,72,6
2015-16,2016-03-09,Nashville Predators,2,Central,Western,80,2,134,0.5970149253731343,85,-5,72,8
2015-16,2016-03-10,Nashville Predators,1,Central,Western,81,2,136,0.5955882352941176,87,-6,74,7
2015-16,2016-03-13,Nashville Predators,0,Central,Western,81,2,138,0.5869565217391305,88,-7,74,7
2015-16,2016-03-15,Nashville Predators,2,Central,Western,83,2,140,0.5928571428571429,88,-5,75,8
2015-16,2016-03-18,Nashville Predators,0,Central,Western,83,2,142,0.5845070422535211,88,-5,76,7
2015-16,2016-03-18,Nashville Predators,2,Central,Western,85,2,144,0.5902777777777778,88,-3,76,9
2015-16,2016-03-22,Nashville Predators,2,Central,Western,87,2,146,0.5958904109589042,91,-4,80,7
2015-16,2016-03-25,Nashville Predators,2,Central,Western,89,2,148,0.6013513513513513,91,-2,83,6
2015-16,2016-03-27,Nashville Predators,2,Central,Western,91,2,150,0.6066666666666667,93,-2,85,6
2015-16,2016-03-29,Nashville Predators,0,Central,Western,91,2,152,0.5986842105263158,95,-4,85,6
2015-16,2016-03-30,Nashville Predators,0,Central,Western,91,2,154,0.5909090909090909,95,-4,87,4
2015-16,2016-03-31,Nashville Predators,0,Central,Western,91,2,156,0.5833333333333334,95,-4,87,4
2015-16,2016-04-03,Nashville Predators,1,Central,Western,92,2,158,0.5822784810126582,99,-7,87,5
2015-16,2016-04-06,Nashville Predators,2,Central,Western,94,2,160,0.5875,101,-7,87,7
2015-16,2016-04-08,Nashville Predators,2,Central,Western,96,2,162,0.5925925925925926,102,-6,87,9
2015-16,2016-04-10,Nashville Predators,0,Central,Western,96,2,164,0.5853658536585366,103,-7,87,9
2015-16,2015-10-09,New Jersey Devils,0,Metropolitan,Eastern,0,2,2,0.0,1,-1,0,0
2015-16,2015-10-10,New Jersey Devils,0,Metropolitan,Eastern,0,2,4,0.0,1,-1,1,-1
2015-16,2015-10-13,New Jersey Devils,0,Metropolitan,Eastern,0,2,6,0.0,3,-3,3,-3
2015-16,2015-10-16,New Jersey Devils,1,Metropolitan,Eastern,1,2,8,0.125,5,-4,5,-4
2015-16,2015-10-18,New Jersey Devils,2,Metropolitan,Eastern,3,2,10,0.3,6,-3,6,-3
2015-16,2015-10-20,New Jersey Devils,2,Metropolitan,Eastern,5,2,12,0.4166666666666667,6,-1,6,-1
2015-16,2015-10-22,New Jersey Devils,2,Metropolitan,Eastern,7,2,14,0.5,8,-1,7,0
2015-16,2015-10-24,New Jersey Devils,2,Metropolitan,Eastern,9,2,16,0.5625,9,0,8,1
2015-16,2015-10-27,New Jersey Devils,0,Metropolitan,Eastern,9,2,18,0.5,12,-3,9,0
2015-16,2015-10-29,New Jersey Devils,2,Metropolitan,Eastern,11,2,20,0.55,12,-1,11,0
2015-16,2015-10-31,New Jersey Devils,2,Metropolitan,Eastern,13,2,22,0.5909090909090909,15,-2,12,1
2015-16,2015-11-04,New Jersey Devils,0,Metropolitan,Eastern,13,2,24,0.5416666666666666,16,-3,13,0
2015-16,2015-11-07,New Jersey Devils,2,Metropolitan,Eastern,15,2,26,0.5769230769230769,18,-3,15,0
2015-16,2015-11-08,New Jersey Devils,2,Metropolitan,Eastern,17,2,28,0.6071428571428571,18,-1,16,1
2015-16,2015-11-11,New Jersey Devils,0,Metropolitan,Eastern,17,2,30,0.5666666666666667,19,-2,17,0
2015-16,2015-11-13,New Jersey Devils,2,Metropolitan,Eastern,19,2,32,0.59375,20,-1,18,1
2015-16,2015-11-15,New Jersey Devils,2,Metropolitan,Eastern,21,2,34,0.6176470588235294,21,0,19,2
2015-16,2015-11-18,New Jersey Devils,0,Metropolitan,Eastern,21,2,36,0.5833333333333334,23,-2,19,2
2015-16,2015-11-21,New Jersey Devils,0,Metropolitan,Eastern,21,2,38,0.5526315789473685,24,-3,21,0
2015-16,2015-11-23,New Jersey Devils,2,Metropolitan,Eastern,23,2,40,0.575,24,-1,23,0
2015-16,2015-11-26,New Jersey Devils,0,Metropolitan,Eastern,23,2,42,0.5476190476190477,26,-3,25,-2
2015-16,2015-11-28,New Jersey Devils,1,Metropolitan,Eastern,24,2,44,0.5454545454545454,27,-3,26,-2
2015-16,2015-11-29,New Jersey Devils,2,Metropolitan,Eastern,26,2,46,0.5652173913043478,28,-2,27,-1
2015-16,2015-12-02,New Jersey Devils,0,Metropolitan,Eastern,26,2,48,0.5416666666666666,30,-4,27,-1
2015-16,2015-12-04,New Jersey Devils,2,Metropolitan,Eastern,28,2,50,0.56,32,-4,28,0
2015-16,2015-12-05,New Jersey Devils,1,Metropolitan,Eastern,29,2,52,0.5576923076923077,34,-5,30,-1
2015-16,2015-12-07,New Jersey Devils,2,Metropolitan,Eastern,31,2,54,0.5740740740740741,35,-4,31,0
2015-16,2015-12-09,New Jersey Devils,1,Metropolitan,Eastern,32,2,56,0.5714285714285714,37,-5,31,1
2015-16,2015-12-12,New Jersey Devils,2,Metropolitan,Eastern,34,2,58,0.5862068965517241,37,-3,34,0
2015-16,2015-12-13,New Jersey Devils,0,Metropolitan,Eastern,34,2,60,0.5666666666666667,39,-5,34,0
2015-16,2015-12-16,New Jersey Devils,2,Metropolitan,Eastern,36,2,62,0.5806451612903226,41,-5,36,0
2015-16,2015-12-18,New Jersey Devils,0,Metropolitan,Eastern,36,2,64,0.5625,41,-5,36,0
2015-16,2015-12-20,New Jersey Devils,0,Metropolitan,Eastern,36,2,66,0.5454545454545454,41,-5,39,-3
2015-16,2015-12-20,New Jersey Devils,1,Metropolitan,Eastern,37,2,68,0.5441176470588235,41,-4,39,-2
2015-16,2015-12-23,New Jersey Devils,2,Metropolitan,Eastern,39,2,70,0.5571428571428572,43,-4,40,-1
2015-16,2015-12-27,New Jersey Devils,0,Metropolitan,Eastern,39,2,72,0.5416666666666666,43,-4,42,-3
2015-16,2015-12-30,New Jersey Devils,2,Metropolitan,Eastern,41,2,74,0.5540540540540541,44,-3,42,-1
2015-16,2015-12-31,New Jersey Devils,2,Metropolitan,Eastern,43,2,76,0.5657894736842105,46,-3,43,0
2015-16,2016-01-03,New Jersey Devils,2,Metropolitan,Eastern,45,2,78,0.5769230769230769,46,-1,44,1
2015-16,2016-01-05,New Jersey Devils,0,Metropolitan,Eastern,45,2,80,0.5625,46,-1,44,1
2015-16,2016-01-07,New Jersey Devils,0,Metropolitan,Eastern,45,2,82,0.5487804878048781,48,-3,44,1
2015-16,2016-01-09,New Jersey Devils,0,Metropolitan,Eastern,45,2,84,0.5357142857142857,49,-4,45,0
2015-16,2016-01-11,New Jersey Devils,2,Metropolitan,Eastern,47,2,86,0.5465116279069767,49,-2,47,0
2015-16,2016-01-13,New Jersey Devils,0,Metropolitan,Eastern,47,2,88,0.5340909090909091,51,-4,47,0
2015-16,2016-01-15,New Jersey Devils,0,Metropolitan,Eastern,47,2,90,0.5222222222222223,51,-4,47,0
2015-16,2016-01-16,New Jersey Devils,2,Metropolitan,Eastern,49,2,92,0.532608695652174,53,-4,49,0
2015-16,2016-01-20,New Jersey Devils,2,Metropolitan,Eastern,51,2,94,0.5425531914893617,54,-3,51,0
2015-16,2016-01-22,New Jersey Devils,2,Metropolitan,Eastern,53,2,96,0.5520833333333334,54,-1,53,0
2015-16,2016-01-24,New Jersey Devils,2,Metropolitan,Eastern,55,2,98,0.5612244897959183,56,-1,55,0
2015-16,2016-01-27,New Jersey Devils,0,Metropolitan,Eastern,55,2,100,0.55,56,-1,55,0
2015-16,2016-02-03,New Jersey Devils,2,Metropolitan,Eastern,57,2,102,0.5588235294117647,58,-1,57,0
2015-16,2016-02-05,New Jersey Devils,1,Metropolitan,Eastern,58,2,104,0.5576923076923077,58,0,58,0
2015-16,2016-02-06,New Jersey Devils,1,Metropolitan,Eastern,59,2,106,0.5566037735849056,59,0,58,1
2015-16,2016-02-09,New Jersey Devils,0,Metropolitan,Eastern,59,2,108,0.5462962962962963,61,-2,60,-1
2015-16,2016-02-10,New Jersey Devils,2,Metropolitan,Eastern,61,2,110,0.5545454545454546,62,-1,61,0
2015-16,2016-02-13,New Jersey Devils,2,Metropolitan,Eastern,63,2,112,0.5625,64,-1,63,0
2015-16,2016-02-14,New Jersey Devils,2,Metropolitan,Eastern,65,2,114,0.5701754385964912,65,0,64,1
2015-16,2016-02-17,New Jersey Devils,0,Metropolitan,Eastern,65,2,116,0.5603448275862069,66,-1,64,1
2015-16,2016-02-20,New Jersey Devils,0,Metropolitan,Eastern,65,2,118,0.5508474576271186,69,-4,66,-1
2015-16,2016-02-21,New Jersey Devils,0,Metropolitan,Eastern,65,2,120,0.5416666666666666,69,-4,68,-3
2015-16,2016-02-24,New Jersey Devils,2,Metropolitan,Eastern,67,2,122,0.5491803278688525,71,-4,68,-1
2015-16,2016-02-26,New Jersey Devils,0,Metropolitan,Eastern,67,2,124,0.5403225806451613,73,-6,68,-1
2015-16,2016-02-27,New Jersey Devils,0,Metropolitan,Eastern,67,2,126,0.5317460317460317,73,-6,70,-3
2015-16,2016-03-02,New Jersey Devils,0,Metropolitan,Eastern,67,2,128,0.5234375,75,-8,72,-5
2015-16,2016-03-04,New Jersey Devils,2,Metropolitan,Eastern,69,2,130,0.5307692307692308,77,-8,74,-5
2015-16,2016-03-05,New Jersey Devils,0,Metropolitan,Eastern,69,2,132,0.5227272727272727,77,-8,74,-5
2015-16,2016-03-06,New Jersey Devils,0,Metropolitan,Eastern,69,2,134,0.5149253731343284,79,-10,75,-6
2015-16,2016-03-11,New Jersey Devils,2,Metropolitan,Eastern,71,2,136,0.5220588235294118,82,-11,76,-5
2015-16,2016-03-13,New Jersey Devils,2,Metropolitan,Eastern,73,2,138,0.5289855072463768,82,-9,79,-6
2015-16,2016-03-15,New Jersey Devils,0,Metropolitan,Eastern,73,2,140,0.5214285714285715,85,-12,79,-6
2015-16,2016-03-17,New Jersey Devils,2,Metropolitan,Eastern,75,2,142,0.528169014084507,85,-10,81,-6
2015-16,2016-03-19,New Jersey Devils,0,Metropolitan,Eastern,75,2,144,0.5208333333333334,86,-11,83,-8
2015-16,2016-03-20,New Jersey Devils,2,Metropolitan,Eastern,77,2,146,0.5273972602739726,88,-11,83,-6
2015-16,2016-03-24,New Jersey Devils,2,Metropolitan,Eastern,79,2,148,0.5337837837837838,88,-9,85,-6
2015-16,2016-03-25,New Jersey Devils,1,Metropolitan,Eastern,80,2,150,0.5333333333333333,88,-8,85,-5
2015-16,2016-03-27,New Jersey Devils,0,Metropolitan,Eastern,80,2,152,0.5263157894736842,92,-12,85,-5
2015-16,2016-03-29,New Jersey Devils,2,Metropolitan,Eastern,82,2,154,0.5324675324675324,94,-12,87,-5
2015-16,2016-03-31,New Jersey Devils,0,Metropolitan,Eastern,82,2,156,0.5256410256410257,95,-13,88,-6
2015-16,2016-04-02,New Jersey Devils,0,Metropolitan,Eastern,82,2,158,0.5189873417721519,95,-13,91,-9
2015-16,2016-04-05,New Jersey Devils,0,Metropolitan,Eastern,82,2,160,0.5125,99,-17,91,-9
2015-16,2016-04-07,New Jersey Devils,0,Metropolitan,Eastern,82,2,162,0.5061728395061729,99,-17,93,-11
2015-16,2016-04-09,New Jersey Devils,2,Metropolitan,Eastern,84,2,164,0.5121951219512195,101,-17,93,-9
2015-16,2015-10-09,New York Islanders,1,Metropolitan,Eastern,1,2,2,0.5,1,0,0,1
2015-16,2015-10-11,New York Islanders,0,Metropolitan,Eastern,1,2,4,0.25,1,0,1,0
2015-16,2015-10-12,New York Islanders,2,Metropolitan,Eastern,3,2,6,0.5,3,0,2,1
2015-16,2015-10-15,New York Islanders,2,Metropolitan,Eastern,5,2,8,0.625,5,0,5,0
2015-16,2015-10-17,New York Islanders,2,Metropolitan,Eastern,7,2,10,0.7,6,1,6,1
2015-16,2015-10-20,New York Islanders,2,Metropolitan,Eastern,9,2,12,0.75,6,3,6,3
2015-16,2015-10-23,New York Islanders,0,Metropolitan,Eastern,9,2,14,0.6428571428571429,9,0,7,2
2015-16,2015-10-25,New York Islanders,2,Metropolitan,Eastern,11,2,16,0.6875,11,0,9,2
2015-16,2015-10-26,New York Islanders,2,Metropolitan,Eastern,13,2,18,0.7222222222222222,12,1,9,4
2015-16,2015-10-29,New York Islanders,1,Metropolitan,Eastern,14,2,20,0.7,12,2,11,3
2015-16,2015-10-31,New York Islanders,1,Metropolitan,Eastern,15,2,22,0.6818181818181818,15,0,12,3
2015-16,2015-11-02,New York Islanders,0,Metropolitan,Eastern,15,2,24,0.625,15,0,13,2
2015-16,2015-11-04,New York Islanders,2,Metropolitan,Eastern,17,2,26,0.6538461538461539,16,1,13,4
2015-16,2015-11-06,New York Islanders,0,Metropolitan,Eastern,17,2,28,0.6071428571428571,17,0,13,4
2015-16,2015-11-08,New York Islanders,0,Metropolitan,Eastern,17,2,30,0.5666666666666667,18,-1,16,1
2015-16,2015-11-11,New York Islanders,2,Metropolitan,Eastern,19,2,32,0.59375,19,0,17,2
2015-16,2015-11-13,New York Islanders,0,Metropolitan,Eastern,19,2,34,0.5588235294117647,20,-1,18,1
2015-16,2015-11-14,New York Islanders,2,Metropolitan,Eastern,21,2,36,0.5833333333333334,21,0,18,3
2015-16,2015-11-17,New York Islanders,2,Metropolitan,Eastern,23,2,38,0.6052631578947368,23,0,19,4
2015-16,2015-11-21,New York Islanders,0,Metropolitan,Eastern,23,2,40,0.575,24,-1,21,2
2015-16,2015-11-23,New York Islanders,0,Metropolitan,Eastern,23,2,42,0.5476190476190477,24,-1,23,0
2015-16,2015-11-26,New York Islanders,2,Metropolitan,Eastern,25,2,44,0.5681818181818182,26,-1,25,0
2015-16,2015-11-28,New York Islanders,1,Metropolitan,Eastern,26,2,46,0.5652173913043478,27,-1,26,0
2015-16,2015-11-29,New York Islanders,2,Metropolitan,Eastern,28,2,48,0.5833333333333334,28,0,27,1
2015-16,2015-12-01,New York Islanders,2,Metropolitan,Eastern,30,2,50,0.6,30,0,27,3
2015-16,2015-12-03,New York Islanders,2,Metropolitan,Eastern,32,2,52,0.6153846153846154,32,0,28,4
2015-16,2015-12-05,New York Islanders,2,Metropolitan,Eastern,34,2,54,0.6296296296296297,34,0,30,4
2015-16,2015-12-06,New York Islanders,1,Metropolitan,Eastern,35,2,56,0.625,35,0,30,5
2015-16,2015-12-09,New York Islanders,2,Metropolitan,Eastern,37,2,58,0.6379310344827587,37,0,31,6
2015-16,2015-12-13,New York Islanders,2,Metropolitan,Eastern,39,2,60,0.65,39,0,34,5
2015-16,2015-12-13,New York Islanders,2,Metropolitan,Eastern,41,2,62,0.6612903225806451,39,2,34,7
2015-16,2015-12-16,New York Islanders,0,Metropolitan,Eastern,41,2,64,0.640625,41,0,36,5
2015-16,2015-12-18,New York Islanders,0,Metropolitan,Eastern,41,2,66,0.6212121212121212,41,0,36,5
2015-16,2015-12-20,New York Islanders,0,Metropolitan,Eastern,41,2,68,0.6029411764705882,41,0,39,2
2015-16,2015-12-22,New York Islanders,2,Metropolitan,Eastern,43,2,70,0.6142857142857143,42,1,39,4
2015-16,2015-12-27,New York Islanders,0,Metropolitan,Eastern,43,2,72,0.5972222222222222,43,0,42,1
2015-16,2015-12-30,New York Islanders,2,Metropolitan,Eastern,45,2,74,0.6081081081081081,44,1,42,3
2015-16,2015-12-31,New York Islanders,2,Metropolitan,Eastern,47,2,76,0.618421052631579,46,1,43,4
2015-16,2016-01-03,New York Islanders,0,Metropolitan,Eastern,47,2,78,0.6025641025641025,46,1,44,3
2015-16,2016-01-03,New York Islanders,2,Metropolitan,Eastern,49,2,80,0.6125,46,3,44,5
2015-16,2016-01-08,New York Islanders,0,Metropolitan,Eastern,49,2,82,0.5975609756097561,48,1,44,5
2015-16,2016-01-09,New York Islanders,0,Metropolitan,Eastern,49,2,84,0.5833333333333334,49,0,45,4
2015-16,2016-01-13,New York Islanders,2,Metropolitan,Eastern,51,2,86,0.5930232558139535,51,0,47,4
2015-16,2016-01-15,New York Islanders,2,Metropolitan,Eastern,53,2,88,0.6022727272727273,51,2,47,6
2015-16,2016-01-17,New York Islanders,1,Metropolitan,Eastern,54,2,90,0.6,53,1,50,4
2015-16,2016-01-23,New York Islanders,2,Metropolitan,Eastern,56,2,92,0.6086956521739131,56,0,53,3
2015-16,2016-01-26,New York Islanders,0,Metropolitan,Eastern,56,2,94,0.5957446808510638,56,0,55,1
2015-16,2016-02-03,New York Islanders,2,Metropolitan,Eastern,58,2,96,0.6041666666666666,58,0,57,1
2015-16,2016-02-05,New York Islanders,0,Metropolitan,Eastern,58,2,98,0.5918367346938775,58,0,58,0
2015-16,2016-02-06,New York Islanders,0,Metropolitan,Eastern,58,2,100,0.58,59,-1,58,0
2015-16,2016-02-07,New York Islanders,2,Metropolitan,Eastern,60,2,102,0.5882352941176471,60,0,59,1
2015-16,2016-02-10,New York Islanders,2,Metropolitan,Eastern,62,2,104,0.5961538461538461,62,0,61,1
2015-16,2016-02-12,New York Islanders,2,Metropolitan,Eastern,64,2,106,0.6037735849056604,64,0,61,3
2015-16,2016-02-14,New York Islanders,0,Metropolitan,Eastern,64,2,108,0.5925925925925926,65,-1,64,0
2015-16,2016-02-15,New York Islanders,2,Metropolitan,Eastern,66,2,110,0.6,66,0,64,2
2015-16,2016-02-19,New York Islanders,1,Metropolitan,Eastern,67,2,112,0.5982142857142857,67,0,66,1
2015-16,2016-02-20,New York Islanders,2,Metropolitan,Eastern,69,2,114,0.6052631578947368,69,0,66,3
2015-16,2016-02-24,New York Islanders,2,Metropolitan,Eastern,71,2,116,0.6120689655172413,71,0,68,3
2015-16,2016-02-26,New York Islanders,2,Metropolitan,Eastern,73,2,118,0.6186440677966102,73,0,68,5
2015-16,2016-02-29,New York Islanders,0,Metropolitan,Eastern,73,2,120,0.6083333333333333,73,0,70,3
2015-16,2016-03-02,New York Islanders,2,Metropolitan,Eastern,75,2,122,0.6147540983606558,75,0,72,3
2015-16,2016-03-04,New York Islanders,2,Metropolitan,Eastern,77,2,124,0.6209677419354839,77,0,74,3
2015-16,2016-03-06,New York Islanders,2,Metropolitan,Eastern,79,2,126,0.626984126984127,79,0,75,4
2015-16,2016-03-09,New York Islanders,2,Metropolitan,Eastern,81,2,128,0.6328125,81,0,75,6
2015-16,2016-03-10,New York Islanders,1,Metropolitan,Eastern,82,2,130,0.6307692307692307,82,0,75,7
2015-16,2016-03-12,New York Islanders,0,Metropolitan,Eastern,82,2,132,0.6212121212121212,82,0,78,4
2015-16,2016-03-14,New York Islanders,2,Metropolitan,Eastern,84,2,134,0.6268656716417911,84,0,79,5
2015-16,2016-03-15,New York Islanders,1,Metropolitan,Eastern,85,2,136,0.625,85,0,79,6
2015-16,2016-03-18,New York Islanders,0,Metropolitan,Eastern,85,2,138,0.6159420289855072,85,0,81,4
2015-16,2016-03-20,New York Islanders,0,Metropolitan,Eastern,85,2,140,0.6071428571428571,88,-3,83,2
2015-16,2016-03-21,New York Islanders,0,Metropolitan,Eastern,85,2,142,0.5985915492957746,88,-3,83,2
2015-16,2016-03-23,New York Islanders,2,Metropolitan,Eastern,87,2,144,0.6041666666666666,88,-1,83,4
2015-16,2016-03-25,New York Islanders,0,Metropolitan,Eastern,87,2,146,0.5958904109589042,88,-1,85,2
2015-16,2016-03-26,New York Islanders,2,Metropolitan,Eastern,89,2,148,0.6013513513513513,90,-1,85,4
2015-16,2016-03-29,New York Islanders,2,Metropolitan,Eastern,91,2,150,0.6066666666666667,94,-3,87,4
2015-16,2016-03-31,New York Islanders,2,Metropolitan,Eastern,93,2,152,0.6118421052631579,95,-2,88,5
2015-16,2016-04-02,New York Islanders,0,Metropolitan,Eastern,93,2,154,0.6038961038961039,95,-2,91,2
2015-16,2016-04-04,New York Islanders,2,Metropolitan,Eastern,95,2,156,0.6089743589743589,97,-2,91,4
2015-16,2016-04-05,New York Islanders,2,Metropolitan,Eastern,97,2,158,0.6139240506329114,99,-2,91,6
2015-16,2016-04-07,New York Islanders,2,Metropolitan,Eastern,99,2,160,0.61875,99,0,93,6
2015-16,2016-04-09,New York Islanders,1,Metropolitan,Eastern,100,2,162,0.6172839506172839,101,-1,93,7
2015-16,2016-04-10,New York Islanders,0,Metropolitan,Eastern,100,2,164,0.6097560975609756,101,-1,93,7
2015-16,2015-10-08,New York Rangers,2,Metropolitan,Eastern,2,2,2,1.0,0,2,0,2
2015-16,2015-10-09,New York Rangers,2,Metropolitan,Eastern,4,2,4,1.0,1,3,0,4
2015-16,2015-10-10,New York Rangers,2,Metropolitan,Eastern,6,2,6,1.0,1,5,1,5
2015-16,2015-10-13,New York Rangers,0,Metropolitan,Eastern,6,2,8,0.75,3,3,3,3
2015-16,2015-10-15,New York Rangers,0,Metropolitan,Eastern,6,2,10,0.6,5,1,5,1
2015-16,2015-10-18,New York Rangers,1,Metropolitan,Eastern,7,2,12,0.5833333333333334,6,1,6,1
2015-16,2015-10-19,New York Rangers,2,Metropolitan,Eastern,9,2,14,0.6428571428571429,6,3,6,3
2015-16,2015-10-22,New York Rangers,2,Metropolitan,Eastern,11,2,16,0.6875,8,3,7,4
2015-16,2015-10-24,New York Rangers,1,Metropolitan,Eastern,12,2,18,0.6666666666666666,9,3,8,4
2015-16,2015-10-25,New York Rangers,2,Metropolitan,Eastern,14,2,20,0.7,11,3,9,5
2015-16,2015-10-30,New York Rangers,2,Metropolitan,Eastern,16,2,22,0.7272727272727273,14,2,11,5
2015-16,2015-11-04,New York Rangers,2,Metropolitan,Eastern,18,2,24,0.75,16,2,13,5
2015-16,2015-11-07,New York Rangers,2,Metropolitan,Eastern,20,2,26,0.7692307692307693,18,2,15,5
2015-16,2015-11-08,New York Rangers,2,Metropolitan,Eastern,22,2,28,0.7857142857142857,18,4,16,6
2015-16,2015-11-11,New York Rangers,2,Metropolitan,Eastern,24,2,30,0.8,19,5,17,7
2015-16,2015-11-13,New York Rangers,2,Metropolitan,Eastern,26,2,32,0.8125,20,6,18,8
2015-16,2015-11-14,New York Rangers,2,Metropolitan,Eastern,28,2,34,0.8235294117647058,21,7,18,10
2015-16,2015-11-16,New York Rangers,2,Metropolitan,Eastern,30,2,36,0.8333333333333334,21,9,19,11
2015-16,2015-11-20,New York Rangers,0,Metropolitan,Eastern,30,2,38,0.7894736842105263,24,6,21,9
2015-16,2015-11-22,New York Rangers,2,Metropolitan,Eastern,32,2,40,0.8,24,8,23,9
2015-16,2015-11-24,New York Rangers,2,Metropolitan,Eastern,34,2,42,0.8095238095238095,24,10,23,11
2015-16,2015-11-26,New York Rangers,0,Metropolitan,Eastern,34,2,44,0.7727272727272727,26,8,25,9
2015-16,2015-11-27,New York Rangers,0,Metropolitan,Eastern,34,2,46,0.7391304347826086,26,8,25,9
2015-16,2015-11-28,New York Rangers,0,Metropolitan,Eastern,34,2,48,0.7083333333333334,27,7,26,8
2015-16,2015-12-01,New York Rangers,2,Metropolitan,Eastern,36,2,50,0.72,30,6,27,9
2015-16,2015-12-03,New York Rangers,1,Metropolitan,Eastern,37,2,52,0.7115384615384616,32,5,28,9
2015-16,2015-12-04,New York Rangers,0,Metropolitan,Eastern,37,2,54,0.6851851851851852,32,5,28,9
2015-16,2015-12-07,New York Rangers,2,Metropolitan,Eastern,39,2,56,0.6964285714285714,35,4,31,8
2015-16,2015-12-10,New York Rangers,0,Metropolitan,Eastern,39,2,58,0.6724137931034483,37,2,32,7
2015-16,2015-12-12,New York Rangers,0,Metropolitan,Eastern,39,2,60,0.65,37,2,34,5
2015-16,2015-12-13,New York Rangers,1,Metropolitan,Eastern,40,2,62,0.6451612903225806,39,1,34,6
2015-16,2015-12-16,New York Rangers,2,Metropolitan,Eastern,42,2,64,0.65625,41,1,36,6
2015-16,2015-12-18,New York Rangers,0,Metropolitan,Eastern,42,2,66,0.6363636363636364,41,1,36,6
2015-16,2015-12-19,New York Rangers,0,Metropolitan,Eastern,42,2,68,0.6176470588235294,41,1,38,4
2015-16,2015-12-21,New York Rangers,0,Metropolitan,Eastern,42,2,70,0.6,41,1,39,3
2015-16,2015-12-23,New York Rangers,2,Metropolitan,Eastern,44,2,72,0.6111111111111112,43,1,40,4
2015-16,2015-12-29,New York Rangers,0,Metropolitan,Eastern,44,2,74,0.5945945945945946,43,1,42,2
2015-16,2015-12-31,New York Rangers,2,Metropolitan,Eastern,46,2,76,0.6052631578947368,46,0,43,3
2015-16,2016-01-03,New York Rangers,0,Metropolitan,Eastern,46,2,78,0.5897435897435898,46,0,44,2
2015-16,2016-01-06,New York Rangers,2,Metropolitan,Eastern,48,2,80,0.6,48,0,44,4
2015-16,2016-01-09,New York Rangers,1,Metropolitan,Eastern,49,2,82,0.5975609756097561,49,0,45,4
2015-16,2016-01-12,New York Rangers,2,Metropolitan,Eastern,51,2,84,0.6071428571428571,49,2,47,4
2015-16,2016-01-15,New York Rangers,0,Metropolitan,Eastern,51,2,86,0.5930232558139535,51,0,47,4
2015-16,2016-01-16,New York Rangers,2,Metropolitan,Eastern,53,2,88,0.6022727272727273,53,0,49,4
2015-16,2016-01-17,New York Rangers,0,Metropolitan,Eastern,53,2,90,0.5888888888888889,53,0,50,3
2015-16,2016-01-20,New York Rangers,2,Metropolitan,Eastern,55,2,92,0.5978260869565217,54,1,51,4
2015-16,2016-01-23,New York Rangers,2,Metropolitan,Eastern,57,2,94,0.6063829787234043,56,1,53,4
2015-16,2016-01-24,New York Rangers,0,Metropolitan,Eastern,57,2,96,0.59375,56,1,55,2
2015-16,2016-01-26,New York Rangers,2,Metropolitan,Eastern,59,2,98,0.6020408163265306,56,3,55,4
2015-16,2016-02-03,New York Rangers,0,Metropolitan,Eastern,59,2,100,0.59,58,1,57,2
2015-16,2016-02-05,New York Rangers,2,Metropolitan,Eastern,61,2,102,0.5980392156862745,58,3,58,3
2015-16,2016-02-06,New York Rangers,2,Metropolitan,Eastern,63,2,104,0.6057692307692307,59,4,58,5
2015-16,2016-02-09,New York Rangers,2,Metropolitan,Eastern,65,2,106,0.6132075471698113,61,4,60,5
2015-16,2016-02-11,New York Rangers,2,Metropolitan,Eastern,67,2,108,0.6203703703703703,62,5,61,6
2015-16,2016-02-13,New York Rangers,1,Metropolitan,Eastern,68,2,110,0.6181818181818182,64,4,63,5
2015-16,2016-02-15,New York Rangers,2,Metropolitan,Eastern,70,2,112,0.625,66,4,64,6
2015-16,2016-02-18,New York Rangers,0,Metropolitan,Eastern,70,2,114,0.6140350877192983,66,4,64,6
2015-16,2016-02-19,New York Rangers,2,Metropolitan,Eastern,72,2,116,0.6206896551724138,67,5,66,6
2015-16,2016-02-22,New York Rangers,2,Metropolitan,Eastern,74,2,118,0.6271186440677966,69,5,68,6
2015-16,2016-02-24,New York Rangers,0,Metropolitan,Eastern,74,2,120,0.6166666666666667,71,3,68,6
2015-16,2016-02-26,New York Rangers,2,Metropolitan,Eastern,76,2,122,0.6229508196721312,73,3,68,8
2015-16,2016-02-27,New York Rangers,2,Metropolitan,Eastern,78,2,124,0.6290322580645161,73,5,70,8
2015-16,2016-03-01,New York Rangers,2,Metropolitan,Eastern,80,2,126,0.6349206349206349,73,7,72,8
2015-16,2016-03-04,New York Rangers,0,Metropolitan,Eastern,80,2,128,0.625,77,3,74,6
2015-16,2016-03-05,New York Rangers,2,Metropolitan,Eastern,82,2,130,0.6307692307692307,77,5,74,8
2015-16,2016-03-06,New York Rangers,0,Metropolitan,Eastern,82,2,132,0.6212121212121212,79,3,75,7
2015-16,2016-03-09,New York Rangers,2,Metropolitan,Eastern,84,2,134,0.6268656716417911,81,3,75,9
2015-16,2016-03-12,New York Rangers,1,Metropolitan,Eastern,85,2,136,0.625,82,3,78,7
2015-16,2016-03-13,New York Rangers,0,Metropolitan,Eastern,85,2,138,0.6159420289855072,82,3,79,6
2015-16,2016-03-17,New York Rangers,2,Metropolitan,Eastern,87,2,140,0.6214285714285714,85,2,81,6
2015-16,2016-03-18,New York Rangers,1,Metropolitan,Eastern,88,2,142,0.6197183098591549,85,3,81,7
2015-16,2016-03-19,New York Rangers,0,Metropolitan,Eastern,88,2,144,0.6111111111111112,86,2,83,5
2015-16,2016-03-21,New York Rangers,2,Metropolitan,Eastern,90,2,146,0.6164383561643836,88,2,83,7
2015-16,2016-03-24,New York Rangers,2,Metropolitan,Eastern,92,2,148,0.6216216216216216,88,4,85,7
2015-16,2016-03-26,New York Rangers,2,Metropolitan,Eastern,94,2,150,0.6266666666666667,90,4,85,9
2015-16,2016-03-27,New York Rangers,1,Metropolitan,Eastern,95,2,152,0.625,92,3,85,10
2015-16,2016-03-31,New York Rangers,0,Metropolitan,Eastern,95,2,154,0.6168831168831169,95,0,88,7
2015-16,2016-04-02,New York Rangers,0,Metropolitan,Eastern,95,2,156,0.6089743589743589,95,0,91,4
2015-16,2016-04-04,New York Rangers,2,Metropolitan,Eastern,97,2,158,0.6139240506329114,97,0,91,6
2015-16,2016-04-05,New York Rangers,2,Metropolitan,Eastern,99,2,160,0.61875,99,0,91,8
2015-16,2016-04-07,New York Rangers,0,Metropolitan,Eastern,99,2,162,0.6111111111111112,99,0,93,6
2015-16,2016-04-09,New York Rangers,2,Metropolitan,Eastern,101,2,164,0.6158536585365854,101,0,93,8
2015-16,2015-10-08,Ottawa Senators,2,Atlantic,Eastern,2,2,2,1.0,2,0,0,2
2015-16,2015-10-10,Ottawa Senators,2,Atlantic,Eastern,4,2,4,1.0,4,0,1,3
2015-16,2015-10-11,Ottawa Senators,0,Atlantic,Eastern,4,2,6,0.6666666666666666,4,0,1,3
2015-16,2015-10-14,Ottawa Senators,2,Atlantic,Eastern,6,2,8,0.75,6,0,3,3
2015-16,2015-10-15,Ottawa Senators,0,Atlantic,Eastern,6,2,10,0.6,6,0,5,1
2015-16,2015-10-17,Ottawa Senators,1,Atlantic,Eastern,7,2,12,0.5833333333333334,7,0,6,1
2015-16,2015-10-22,Ottawa Senators,1,Atlantic,Eastern,8,2,14,0.5714285714285714,8,0,7,1
2015-16,2015-10-24,Ottawa Senators,0,Atlantic,Eastern,8,2,16,0.5,8,0,8,0
2015-16,2015-10-28,Ottawa Senators,2,Atlantic,Eastern,10,2,18,0.5555555555555556,11,-1,10,0
2015-16,2015-10-30,Ottawa Senators,2,Atlantic,Eastern,12,2,20,0.6,12,0,11,1
2015-16,2015-10-31,Ottawa Senators,0,Atlantic,Eastern,12,2,22,0.5454545454545454,12,0,12,0
2015-16,2015-11-04,Ottawa Senators,2,Atlantic,Eastern,14,2,24,0.5833333333333334,14,0,13,1
2015-16,2015-11-06,Ottawa Senators,2,Atlantic,Eastern,16,2,26,0.6153846153846154,16,0,13,3
2015-16,2015-11-08,Ottawa Senators,1,Atlantic,Eastern,17,2,28,0.6071428571428571,16,1,16,1
2015-16,2015-11-11,Ottawa Senators,0,Atlantic,Eastern,17,2,30,0.5666666666666667,17,0,17,0
2015-16,2015-11-13,Ottawa Senators,2,Atlantic,Eastern,19,2,32,0.59375,18,1,18,1
2015-16,2015-11-14,Ottawa Senators,1,Atlantic,Eastern,20,2,34,0.5882352941176471,18,2,18,2
2015-16,2015-11-17,Ottawa Senators,1,Atlantic,Eastern,21,2,36,0.5833333333333334,19,2,19,2
2015-16,2015-11-20,Ottawa Senators,2,Atlantic,Eastern,23,2,38,0.6052631578947368,21,2,21,2
2015-16,2015-11-22,Ottawa Senators,2,Atlantic,Eastern,25,2,40,0.625,24,1,23,2
2015-16,2015-11-25,Ottawa Senators,2,Atlantic,Eastern,27,2,42,0.6428571428571429,24,3,23,4
2015-16,2015-11-26,Ottawa Senators,2,Atlantic,Eastern,29,2,44,0.6590909090909091,25,4,25,4
2015-16,2015-11-29,Ottawa Senators,0,Atlantic,Eastern,29,2,46,0.6304347826086957,28,1,27,2
2015-16,2015-12-02,Ottawa Senators,0,Atlantic,Eastern,29,2,48,0.6041666666666666,29,0,27,2
2015-16,2015-12-04,Ottawa Senators,2,Atlantic,Eastern,31,2,50,0.62,31,0,28,3
2015-16,2015-12-06,Ottawa Senators,2,Atlantic,Eastern,33,2,52,0.6346153846153846,33,0,30,3
2015-16,2015-12-07,Ottawa Senators,0,Atlantic,Eastern,33,2,54,0.6111111111111112,33,0,31,2
2015-16,2015-12-09,Ottawa Senators,2,Atlantic,Eastern,35,2,56,0.625,35,0,31,4
2015-16,2015-12-11,Ottawa Senators,0,Atlantic,Eastern,35,2,58,0.603448275862069,35,0,32,3
2015-16,2015-12-13,Ottawa Senators,0,Atlantic,Eastern,35,2,60,0.5833333333333334,35,0,34,1
2015-16,2015-12-15,Ottawa Senators,2,Atlantic,Eastern,37,2,62,0.5967741935483871,37,0,34,3
2015-16,2015-12-17,Ottawa Senators,0,Atlantic,Eastern,37,2,64,0.578125,38,-1,36,1
2015-16,2015-12-19,Ottawa Senators,2,Atlantic,Eastern,39,2,66,0.5909090909090909,39,0,38,1
2015-16,2015-12-20,Ottawa Senators,0,Atlantic,Eastern,39,2,68,0.5735294117647058,40,-1,39,0
2015-16,2015-12-23,Ottawa Senators,1,Atlantic,Eastern,40,2,70,0.5714285714285714,42,-2,40,0
2015-16,2015-12-27,Ottawa Senators,2,Atlantic,Eastern,42,2,72,0.5833333333333334,43,-1,42,0
2015-16,2015-12-30,Ottawa Senators,0,Atlantic,Eastern,42,2,74,0.5675675675675675,44,-2,42,0
2015-16,2015-12-31,Ottawa Senators,0,Atlantic,Eastern,42,2,76,0.5526315789473685,44,-2,43,-1
2015-16,2016-01-04,Ottawa Senators,0,Atlantic,Eastern,42,2,78,0.5384615384615384,45,-3,44,-2
2015-16,2016-01-05,Ottawa Senators,2,Atlantic,Eastern,44,2,80,0.55,47,-3,44,0
2015-16,2016-01-08,Ottawa Senators,0,Atlantic,Eastern,44,2,82,0.5365853658536586,49,-5,44,0
2015-16,2016-01-10,Ottawa Senators,2,Atlantic,Eastern,46,2,84,0.5476190476190477,49,-3,46,0
2015-16,2016-01-11,Ottawa Senators,0,Atlantic,Eastern,46,2,86,0.5348837209302325,49,-3,47,-1
2015-16,2016-01-14,Ottawa Senators,0,Atlantic,Eastern,46,2,88,0.5227272727272727,49,-3,47,-1
2015-16,2016-01-16,Ottawa Senators,2,Atlantic,Eastern,48,2,90,0.5333333333333333,50,-2,49,-1
2015-16,2016-01-19,Ottawa Senators,2,Atlantic,Eastern,50,2,92,0.5434782608695652,52,-2,50,0
2015-16,2016-01-22,Ottawa Senators,0,Atlantic,Eastern,50,2,94,0.5319148936170213,54,-4,53,-3
2015-16,2016-01-23,Ottawa Senators,0,Atlantic,Eastern,50,2,96,0.5208333333333334,56,-6,53,-3
2015-16,2016-01-24,Ottawa Senators,2,Atlantic,Eastern,52,2,98,0.5306122448979592,56,-4,55,-3
2015-16,2016-01-27,Ottawa Senators,0,Atlantic,Eastern,52,2,100,0.52,57,-5,55,-3
2015-16,2016-02-03,Ottawa Senators,0,Atlantic,Eastern,52,2,102,0.5098039215686274,58,-6,57,-5
2015-16,2016-02-05,Ottawa Senators,0,Atlantic,Eastern,52,2,104,0.5,60,-8,58,-6
2015-16,2016-02-07,Ottawa Senators,2,Atlantic,Eastern,54,2,106,0.5094339622641509,62,-8,59,-5
2015-16,2016-02-09,Ottawa Senators,2,Atlantic,Eastern,56,2,108,0.5185185185185185,62,-6,60,-4
2015-16,2016-02-11,Ottawa Senators,0,Atlantic,Eastern,56,2,110,0.509090909090909,62,-6,61,-5
2015-16,2016-02-12,Ottawa Senators,0,Atlantic,Eastern,56,2,112,0.5,64,-8,61,-5
2015-16,2016-02-14,Ottawa Senators,0,Atlantic,Eastern,56,2,114,0.49122807017543857,66,-10,64,-8
2015-16,2016-02-17,Ottawa Senators,2,Atlantic,Eastern,58,2,116,0.5,67,-9,64,-6
2015-16,2016-02-19,Ottawa Senators,2,Atlantic,Eastern,60,2,118,0.5084745762711864,67,-7,66,-6
2015-16,2016-02-21,Ottawa Senators,2,Atlantic,Eastern,62,2,120,0.5166666666666667,68,-6,68,-6
2015-16,2016-02-24,Ottawa Senators,2,Atlantic,Eastern,64,2,122,0.5245901639344263,71,-7,68,-4
2015-16,2016-02-26,Ottawa Senators,0,Atlantic,Eastern,64,2,124,0.5161290322580645,72,-8,68,-4
2015-16,2016-02-28,Ottawa Senators,2,Atlantic,Eastern,66,2,126,0.5238095238095238,74,-8,70,-4
2015-16,2016-03-02,Ottawa Senators,1,Atlantic,Eastern,67,2,128,0.5234375,76,-9,72,-5
2015-16,2016-03-04,Ottawa Senators,0,Atlantic,Eastern,67,2,130,0.5153846153846153,78,-11,74,-7
2015-16,2016-03-06,Ottawa Senators,2,Atlantic,Eastern,69,2,132,0.5227272727272727,79,-10,75,-6
2015-16,2016-03-06,Ottawa Senators,0,Atlantic,Eastern,69,2,134,0.5149253731343284,79,-10,75,-6
2015-16,2016-03-09,Ottawa Senators,1,Atlantic,Eastern,70,2,136,0.5147058823529411,81,-11,75,-5
2015-16,2016-03-11,Ottawa Senators,0,Atlantic,Eastern,70,2,138,0.5072463768115942,83,-13,76,-6
2015-16,2016-03-13,Ottawa Senators,2,Atlantic,Eastern,72,2,140,0.5142857142857142,85,-13,79,-7
2015-16,2016-03-15,Ottawa Senators,2,Atlantic,Eastern,74,2,142,0.5211267605633803,85,-11,79,-5
2015-16,2016-03-18,Ottawa Senators,0,Atlantic,Eastern,74,2,144,0.5138888888888888,85,-11,81,-7
2015-16,2016-03-19,Ottawa Senators,2,Atlantic,Eastern,76,2,146,0.5205479452054794,85,-9,83,-7
2015-16,2016-03-22,Ottawa Senators,0,Atlantic,Eastern,76,2,148,0.5135135135135135,86,-10,83,-7
2015-16,2016-03-23,Ottawa Senators,0,Atlantic,Eastern,76,2,150,0.5066666666666667,86,-10,83,-7
2015-16,2016-03-26,Ottawa Senators,1,Atlantic,Eastern,77,2,152,0.506578947368421,88,-11,85,-8
2015-16,2016-03-30,Ottawa Senators,2,Atlantic,Eastern,79,2,154,0.512987012987013,88,-9,87,-8
2015-16,2016-04-01,Ottawa Senators,2,Atlantic,Eastern,81,2,156,0.5192307692307693,89,-8,89,-8
2015-16,2016-04-02,Ottawa Senators,0,Atlantic,Eastern,81,2,158,0.5126582278481012,91,-10,91,-10
2015-16,2016-04-05,Ottawa Senators,0,Atlantic,Eastern,81,2,160,0.50625,91,-10,91,-10
2015-16,2016-04-07,Ottawa Senators,2,Atlantic,Eastern,83,2,162,0.5123456790123457,93,-10,93,-10
2015-16,2016-04-09,Ottawa Senators,2,Atlantic,Eastern,85,2,164,0.5182926829268293,93,-8,93,-8
2015-16,2015-10-08,Philadelphia Flyers,1,Metropolitan,Eastern,1,2,2,0.5,0,1,0,1
2015-16,2015-10-10,Philadelphia Flyers,0,Metropolitan,Eastern,1,2,4,0.25,1,0,1,0
2015-16,2015-10-12,Philadelphia Flyers,2,Metropolitan,Eastern,3,2,6,0.5,3,0,2,1
2015-16,2015-10-15,Philadelphia Flyers,2,Metropolitan,Eastern,5,2,8,0.625,5,0,5,0
2015-16,2015-10-20,Philadelphia Flyers,0,Metropolitan,Eastern,5,2,10,0.5,6,-1,6,-1
2015-16,2015-10-22,Philadelphia Flyers,2,Metropolitan,Eastern,7,2,12,0.5833333333333334,8,-1,7,0
2015-16,2015-10-24,Philadelphia Flyers,2,Metropolitan,Eastern,9,2,14,0.6428571428571429,9,0,8,1
2015-16,2015-10-27,Philadelphia Flyers,1,Metropolitan,Eastern,10,2,16,0.625,12,-2,9,1
2015-16,2015-10-29,Philadelphia Flyers,0,Metropolitan,Eastern,10,2,18,0.5555555555555556,12,-2,11,-1
2015-16,2015-10-30,Philadelphia Flyers,0,Metropolitan,Eastern,10,2,20,0.5,14,-4,11,-1
2015-16,2015-11-03,Philadelphia Flyers,0,Metropolitan,Eastern,10,2,22,0.45454545454545453,15,-5,13,-3
2015-16,2015-11-04,Philadelphia Flyers,0,Metropolitan,Eastern,10,2,24,0.4166666666666667,16,-6,13,-3
2015-16,2015-11-06,Philadelphia Flyers,1,Metropolitan,Eastern,11,2,26,0.4230769230769231,17,-6,13,-2
2015-16,2015-11-08,Philadelphia Flyers,2,Metropolitan,Eastern,13,2,28,0.4642857142857143,18,-5,16,-3
2015-16,2015-11-11,Philadelphia Flyers,0,Metropolitan,Eastern,13,2,30,0.43333333333333335,19,-6,17,-4
2015-16,2015-11-13,Philadelphia Flyers,0,Metropolitan,Eastern,13,2,32,0.40625,20,-7,18,-5
2015-16,2015-11-15,Philadelphia Flyers,2,Metropolitan,Eastern,15,2,34,0.4411764705882353,21,-6,19,-4
2015-16,2015-11-18,Philadelphia Flyers,1,Metropolitan,Eastern,16,2,36,0.4444444444444444,23,-7,19,-3
2015-16,2015-11-20,Philadelphia Flyers,1,Metropolitan,Eastern,17,2,38,0.4473684210526316,24,-7,21,-4
2015-16,2015-11-22,Philadelphia Flyers,0,Metropolitan,Eastern,17,2,40,0.425,24,-7,23,-6
2015-16,2015-11-24,Philadelphia Flyers,2,Metropolitan,Eastern,19,2,42,0.4523809523809524,24,-5,23,-4
2015-16,2015-11-26,Philadelphia Flyers,0,Metropolitan,Eastern,19,2,44,0.4318181818181818,26,-7,25,-6
2015-16,2015-11-27,Philadelphia Flyers,2,Metropolitan,Eastern,21,2,46,0.45652173913043476,26,-5,25,-4
2015-16,2015-11-28,Philadelphia Flyers,2,Metropolitan,Eastern,23,2,48,0.4791666666666667,27,-4,26,-3
2015-16,2015-12-02,Philadelphia Flyers,2,Metropolitan,Eastern,25,2,50,0.5,30,-5,27,-2
2015-16,2015-12-05,Philadelphia Flyers,2,Metropolitan,Eastern,27,2,52,0.5192307692307693,34,-7,30,-3
2015-16,2015-12-06,Philadelphia Flyers,0,Metropolitan,Eastern,27,2,54,0.5,35,-8,30,-3
2015-16,2015-12-09,Philadelphia Flyers,1,Metropolitan,Eastern,28,2,56,0.5,37,-9,31,-3
2015-16,2015-12-11,Philadelphia Flyers,2,Metropolitan,Eastern,30,2,58,0.5172413793103449,37,-7,32,-2
2015-16,2015-12-12,Philadelphia Flyers,0,Metropolitan,Eastern,30,2,60,0.5,37,-7,34,-4
2015-16,2015-12-16,Philadelphia Flyers,2,Metropolitan,Eastern,32,2,62,0.5161290322580645,41,-9,36,-4
2015-16,2015-12-18,Philadelphia Flyers,2,Metropolitan,Eastern,34,2,64,0.53125,41,-7,36,-2
2015-16,2015-12-20,Philadelphia Flyers,1,Metropolitan,Eastern,35,2,66,0.5303030303030303,41,-6,39,-4
2015-16,2015-12-22,Philadelphia Flyers,2,Metropolitan,Eastern,37,2,68,0.5441176470588235,42,-5,39,-2
2015-16,2015-12-28,Philadelphia Flyers,0,Metropolitan,Eastern,37,2,70,0.5285714285714286,43,-6,42,-5
2015-16,2015-12-31,Philadelphia Flyers,0,Metropolitan,Eastern,37,2,72,0.5138888888888888,46,-9,43,-6
2015-16,2016-01-02,Philadelphia Flyers,0,Metropolitan,Eastern,37,2,74,0.5,46,-9,43,-6
2015-16,2016-01-06,Philadelphia Flyers,2,Metropolitan,Eastern,39,2,76,0.5131578947368421,48,-9,44,-5
2015-16,2016-01-08,Philadelphia Flyers,2,Metropolitan,Eastern,41,2,78,0.5256410256410257,48,-7,44,-3
2015-16,2016-01-09,Philadelphia Flyers,2,Metropolitan,Eastern,43,2,80,0.5375,49,-6,45,-2
2015-16,2016-01-14,Philadelphia Flyers,2,Metropolitan,Eastern,45,2,82,0.5487804878048781,51,-6,47,-2
2015-16,2016-01-16,Philadelphia Flyers,1,Metropolitan,Eastern,46,2,84,0.5476190476190477,53,-7,49,-3
2015-16,2016-01-18,Philadelphia Flyers,2,Metropolitan,Eastern,48,2,86,0.5581395348837209,53,-5,50,-2
2015-16,2016-01-20,Philadelphia Flyers,0,Metropolitan,Eastern,48,2,88,0.5454545454545454,54,-6,51,-3
2015-16,2016-01-22,Philadelphia Flyers,0,Metropolitan,Eastern,48,2,90,0.5333333333333333,54,-6,53,-5
2015-16,2016-01-26,Philadelphia Flyers,0,Metropolitan,Eastern,48,2,92,0.5217391304347826,56,-8,55,-7
2015-16,2016-01-28,Philadelphia Flyers,2,Metropolitan,Eastern,50,2,94,0.5319148936170213,56,-6,55,-5
2015-16,2016-02-03,Philadelphia Flyers,2,Metropolitan,Eastern,52,2,96,0.5416666666666666,58,-6,57,-5
2015-16,2016-02-05,Philadelphia Flyers,2,Metropolitan,Eastern,54,2,98,0.5510204081632653,58,-4,58,-4
2015-16,2016-02-06,Philadelphia Flyers,1,Metropolitan,Eastern,55,2,100,0.55,59,-4,58,-3
2015-16,2016-02-07,Philadelphia Flyers,0,Metropolitan,Eastern,55,2,102,0.5392156862745098,60,-5,59,-4
2015-16,2016-02-10,Philadelphia Flyers,0,Metropolitan,Eastern,55,2,104,0.5288461538461539,62,-7,61,-6
2015-16,2016-02-12,Philadelphia Flyers,2,Metropolitan,Eastern,57,2,106,0.5377358490566038,64,-7,61,-4
2015-16,2016-02-13,Philadelphia Flyers,1,Metropolitan,Eastern,58,2,108,0.5370370370370371,64,-6,63,-5
2015-16,2016-02-15,Philadelphia Flyers,0,Metropolitan,Eastern,58,2,110,0.5272727272727272,66,-8,64,-6
2015-16,2016-02-17,Philadelphia Flyers,2,Metropolitan,Eastern,60,2,112,0.5357142857142857,66,-6,64,-4
2015-16,2016-02-20,Philadelphia Flyers,1,Metropolitan,Eastern,61,2,114,0.5350877192982456,69,-8,66,-5
2015-16,2016-02-21,Philadelphia Flyers,2,Metropolitan,Eastern,63,2,116,0.5431034482758621,69,-6,68,-5
2015-16,2016-02-24,Philadelphia Flyers,0,Metropolitan,Eastern,63,2,118,0.5338983050847458,71,-8,68,-5
2015-16,2016-02-26,Philadelphia Flyers,2,Metropolitan,Eastern,65,2,120,0.5416666666666666,73,-8,68,-3
2015-16,2016-02-27,Philadelphia Flyers,2,Metropolitan,Eastern,67,2,122,0.5491803278688525,73,-6,70,-3
2015-16,2016-03-01,Philadelphia Flyers,2,Metropolitan,Eastern,69,2,124,0.5564516129032258,73,-4,72,-3
2015-16,2016-03-04,Philadelphia Flyers,0,Metropolitan,Eastern,69,2,126,0.5476190476190477,77,-8,74,-5
2015-16,2016-03-06,Philadelphia Flyers,2,Metropolitan,Eastern,71,2,128,0.5546875,79,-8,75,-4
2015-16,2016-03-08,Philadelphia Flyers,2,Metropolitan,Eastern,73,2,130,0.5615384615384615,79,-6,75,-2
2015-16,2016-03-12,Philadelphia Flyers,2,Metropolitan,Eastern,75,2,132,0.5681818181818182,82,-7,78,-3
2015-16,2016-03-13,Philadelphia Flyers,1,Metropolitan,Eastern,76,2,134,0.5671641791044776,82,-6,79,-3
2015-16,2016-03-15,Philadelphia Flyers,2,Metropolitan,Eastern,78,2,136,0.5735294117647058,85,-7,79,-1
2015-16,2016-03-17,Philadelphia Flyers,2,Metropolitan,Eastern,80,2,138,0.5797101449275363,85,-5,81,-1
2015-16,2016-03-19,Philadelphia Flyers,0,Metropolitan,Eastern,80,2,140,0.5714285714285714,86,-6,83,-3
2015-16,2016-03-21,Philadelphia Flyers,2,Metropolitan,Eastern,82,2,142,0.5774647887323944,88,-6,83,-1
2015-16,2016-03-22,Philadelphia Flyers,1,Metropolitan,Eastern,83,2,144,0.5763888888888888,88,-5,83,0
2015-16,2016-03-25,Philadelphia Flyers,2,Metropolitan,Eastern,85,2,146,0.5821917808219178,88,-3,85,0
2015-16,2016-03-27,Philadelphia Flyers,0,Metropolitan,Eastern,85,2,148,0.5743243243243243,92,-7,85,0
2015-16,2016-03-28,Philadelphia Flyers,2,Metropolitan,Eastern,87,2,150,0.58,92,-5,87,0
2015-16,2016-03-31,Philadelphia Flyers,2,Metropolitan,Eastern,89,2,152,0.5855263157894737,95,-6,88,1
2015-16,2016-04-02,Philadelphia Flyers,2,Metropolitan,Eastern,91,2,154,0.5909090909090909,95,-4,91,0
2015-16,2016-04-03,Philadelphia Flyers,0,Metropolitan,Eastern,91,2,156,0.5833333333333334,95,-4,91,0
2015-16,2016-04-07,Philadelphia Flyers,1,Metropolitan,Eastern,92,2,158,0.5822784810126582,99,-7,93,-1
2015-16,2016-04-07,Philadelphia Flyers,0,Metropolitan,Eastern,92,2,160,0.575,99,-7,93,-1
2015-16,2016-04-09,Philadelphia Flyers,2,Metropolitan,Eastern,94,2,162,0.5802469135802469,101,-7,93,1
2015-16,2016-04-10,Philadelphia Flyers,2,Metropolitan,Eastern,96,2,164,0.5853658536585366,101,-5,93,3
2015-16,2015-10-09,Pittsburgh Penguins,0,Metropolitan,Eastern,0,2,2,0.0,1,-1,0,0
2015-16,2015-10-11,Pittsburgh Penguins,0,Metropolitan,Eastern,0,2,4,0.0,1,-1,1,-1
2015-16,2015-10-13,Pittsburgh Penguins,0,Metropolitan,Eastern,0,2,6,0.0,3,-3,3,-3
2015-16,2015-10-15,Pittsburgh Penguins,2,Metropolitan,Eastern,2,2,8,0.25,5,-3,5,-3
2015-16,2015-10-17,Pittsburgh Penguins,2,Metropolitan,Eastern,4,2,10,0.4,6,-2,6,-2
2015-16,2015-10-20,Pittsburgh Penguins,2,Metropolitan,Eastern,6,2,12,0.5,6,0,6,0
2015-16,2015-10-22,Pittsburgh Penguins,0,Metropolitan,Eastern,6,2,14,0.42857142857142855,8,-2,7,-1
2015-16,2015-10-25,Pittsburgh Penguins,2,Metropolitan,Eastern,8,2,16,0.5,11,-3,9,-1
2015-16,2015-10-29,Pittsburgh Penguins,2,Metropolitan,Eastern,10,2,18,0.5555555555555556,12,-2,11,-1
2015-16,2015-10-29,Pittsburgh Penguins,2,Metropolitan,Eastern,12,2,20,0.6,12,0,11,1
2015-16,2015-10-31,Pittsburgh Penguins,2,Metropolitan,Eastern,14,2,22,0.6363636363636364,15,-1,12,2
2015-16,2015-11-05,Pittsburgh Penguins,2,Metropolitan,Eastern,16,2,24,0.6666666666666666,16,0,13,3
2015-16,2015-11-07,Pittsburgh Penguins,2,Metropolitan,Eastern,18,2,26,0.6923076923076923,18,0,15,3
2015-16,2015-11-08,Pittsburgh Penguins,0,Metropolitan,Eastern,18,2,28,0.6428571428571429,18,0,16,2
2015-16,2015-11-12,Pittsburgh Penguins,2,Metropolitan,Eastern,20,2,30,0.6666666666666666,20,0,17,3
2015-16,2015-11-14,Pittsburgh Penguins,0,Metropolitan,Eastern,20,2,32,0.625,21,-1,18,2
2015-16,2015-11-15,Pittsburgh Penguins,0,Metropolitan,Eastern,20,2,34,0.5882352941176471,21,-1,19,1
2015-16,2015-11-18,Pittsburgh Penguins,2,Metropolitan,Eastern,22,2,36,0.6111111111111112,23,-1,19,3
2015-16,2015-11-20,Pittsburgh Penguins,2,Metropolitan,Eastern,24,2,38,0.631578947368421,24,0,21,3
2015-16,2015-11-22,Pittsburgh Penguins,0,Metropolitan,Eastern,24,2,40,0.6,24,0,23,1
2015-16,2015-11-26,Pittsburgh Penguins,2,Metropolitan,Eastern,26,2,42,0.6190476190476191,26,0,25,1
2015-16,2015-11-28,Pittsburgh Penguins,1,Metropolitan,Eastern,27,2,44,0.6136363636363636,27,0,26,1
2015-16,2015-11-29,Pittsburgh Penguins,1,Metropolitan,Eastern,28,2,46,0.6086956521739131,28,0,27,1
2015-16,2015-12-02,Pittsburgh Penguins,2,Metropolitan,Eastern,30,2,48,0.625,30,0,27,3
2015-16,2015-12-05,Pittsburgh Penguins,0,Metropolitan,Eastern,30,2,50,0.6,34,-4,30,0
2015-16,2015-12-07,Pittsburgh Penguins,0,Metropolitan,Eastern,30,2,52,0.5769230769230769,35,-5,31,-1
2015-16,2015-12-10,Pittsburgh Penguins,2,Metropolitan,Eastern,32,2,54,0.5925925925925926,37,-5,32,0
2015-16,2015-12-12,Pittsburgh Penguins,1,Metropolitan,Eastern,33,2,56,0.5892857142857143,37,-4,34,-1
2015-16,2015-12-15,Pittsburgh Penguins,0,Metropolitan,Eastern,33,2,58,0.5689655172413793,40,-7,34,-1
2015-16,2015-12-17,Pittsburgh Penguins,0,Metropolitan,Eastern,33,2,60,0.55,41,-8,36,-3
2015-16,2015-12-19,Pittsburgh Penguins,0,Metropolitan,Eastern,33,2,62,0.532258064516129,41,-8,38,-5
2015-16,2015-12-20,Pittsburgh Penguins,0,Metropolitan,Eastern,33,2,64,0.515625,41,-8,39,-6
2015-16,2015-12-22,Pittsburgh Penguins,2,Metropolitan,Eastern,35,2,66,0.5303030303030303,42,-7,39,-4
2015-16,2015-12-27,Pittsburgh Penguins,2,Metropolitan,Eastern,37,2,68,0.5441176470588235,43,-6,42,-5
2015-16,2015-12-28,Pittsburgh Penguins,0,Metropolitan,Eastern,37,2,70,0.5285714285714286,43,-6,42,-5
2015-16,2015-12-31,Pittsburgh Penguins,2,Metropolitan,Eastern,39,2,72,0.5416666666666666,46,-7,43,-4
2015-16,2015-12-31,Pittsburgh Penguins,1,Metropolitan,Eastern,40,2,74,0.5405405405405406,46,-6,43,-3
2015-16,2016-01-03,Pittsburgh Penguins,2,Metropolitan,Eastern,42,2,76,0.5526315789473685,46,-4,44,-2
2015-16,2016-01-06,Pittsburgh Penguins,1,Metropolitan,Eastern,43,2,78,0.5512820512820513,48,-5,44,-1
2015-16,2016-01-07,Pittsburgh Penguins,0,Metropolitan,Eastern,43,2,80,0.5375,48,-5,44,-1
2015-16,2016-01-10,Pittsburgh Penguins,2,Metropolitan,Eastern,45,2,82,0.5487804878048781,49,-4,46,-1
2015-16,2016-01-13,Pittsburgh Penguins,1,Metropolitan,Eastern,46,2,84,0.5476190476190477,51,-5,47,-1
2015-16,2016-01-16,Pittsburgh Penguins,1,Metropolitan,Eastern,47,2,86,0.5465116279069767,53,-6,49,-2
2015-16,2016-01-17,Pittsburgh Penguins,2,Metropolitan,Eastern,49,2,88,0.5568181818181818,53,-4,50,-1
2015-16,2016-01-19,Pittsburgh Penguins,0,Metropolitan,Eastern,49,2,90,0.5444444444444444,53,-4,50,-1
2015-16,2016-01-22,Pittsburgh Penguins,2,Metropolitan,Eastern,51,2,92,0.5543478260869565,54,-3,53,-2
2015-16,2016-01-23,Pittsburgh Penguins,2,Metropolitan,Eastern,53,2,94,0.5638297872340425,56,-3,53,0
2015-16,2016-01-27,Pittsburgh Penguins,2,Metropolitan,Eastern,55,2,96,0.5729166666666666,56,-1,55,0
2015-16,2016-02-03,Pittsburgh Penguins,2,Metropolitan,Eastern,57,2,98,0.5816326530612245,58,-1,57,0
2015-16,2016-02-06,Pittsburgh Penguins,0,Metropolitan,Eastern,57,2,100,0.57,59,-2,58,-1
2015-16,2016-02-07,Pittsburgh Penguins,2,Metropolitan,Eastern,59,2,102,0.5784313725490197,60,-1,59,0
2015-16,2016-02-09,Pittsburgh Penguins,2,Metropolitan,Eastern,61,2,104,0.5865384615384616,61,0,60,1
2015-16,2016-02-11,Pittsburgh Penguins,0,Metropolitan,Eastern,61,2,106,0.5754716981132075,62,-1,61,0
2015-16,2016-02-13,Pittsburgh Penguins,2,Metropolitan,Eastern,63,2,108,0.5833333333333334,64,-1,63,0
2015-16,2016-02-16,Pittsburgh Penguins,1,Metropolitan,Eastern,64,2,110,0.5818181818181818,66,-2,64,0
2015-16,2016-02-19,Pittsburgh Penguins,2,Metropolitan,Eastern,66,2,112,0.5892857142857143,67,-1,66,0
2015-16,2016-02-20,Pittsburgh Penguins,0,Metropolitan,Eastern,66,2,114,0.5789473684210527,69,-3,66,0
2015-16,2016-02-21,Pittsburgh Penguins,2,Metropolitan,Eastern,68,2,116,0.5862068965517241,69,-1,68,0
2015-16,2016-02-25,Pittsburgh Penguins,0,Metropolitan,Eastern,68,2,118,0.576271186440678,71,-3,68,0
2015-16,2016-02-27,Pittsburgh Penguins,2,Metropolitan,Eastern,70,2,120,0.5833333333333334,73,-3,70,0
2015-16,2016-03-01,Pittsburgh Penguins,2,Metropolitan,Eastern,72,2,122,0.5901639344262295,73,-1,72,0
2015-16,2016-03-02,Pittsburgh Penguins,0,Metropolitan,Eastern,72,2,124,0.5806451612903226,75,-3,72,0
2015-16,2016-03-04,Pittsburgh Penguins,2,Metropolitan,Eastern,74,2,126,0.5873015873015873,77,-3,74,0
2015-16,2016-03-05,Pittsburgh Penguins,0,Metropolitan,Eastern,74,2,128,0.578125,77,-3,74,0
2015-16,2016-03-06,Pittsburgh Penguins,2,Metropolitan,Eastern,76,2,130,0.5846153846153846,79,-3,75,1
2015-16,2016-03-09,Pittsburgh Penguins,0,Metropolitan,Eastern,76,2,132,0.5757575757575758,81,-5,75,1
2015-16,2016-03-12,Pittsburgh Penguins,2,Metropolitan,Eastern,78,2,134,0.582089552238806,82,-4,78,0
2015-16,2016-03-13,Pittsburgh Penguins,2,Metropolitan,Eastern,80,2,136,0.5882352941176471,82,-2,79,1
2015-16,2016-03-15,Pittsburgh Penguins,2,Metropolitan,Eastern,82,2,138,0.5942028985507246,85,-3,79,3
2015-16,2016-03-17,Pittsburgh Penguins,2,Metropolitan,Eastern,84,2,140,0.6,85,-1,81,3
2015-16,2016-03-19,Pittsburgh Penguins,2,Metropolitan,Eastern,86,2,142,0.6056338028169014,86,0,83,3
2015-16,2016-03-20,Pittsburgh Penguins,2,Metropolitan,Eastern,88,2,144,0.6111111111111112,88,0,83,5
2015-16,2016-03-24,Pittsburgh Penguins,0,Metropolitan,Eastern,88,2,146,0.6027397260273972,88,0,85,3
2015-16,2016-03-26,Pittsburgh Penguins,2,Metropolitan,Eastern,90,2,148,0.6081081081081081,90,0,85,5
2015-16,2016-03-27,Pittsburgh Penguins,2,Metropolitan,Eastern,92,2,150,0.6133333333333333,92,0,85,7
2015-16,2016-03-29,Pittsburgh Penguins,2,Metropolitan,Eastern,94,2,152,0.618421052631579,94,0,87,7
2015-16,2016-03-31,Pittsburgh Penguins,2,Metropolitan,Eastern,96,2,154,0.6233766233766234,95,1,88,8
2015-16,2016-04-02,Pittsburgh Penguins,2,Metropolitan,Eastern,98,2,156,0.6282051282051282,95,3,91,7
2015-16,2016-04-03,Pittsburgh Penguins,2,Metropolitan,Eastern,100,2,158,0.6329113924050633,95,5,91,9
2015-16,2016-04-05,Pittsburgh Penguins,2,Metropolitan,Eastern,102,2,160,0.6375,99,3,91,11
2015-16,2016-04-07,Pittsburgh Penguins,2,Metropolitan,Eastern,104,2,162,0.6419753086419753,99,5,93,11
2015-16,2016-04-09,Pittsburgh Penguins,0,Metropolitan,Eastern,104,2,164,0.6341463414634146,101,3,93,11
2015-16,2015-10-08,San Jose Sharks,2,Pacific,Western,2,2,2,1.0,0,2,0,2
2015-16,2015-10-11,San Jose Sharks,2,Pacific,Western,4,2,4,1.0,3,1,2,2
2015-16,2015-10-13,San Jose Sharks,2,Pacific,Western,6,2,6,1.0,4,2,2,4
2015-16,2015-10-16,San Jose Sharks,2,Pacific,Western,8,2,8,1.0,6,2,6,2
2015-16,2015-10-17,San Jose Sharks,0,Pacific,Western,8,2,10,0.8,6,2,6,2
2015-16,2015-10-19,San Jose Sharks,0,Pacific,Western,8,2,12,0.6666666666666666,6,2,6,2
2015-16,2015-10-23,San Jose Sharks,0,Pacific,Western,8,2,14,0.5714285714285714,7,1,8,0
2015-16,2015-10-25,San Jose Sharks,2,Pacific,Western,10,2,16,0.625,9,1,9,1
2015-16,2015-10-29,San Jose Sharks,0,Pacific,Western,10,2,18,0.5555555555555556,11,-1,11,-1
2015-16,2015-10-31,San Jose Sharks,0,Pacific,Western,10,2,20,0.5,11,-1,12,-2
2015-16,2015-11-01,San Jose Sharks,2,Pacific,Western,12,2,22,0.5454545454545454,12,0,12,0
2015-16,2015-11-04,San Jose Sharks,0,Pacific,Western,12,2,24,0.5,12,0,14,-2
2015-16,2015-11-06,San Jose Sharks,2,Pacific,Western,14,2,26,0.5384615384615384,14,0,15,-1
2015-16,2015-11-08,San Jose Sharks,0,Pacific,Western,14,2,28,0.5,14,0,15,-1
2015-16,2015-11-11,San Jose Sharks,0,Pacific,Western,14,2,30,0.4666666666666667,17,-3,17,-3
2015-16,2015-11-14,San Jose Sharks,2,Pacific,Western,16,2,32,0.5,19,-3,18,-2
2015-16,2015-11-15,San Jose Sharks,2,Pacific,Western,18,2,34,0.5294117647058824,19,-1,19,-1
2015-16,2015-11-18,San Jose Sharks,2,Pacific,Western,20,2,36,0.5555555555555556,20,0,20,0
2015-16,2015-11-20,San Jose Sharks,2,Pacific,Western,22,2,38,0.5789473684210527,21,1,21,1
2015-16,2015-11-22,San Jose Sharks,2,Pacific,Western,24,2,40,0.6,22,2,22,2
2015-16,2015-11-22,San Jose Sharks,2,Pacific,Western,26,2,42,0.6190476190476191,22,4,22,4
2015-16,2015-11-26,San Jose Sharks,0,Pacific,Western,26,2,44,0.5909090909090909,24,2,24,2
2015-16,2015-11-29,San Jose Sharks,2,Pacific,Western,28,2,46,0.6086956521739131,27,1,26,2
2015-16,2015-12-02,San Jose Sharks,0,Pacific,Western,28,2,48,0.5833333333333334,27,1,27,1
2015-16,2015-12-05,San Jose Sharks,0,Pacific,Western,28,2,50,0.56,27,1,28,0
2015-16,2015-12-06,San Jose Sharks,0,Pacific,Western,28,2,52,0.5384615384615384,27,1,28,0
2015-16,2015-12-09,San Jose Sharks,0,Pacific,Western,28,2,54,0.5185185185185185,28,0,28,0
2015-16,2015-12-10,San Jose Sharks,1,Pacific,Western,29,2,56,0.5178571428571429,29,0,29,0
2015-16,2015-12-13,San Jose Sharks,0,Pacific,Western,29,2,58,0.5,30,-1,30,-1
2015-16,2015-12-16,San Jose Sharks,2,Pacific,Western,31,2,60,0.5166666666666667,30,1,31,0
2015-16,2015-12-18,San Jose Sharks,2,Pacific,Western,33,2,62,0.532258064516129,32,1,33,0
2015-16,2015-12-19,San Jose Sharks,0,Pacific,Western,33,2,64,0.515625,32,1,33,0
2015-16,2015-12-21,San Jose Sharks,1,Pacific,Western,34,2,66,0.5151515151515151,33,1,34,0
2015-16,2015-12-23,San Jose Sharks,2,Pacific,Western,36,2,68,0.5294117647058824,35,1,35,1
2015-16,2015-12-29,San Jose Sharks,0,Pacific,Western,36,2,70,0.5142857142857142,37,-1,37,-1
2015-16,2015-12-31,San Jose Sharks,2,Pacific,Western,38,2,72,0.5277777777777778,37,1,38,0
2015-16,2016-01-03,San Jose Sharks,0,Pacific,Western,38,2,74,0.5135135135135135,39,-1,39,-1
2015-16,2016-01-08,San Jose Sharks,0,Pacific,Western,38,2,76,0.5,41,-3,43,-5
2015-16,2016-01-10,San Jose Sharks,2,Pacific,Western,40,2,78,0.5128205128205128,42,-2,45,-5
2015-16,2016-01-12,San Jose Sharks,2,Pacific,Western,42,2,80,0.525,44,-2,45,-3
2015-16,2016-01-13,San Jose Sharks,2,Pacific,Western,44,2,82,0.5365853658536586,44,0,45,-1
2015-16,2016-01-15,San Jose Sharks,2,Pacific,Western,46,2,84,0.5476190476190477,46,0,46,0
2015-16,2016-01-17,San Jose Sharks,2,Pacific,Western,48,2,86,0.5581395348837209,48,0,48,0
2015-16,2016-01-19,San Jose Sharks,1,Pacific,Western,49,2,88,0.5568181818181818,49,0,49,0
2015-16,2016-01-22,San Jose Sharks,2,Pacific,Western,51,2,90,0.5666666666666667,51,0,51,0
2015-16,2016-01-23,San Jose Sharks,2,Pacific,Western,53,2,92,0.5760869565217391,51,2,51,2
2015-16,2016-01-25,San Jose Sharks,1,Pacific,Western,54,2,94,0.574468085106383,51,3,52,2
2015-16,2016-01-27,San Jose Sharks,2,Pacific,Western,56,2,96,0.5833333333333334,53,3,54,2
2015-16,2016-02-03,San Jose Sharks,0,Pacific,Western,56,2,98,0.5714285714285714,53,3,55,1
2015-16,2016-02-05,San Jose Sharks,2,Pacific,Western,58,2,100,0.58,55,3,55,3
2015-16,2016-02-07,San Jose Sharks,0,Pacific,Western,58,2,102,0.5686274509803921,57,1,57,1
2015-16,2016-02-10,San Jose Sharks,2,Pacific,Western,60,2,104,0.5769230769230769,59,1,58,2
2015-16,2016-02-12,San Jose Sharks,1,Pacific,Western,61,2,106,0.5754716981132075,60,1,58,3
2015-16,2016-02-14,San Jose Sharks,2,Pacific,Western,63,2,108,0.5833333333333334,62,1,61,2
2015-16,2016-02-17,San Jose Sharks,2,Pacific,Western,65,2,110,0.5909090909090909,65,0,62,3
2015-16,2016-02-19,San Jose Sharks,2,Pacific,Western,67,2,112,0.5982142857142857,67,0,64,3
2015-16,2016-02-20,San Jose Sharks,0,Pacific,Western,67,2,114,0.5877192982456141,67,0,64,3
2015-16,2016-02-23,San Jose Sharks,2,Pacific,Western,69,2,116,0.5948275862068966,69,0,66,3
2015-16,2016-02-25,San Jose Sharks,1,Pacific,Western,70,2,118,0.5932203389830508,70,0,68,2
2015-16,2016-02-27,San Jose Sharks,0,Pacific,Western,70,2,120,0.5833333333333334,70,0,68,2
2015-16,2016-02-29,San Jose Sharks,2,Pacific,Western,72,2,122,0.5901639344262295,72,0,68,4
2015-16,2016-03-01,San Jose Sharks,2,Pacific,Western,74,2,124,0.5967741935483871,74,0,68,6
2015-16,2016-03-04,San Jose Sharks,2,Pacific,Western,76,2,126,0.6031746031746031,76,0,70,6
2015-16,2016-03-06,San Jose Sharks,0,Pacific,Western,76,2,128,0.59375,76,0,72,4
2015-16,2016-03-08,San Jose Sharks,2,Pacific,Western,78,2,130,0.6,78,0,72,6
2015-16,2016-03-09,San Jose Sharks,2,Pacific,Western,80,2,132,0.6060606060606061,80,0,72,8
2015-16,2016-03-11,San Jose Sharks,0,Pacific,Western,80,2,134,0.5970149253731343,80,0,74,6
2015-16,2016-03-13,San Jose Sharks,2,Pacific,Western,82,2,136,0.6029411764705882,82,0,74,8
2015-16,2016-03-16,San Jose Sharks,2,Pacific,Western,84,2,138,0.6086956521739131,84,0,75,9
2015-16,2016-03-18,San Jose Sharks,0,Pacific,Western,84,2,140,0.6,84,0,76,8
2015-16,2016-03-19,San Jose Sharks,2,Pacific,Western,86,2,142,0.6056338028169014,86,0,78,8
2015-16,2016-03-21,San Jose Sharks,2,Pacific,Western,88,2,144,0.6111111111111112,88,0,80,8
2015-16,2016-03-23,San Jose Sharks,0,Pacific,Western,88,2,146,0.6027397260273972,88,0,81,7
2015-16,2016-03-25,San Jose Sharks,0,Pacific,Western,88,2,148,0.5945945945945946,88,0,83,5
2015-16,2016-03-26,San Jose Sharks,0,Pacific,Western,88,2,150,0.5866666666666667,88,0,85,3
2015-16,2016-03-29,San Jose Sharks,2,Pacific,Western,90,2,152,0.5921052631578947,90,0,85,5
2015-16,2016-03-30,San Jose Sharks,2,Pacific,Western,92,2,154,0.5974025974025974,92,0,87,5
2015-16,2016-04-01,San Jose Sharks,0,Pacific,Western,92,2,156,0.5897435897435898,92,0,87,5
2015-16,2016-04-03,San Jose Sharks,2,Pacific,Western,94,2,158,0.5949367088607594,94,0,87,7
2015-16,2016-04-06,San Jose Sharks,2,Pacific,Western,96,2,160,0.6,96,0,87,9
2015-16,2016-04-08,San Jose Sharks,0,Pacific,Western,96,2,162,0.5925925925925926,96,0,87,9
2015-16,2016-04-10,San Jose Sharks,2,Pacific,Western,98,2,164,0.5975609756097561,98,0,87,11
2015-16,2015-10-09,St. Louis Blues,2,Central,Western,2,2,2,1.0,2,0,2,0
2015-16,2015-10-11,St. Louis Blues,0,Central,Western,2,2,4,0.5,4,-2,2,0
2015-16,2015-10-14,St. Louis Blues,2,Central,Western,4,2,6,0.6666666666666666,4,0,4,0
2015-16,2015-10-16,St. Louis Blues,2,Central,Western,6,2,8,0.75,6,0,6,0
2015-16,2015-10-17,St. Louis Blues,2,Central,Western,8,2,10,0.8,8,0,6,2
2015-16,2015-10-18,St. Louis Blues,2,Central,Western,10,2,12,0.8333333333333334,8,2,6,4
2015-16,2015-10-20,St. Louis Blues,0,Central,Western,10,2,14,0.7142857142857143,8,2,7,3
2015-16,2015-10-25,St. Louis Blues,1,Central,Western,11,2,16,0.6875,11,0,9,2
2015-16,2015-10-28,St. Louis Blues,2,Central,Western,13,2,18,0.7222222222222222,13,0,11,2
2015-16,2015-10-30,St. Louis Blues,2,Central,Western,15,2,20,0.75,15,0,12,3
2015-16,2015-10-31,St. Louis Blues,2,Central,Western,17,2,22,0.7727272727272727,16,1,12,5
2015-16,2015-11-04,St. Louis Blues,0,Central,Western,17,2,24,0.7083333333333334,16,1,14,3
2015-16,2015-11-05,St. Louis Blues,2,Central,Western,19,2,26,0.7307692307692307,17,2,15,4
2015-16,2015-11-08,St. Louis Blues,2,Central,Western,21,2,28,0.75,18,3,15,6
2015-16,2015-11-11,St. Louis Blues,2,Central,Western,23,2,30,0.7666666666666667,20,3,17,6
2015-16,2015-11-13,St. Louis Blues,0,Central,Western,23,2,32,0.71875,22,1,18,5
2015-16,2015-11-15,St. Louis Blues,0,Central,Western,23,2,34,0.6764705882352942,23,0,19,4
2015-16,2015-11-17,St. Louis Blues,2,Central,Western,25,2,36,0.6944444444444444,23,2,19,6
2015-16,2015-11-18,St. Louis Blues,0,Central,Western,25,2,38,0.6578947368421053,25,0,20,5
2015-16,2015-11-20,St. Louis Blues,2,Central,Western,27,2,40,0.675,25,2,21,6
2015-16,2015-11-22,St. Louis Blues,1,Central,Western,28,2,42,0.6666666666666666,25,3,22,6
2015-16,2015-11-24,St. Louis Blues,2,Central,Western,30,2,44,0.6818181818181818,25,5,22,8
2015-16,2015-11-26,St. Louis Blues,1,Central,Western,31,2,46,0.6739130434782609,27,4,24,7
2015-16,2015-11-29,St. Louis Blues,2,Central,Western,33,2,48,0.6875,29,4,26,7
2015-16,2015-12-02,St. Louis Blues,0,Central,Western,33,2,50,0.66,30,3,27,6
2015-16,2015-12-05,St. Louis Blues,1,Central,Western,34,2,52,0.6538461538461539,30,4,28,6
2015-16,2015-12-06,St. Louis Blues,0,Central,Western,34,2,54,0.6296296296296297,32,2,28,6
2015-16,2015-12-09,St. Louis Blues,2,Central,Western,36,2,56,0.6428571428571429,34,2,28,8
2015-16,2015-12-11,St. Louis Blues,0,Central,Western,36,2,58,0.6206896551724138,35,1,30,6
2015-16,2015-12-13,St. Louis Blues,0,Central,Western,36,2,60,0.6,36,0,30,6
2015-16,2015-12-13,St. Louis Blues,2,Central,Western,38,2,62,0.6129032258064516,36,2,30,8
2015-16,2015-12-16,St. Louis Blues,2,Central,Western,40,2,64,0.625,38,2,31,9
2015-16,2015-12-18,St. Louis Blues,2,Central,Western,42,2,66,0.6363636363636364,40,2,33,9
2015-16,2015-12-19,St. Louis Blues,2,Central,Western,44,2,68,0.6470588235294118,42,2,33,11
2015-16,2015-12-22,St. Louis Blues,0,Central,Western,44,2,70,0.6285714285714286,44,0,34,10
2015-16,2015-12-23,St. Louis Blues,2,Central,Western,46,2,72,0.6388888888888888,44,2,35,11
2015-16,2015-12-27,St. Louis Blues,2,Central,Western,48,2,74,0.6486486486486487,44,4,36,12
2015-16,2015-12-27,St. Louis Blues,0,Central,Western,48,2,76,0.631578947368421,44,4,36,12
2015-16,2015-12-30,St. Louis Blues,2,Central,Western,50,2,78,0.6410256410256411,46,4,37,13
2015-16,2016-01-01,St. Louis Blues,0,Central,Western,50,2,80,0.625,48,2,39,11
2015-16,2016-01-03,St. Louis Blues,0,Central,Western,50,2,82,0.6097560975609756,48,2,39,11
2015-16,2016-01-05,St. Louis Blues,1,Central,Western,51,2,84,0.6071428571428571,50,1,41,10
2015-16,2016-01-07,St. Louis Blues,1,Central,Western,52,2,86,0.6046511627906976,52,0,42,10
2015-16,2016-01-09,St. Louis Blues,1,Central,Western,53,2,88,0.6022727272727273,53,0,44,9
2015-16,2016-01-10,St. Louis Blues,2,Central,Western,55,2,90,0.6111111111111112,55,0,45,10
2015-16,2016-01-13,St. Louis Blues,2,Central,Western,57,2,92,0.6195652173913043,57,0,45,12
2015-16,2016-01-15,St. Louis Blues,0,Central,Western,57,2,94,0.6063829787234043,57,0,46,11
2015-16,2016-01-17,St. Louis Blues,2,Central,Western,59,2,96,0.6145833333333334,59,0,48,11
2015-16,2016-01-19,St. Louis Blues,2,Central,Western,61,2,98,0.6224489795918368,61,0,49,12
2015-16,2016-01-21,St. Louis Blues,2,Central,Western,63,2,100,0.63,63,0,49,14
2015-16,2016-01-23,St. Louis Blues,1,Central,Western,64,2,102,0.6274509803921569,64,0,51,13
2015-16,2016-01-25,St. Louis Blues,0,Central,Western,64,2,104,0.6153846153846154,64,0,52,12
2015-16,2016-02-03,St. Louis Blues,2,Central,Western,66,2,106,0.6226415094339622,66,0,55,11
2015-16,2016-02-05,St. Louis Blues,0,Central,Western,66,2,108,0.6111111111111112,66,0,55,11
2015-16,2016-02-07,St. Louis Blues,2,Central,Western,68,2,110,0.6181818181818182,68,0,57,11
2015-16,2016-02-10,St. Louis Blues,1,Central,Western,69,2,112,0.6160714285714286,69,0,58,11
2015-16,2016-02-13,St. Louis Blues,2,Central,Western,71,2,114,0.6228070175438597,71,0,59,12
2015-16,2016-02-14,St. Louis Blues,2,Central,Western,73,2,116,0.6293103448275862,73,0,61,12
2015-16,2016-02-17,St. Louis Blues,2,Central,Western,75,2,118,0.635593220338983,75,0,62,13
2015-16,2016-02-19,St. Louis Blues,2,Central,Western,77,2,120,0.6416666666666667,77,0,64,13
2015-16,2016-02-21,St. Louis Blues,2,Central,Western,79,2,122,0.6475409836065574,79,0,65,14
2015-16,2016-02-23,St. Louis Blues,0,Central,Western,79,2,124,0.6370967741935484,79,0,66,13
2015-16,2016-02-26,St. Louis Blues,0,Central,Western,79,2,126,0.626984126984127,79,0,68,11
2015-16,2016-02-27,St. Louis Blues,0,Central,Western,79,2,128,0.6171875,79,0,68,11
2015-16,2016-02-28,St. Louis Blues,2,Central,Western,81,2,130,0.6230769230769231,81,0,68,13
2015-16,2016-03-02,St. Louis Blues,2,Central,Western,83,2,132,0.6287878787878788,83,0,68,15
2015-16,2016-03-07,St. Louis Blues,2,Central,Western,85,2,134,0.6343283582089553,85,0,72,13
2015-16,2016-03-10,St. Louis Blues,2,Central,Western,87,2,136,0.6397058823529411,87,0,74,13
2015-16,2016-03-12,St. Louis Blues,2,Central,Western,89,2,138,0.644927536231884,88,1,74,15
2015-16,2016-03-13,St. Louis Blues,2,Central,Western,91,2,140,0.65,88,3,74,17
2015-16,2016-03-15,St. Louis Blues,0,Central,Western,91,2,142,0.6408450704225352,88,3,75,16
2015-16,2016-03-17,St. Louis Blues,0,Central,Western,91,2,144,0.6319444444444444,88,3,76,15
2015-16,2016-03-20,St. Louis Blues,2,Central,Western,93,2,146,0.636986301369863,90,3,78,15
2015-16,2016-03-23,St. Louis Blues,2,Central,Western,95,2,148,0.6418918918918919,91,4,81,14
2015-16,2016-03-26,St. Louis Blues,2,Central,Western,97,2,150,0.6466666666666666,91,6,85,12
2015-16,2016-03-26,St. Louis Blues,2,Central,Western,99,2,152,0.6513157894736842,91,8,85,14
2015-16,2016-03-30,St. Louis Blues,2,Central,Western,101,2,154,0.6558441558441559,95,6,87,14
2015-16,2016-04-02,St. Louis Blues,0,Central,Western,101,2,156,0.6474358974358975,97,4,87,14
2015-16,2016-04-04,St. Louis Blues,2,Central,Western,103,2,158,0.6518987341772152,99,4,87,16
2015-16,2016-04-05,St. Louis Blues,2,Central,Western,105,2,160,0.65625,99,6,87,18
2015-16,2016-04-08,St. Louis Blues,2,Central,Western,107,2,162,0.6604938271604939,102,5,87,20
2015-16,2016-04-10,St. Louis Blues,0,Central,Western,107,2,164,0.6524390243902439,103,4,87,20
2015-16,2015-10-08,Tampa Bay Lightning,2,Atlantic,Eastern,2,2,2,1.0,2,0,0,2
2015-16,2015-10-10,Tampa Bay Lightning,2,Atlantic,Eastern,4,2,4,1.0,4,0,1,3
2015-16,2015-10-12,Tampa Bay Lightning,2,Atlantic,Eastern,6,2,6,1.0,4,2,2,4
2015-16,2015-10-13,Tampa Bay Lightning,0,Atlantic,Eastern,6,2,8,0.75,6,0,3,3
2015-16,2015-10-15,Tampa Bay Lightning,0,Atlantic,Eastern,6,2,10,0.6,6,0,5,1
2015-16,2015-10-17,Tampa Bay Lightning,2,Atlantic,Eastern,8,2,12,0.6666666666666666,7,1,6,2
2015-16,2015-10-21,Tampa Bay Lightning,1,Atlantic,Eastern,9,2,14,0.6428571428571429,7,2,6,3
2015-16,2015-10-24,Tampa Bay Lightning,2,Atlantic,Eastern,11,2,16,0.6875,8,3,8,3
2015-16,2015-10-25,Tampa Bay Lightning,1,Atlantic,Eastern,12,2,18,0.6666666666666666,9,3,9,3
2015-16,2015-10-28,Tampa Bay Lightning,0,Atlantic,Eastern,12,2,20,0.6,11,1,10,2
2015-16,2015-10-29,Tampa Bay Lightning,0,Atlantic,Eastern,12,2,22,0.5454545454545454,11,1,11,1
2015-16,2015-10-31,Tampa Bay Lightning,0,Atlantic,Eastern,12,2,24,0.5,12,0,12,0
2015-16,2015-11-01,Tampa Bay Lightning,2,Atlantic,Eastern,14,2,26,0.5384615384615384,13,1,13,1
2015-16,2015-11-04,Tampa Bay Lightning,0,Atlantic,Eastern,14,2,28,0.5,14,0,13,1
2015-16,2015-11-06,Tampa Bay Lightning,2,Atlantic,Eastern,16,2,30,0.5333333333333333,16,0,13,3
2015-16,2015-11-08,Tampa Bay Lightning,0,Atlantic,Eastern,16,2,32,0.5,16,0,16,0
2015-16,2015-11-11,Tampa Bay Lightning,0,Atlantic,Eastern,16,2,34,0.47058823529411764,17,-1,17,-1
2015-16,2015-11-13,Tampa Bay Lightning,2,Atlantic,Eastern,18,2,36,0.5,18,0,18,0
2015-16,2015-11-15,Tampa Bay Lightning,1,Atlantic,Eastern,19,2,38,0.5,19,0,19,0
2015-16,2015-11-17,Tampa Bay Lightning,0,Atlantic,Eastern,19,2,40,0.475,19,0,19,0
2015-16,2015-11-20,Tampa Bay Lightning,2,Atlantic,Eastern,21,2,42,0.5,21,0,21,0
2015-16,2015-11-22,Tampa Bay Lightning,2,Atlantic,Eastern,23,2,44,0.5227272727272727,24,-1,23,0
2015-16,2015-11-26,Tampa Bay Lightning,2,Atlantic,Eastern,25,2,46,0.5434782608695652,25,0,25,0
2015-16,2015-11-27,Tampa Bay Lightning,0,Atlantic,Eastern,25,2,48,0.5208333333333334,27,-2,25,0
2015-16,2015-11-29,Tampa Bay Lightning,0,Atlantic,Eastern,25,2,50,0.5,28,-3,27,-2
2015-16,2015-12-03,Tampa Bay Lightning,2,Atlantic,Eastern,27,2,52,0.5192307692307693,29,-2,28,-1
2015-16,2015-12-06,Tampa Bay Lightning,2,Atlantic,Eastern,29,2,54,0.5370370370370371,33,-4,30,-1
2015-16,2015-12-07,Tampa Bay Lightning,0,Atlantic,Eastern,29,2,56,0.5178571428571429,33,-4,31,-2
2015-16,2015-12-11,Tampa Bay Lightning,2,Atlantic,Eastern,31,2,58,0.5344827586206896,35,-4,32,-1
2015-16,2015-12-13,Tampa Bay Lightning,0,Atlantic,Eastern,31,2,60,0.5166666666666667,35,-4,34,-3
2015-16,2015-12-15,Tampa Bay Lightning,2,Atlantic,Eastern,33,2,62,0.532258064516129,37,-4,34,-1
2015-16,2015-12-16,Tampa Bay Lightning,2,Atlantic,Eastern,35,2,64,0.546875,37,-2,36,-1
2015-16,2015-12-19,Tampa Bay Lightning,0,Atlantic,Eastern,35,2,66,0.5303030303030303,39,-4,38,-3
2015-16,2015-12-20,Tampa Bay Lightning,2,Atlantic,Eastern,37,2,68,0.5441176470588235,40,-3,39,-2
2015-16,2015-12-23,Tampa Bay Lightning,0,Atlantic,Eastern,37,2,70,0.5285714285714286,42,-5,40,-3
2015-16,2015-12-27,Tampa Bay Lightning,2,Atlantic,Eastern,39,2,72,0.5416666666666666,43,-4,42,-3
2015-16,2015-12-29,Tampa Bay Lightning,1,Atlantic,Eastern,40,2,74,0.5405405405405406,43,-3,42,-2
2015-16,2015-12-31,Tampa Bay Lightning,0,Atlantic,Eastern,40,2,76,0.5263157894736842,44,-4,43,-3
2015-16,2016-01-03,Tampa Bay Lightning,2,Atlantic,Eastern,42,2,78,0.5384615384615384,45,-3,44,-2
2015-16,2016-01-06,Tampa Bay Lightning,0,Atlantic,Eastern,42,2,80,0.525,47,-5,44,-2
2015-16,2016-01-09,Tampa Bay Lightning,2,Atlantic,Eastern,44,2,82,0.5365853658536586,49,-5,45,-1
2015-16,2016-01-10,Tampa Bay Lightning,2,Atlantic,Eastern,46,2,84,0.5476190476190477,49,-3,46,0
2015-16,2016-01-13,Tampa Bay Lightning,2,Atlantic,Eastern,48,2,86,0.5581395348837209,49,-1,47,1
2015-16,2016-01-16,Tampa Bay Lightning,2,Atlantic,Eastern,50,2,88,0.5681818181818182,50,0,49,1
2015-16,2016-01-17,Tampa Bay Lightning,2,Atlantic,Eastern,52,2,90,0.5777777777777777,52,0,50,2
2015-16,2016-01-20,Tampa Bay Lightning,2,Atlantic,Eastern,54,2,92,0.5869565217391305,54,0,51,3
2015-16,2016-01-22,Tampa Bay Lightning,2,Atlantic,Eastern,56,2,94,0.5957446808510638,54,2,53,3
2015-16,2016-01-24,Tampa Bay Lightning,0,Atlantic,Eastern,56,2,96,0.5833333333333334,56,0,55,1
2015-16,2016-01-28,Tampa Bay Lightning,2,Atlantic,Eastern,58,2,98,0.5918367346938775,58,0,55,3
2015-16,2016-02-04,Tampa Bay Lightning,2,Atlantic,Eastern,60,2,100,0.6,58,2,57,3
2015-16,2016-02-06,Tampa Bay Lightning,2,Atlantic,Eastern,62,2,102,0.6078431372549019,60,2,58,4
2015-16,2016-02-09,Tampa Bay Lightning,0,Atlantic,Eastern,62,2,104,0.5961538461538461,62,0,60,2
2015-16,2016-02-10,Tampa Bay Lightning,0,Atlantic,Eastern,62,2,106,0.5849056603773585,62,0,61,1
2015-16,2016-02-13,Tampa Bay Lightning,2,Atlantic,Eastern,64,2,108,0.5925925925925926,65,-1,63,1
2015-16,2016-02-14,Tampa Bay Lightning,0,Atlantic,Eastern,64,2,110,0.5818181818181818,66,-2,64,0
2015-16,2016-02-17,Tampa Bay Lightning,0,Atlantic,Eastern,64,2,112,0.5714285714285714,67,-3,64,0
2015-16,2016-02-19,Tampa Bay Lightning,2,Atlantic,Eastern,66,2,114,0.5789473684210527,67,-1,66,0
2015-16,2016-02-20,Tampa Bay Lightning,2,Atlantic,Eastern,68,2,116,0.5862068965517241,68,0,66,2
2015-16,2016-02-22,Tampa Bay Lightning,2,Atlantic,Eastern,70,2,118,0.5932203389830508,70,0,68,2
2015-16,2016-02-24,Tampa Bay Lightning,2,Atlantic,Eastern,72,2,120,0.6,71,1,68,4
2015-16,2016-02-27,Tampa Bay Lightning,2,Atlantic,Eastern,74,2,122,0.6065573770491803,74,0,70,4
2015-16,2016-02-28,Tampa Bay Lightning,2,Atlantic,Eastern,76,2,124,0.6129032258064516,74,2,70,6
2015-16,2016-03-01,Tampa Bay Lightning,2,Atlantic,Eastern,78,2,126,0.6190476190476191,75,3,72,6
2015-16,2016-03-04,Tampa Bay Lightning,2,Atlantic,Eastern,80,2,128,0.625,78,2,74,6
2015-16,2016-03-06,Tampa Bay Lightning,2,Atlantic,Eastern,82,2,130,0.6307692307692307,79,3,75,7
2015-16,2016-03-08,Tampa Bay Lightning,0,Atlantic,Eastern,82,2,132,0.6212121212121212,81,1,75,7
2015-16,2016-03-09,Tampa Bay Lightning,1,Atlantic,Eastern,83,2,134,0.6194029850746269,81,2,75,8
2015-16,2016-03-12,Tampa Bay Lightning,0,Atlantic,Eastern,83,2,136,0.6102941176470589,83,0,78,5
2015-16,2016-03-13,Tampa Bay Lightning,2,Atlantic,Eastern,85,2,138,0.6159420289855072,85,0,79,6
2015-16,2016-03-15,Tampa Bay Lightning,0,Atlantic,Eastern,85,2,140,0.6071428571428571,85,0,79,6
2015-16,2016-03-18,Tampa Bay Lightning,0,Atlantic,Eastern,85,2,142,0.5985915492957746,85,0,81,4
2015-16,2016-03-20,Tampa Bay Lightning,2,Atlantic,Eastern,87,2,144,0.6041666666666666,86,1,83,4
2015-16,2016-03-22,Tampa Bay Lightning,2,Atlantic,Eastern,89,2,146,0.6095890410958904,86,3,83,6
2015-16,2016-03-25,Tampa Bay Lightning,2,Atlantic,Eastern,91,2,148,0.6148648648648649,86,5,85,6
2015-16,2016-03-26,Tampa Bay Lightning,0,Atlantic,Eastern,91,2,150,0.6066666666666667,88,3,85,6
2015-16,2016-03-28,Tampa Bay Lightning,2,Atlantic,Eastern,93,2,152,0.6118421052631579,88,5,87,6
2015-16,2016-03-31,Tampa Bay Lightning,0,Atlantic,Eastern,93,2,154,0.6038961038961039,88,5,88,5
2015-16,2016-04-02,Tampa Bay Lightning,2,Atlantic,Eastern,95,2,156,0.6089743589743589,91,4,91,4
2015-16,2016-04-04,Tampa Bay Lightning,0,Atlantic,Eastern,95,2,158,0.6012658227848101,91,4,91,4
2015-16,2016-04-05,Tampa Bay Lightning,0,Atlantic,Eastern,95,2,160,0.59375,91,4,91,4
2015-16,2016-04-07,Tampa Bay Lightning,2,Atlantic,Eastern,97,2,162,0.5987654320987654,93,4,93,4
2015-16,2016-04-09,Tampa Bay Lightning,0,Atlantic,Eastern,97,2,164,0.5914634146341463,93,4,93,4
2015-16,2015-10-07,Toronto Maple Leafs,0,Atlantic,Eastern,0,2,2,0.0,0,0,0,0
2015-16,2015-10-09,Toronto Maple Leafs,0,Atlantic,Eastern,0,2,4,0.0,2,-2,0,0
2015-16,2015-10-10,Toronto Maple Leafs,1,Atlantic,Eastern,1,2,6,0.16666666666666666,4,-3,1,0
2015-16,2015-10-16,Toronto Maple Leafs,2,Atlantic,Eastern,3,2,8,0.375,6,-3,5,-2
2015-16,2015-10-17,Toronto Maple Leafs,0,Atlantic,Eastern,3,2,10,0.3,7,-4,6,-3
2015-16,2015-10-21,Toronto Maple Leafs,1,Atlantic,Eastern,4,2,12,0.3333333333333333,7,-3,6,-2
2015-16,2015-10-24,Toronto Maple Leafs,0,Atlantic,Eastern,4,2,14,0.2857142857142857,8,-4,8,-4
2015-16,2015-10-26,Toronto Maple Leafs,0,Atlantic,Eastern,4,2,16,0.25,9,-5,9,-5
2015-16,2015-10-30,Toronto Maple Leafs,0,Atlantic,Eastern,4,2,18,0.2222222222222222,12,-8,11,-7
2015-16,2015-10-31,Toronto Maple Leafs,0,Atlantic,Eastern,4,2,20,0.2,12,-8,12,-8
2015-16,2015-11-03,Toronto Maple Leafs,2,Atlantic,Eastern,6,2,22,0.2727272727272727,13,-7,13,-7
2015-16,2015-11-05,Toronto Maple Leafs,0,Atlantic,Eastern,6,2,24,0.25,14,-8,13,-7
2015-16,2015-11-07,Toronto Maple Leafs,1,Atlantic,Eastern,7,2,26,0.2692307692307692,16,-9,15,-8
2015-16,2015-11-08,Toronto Maple Leafs,1,Atlantic,Eastern,8,2,28,0.2857142857142857,16,-8,16,-8
2015-16,2015-11-11,Toronto Maple Leafs,2,Atlantic,Eastern,10,2,30,0.3333333333333333,17,-7,17,-7
2015-16,2015-11-13,Toronto Maple Leafs,2,Atlantic,Eastern,12,2,32,0.375,18,-6,18,-6
2015-16,2015-11-15,Toronto Maple Leafs,2,Atlantic,Eastern,14,2,34,0.4117647058823529,19,-5,19,-5
2015-16,2015-11-16,Toronto Maple Leafs,0,Atlantic,Eastern,14,2,36,0.3888888888888889,19,-5,19,-5
2015-16,2015-11-18,Toronto Maple Leafs,2,Atlantic,Eastern,16,2,38,0.42105263157894735,19,-3,19,-3
2015-16,2015-11-21,Toronto Maple Leafs,2,Atlantic,Eastern,18,2,40,0.45,22,-4,21,-3
2015-16,2015-11-22,Toronto Maple Leafs,0,Atlantic,Eastern,18,2,42,0.42857142857142855,24,-6,23,-5
2015-16,2015-11-24,Toronto Maple Leafs,1,Atlantic,Eastern,19,2,44,0.4318181818181818,24,-5,23,-4
2015-16,2015-11-29,Toronto Maple Leafs,0,Atlantic,Eastern,19,2,46,0.41304347826086957,28,-9,27,-8
2015-16,2015-12-01,Toronto Maple Leafs,2,Atlantic,Eastern,21,2,48,0.4375,28,-7,27,-6
2015-16,2015-12-03,Toronto Maple Leafs,0,Atlantic,Eastern,21,2,50,0.42,29,-8,28,-7
2015-16,2015-12-04,Toronto Maple Leafs,0,Atlantic,Eastern,21,2,52,0.40384615384615385,31,-10,28,-7
2015-16,2015-12-06,Toronto Maple Leafs,2,Atlantic,Eastern,23,2,54,0.42592592592592593,33,-10,30,-7
2015-16,2015-12-09,Toronto Maple Leafs,2,Atlantic,Eastern,25,2,56,0.44642857142857145,35,-10,31,-6
2015-16,2015-12-16,Toronto Maple Leafs,1,Atlantic,Eastern,26,2,58,0.4482758620689655,37,-11,36,-10
2015-16,2015-12-18,Toronto Maple Leafs,1,Atlantic,Eastern,27,2,60,0.45,38,-11,36,-9
2015-16,2015-12-20,Toronto Maple Leafs,2,Atlantic,Eastern,29,2,62,0.46774193548387094,40,-11,39,-10
2015-16,2015-12-22,Toronto Maple Leafs,2,Atlantic,Eastern,31,2,64,0.484375,41,-10,39,-8
2015-16,2015-12-23,Toronto Maple Leafs,0,Atlantic,Eastern,31,2,66,0.4696969696969697,42,-11,40,-9
2015-16,2015-12-27,Toronto Maple Leafs,2,Atlantic,Eastern,33,2,68,0.4852941176470588,43,-10,42,-9
2015-16,2015-12-30,Toronto Maple Leafs,0,Atlantic,Eastern,33,2,70,0.4714285714285714,44,-11,42,-9
2015-16,2015-12-31,Toronto Maple Leafs,2,Atlantic,Eastern,35,2,72,0.4861111111111111,44,-9,43,-8
2015-16,2016-01-03,Toronto Maple Leafs,2,Atlantic,Eastern,37,2,74,0.5,45,-8,44,-7
2015-16,2016-01-07,Toronto Maple Leafs,2,Atlantic,Eastern,39,2,76,0.5131578947368421,47,-8,44,-5
2015-16,2016-01-08,Toronto Maple Leafs,0,Atlantic,Eastern,39,2,78,0.5,49,-10,44,-5
2015-16,2016-01-10,Toronto Maple Leafs,0,Atlantic,Eastern,39,2,80,0.4875,49,-10,46,-7
2015-16,2016-01-14,Toronto Maple Leafs,0,Atlantic,Eastern,39,2,82,0.47560975609756095,49,-10,47,-8
2015-16,2016-01-16,Toronto Maple Leafs,0,Atlantic,Eastern,39,2,84,0.4642857142857143,50,-11,49,-10
2015-16,2016-01-17,Toronto Maple Leafs,0,Atlantic,Eastern,39,2,86,0.45348837209302323,52,-13,50,-11
2015-16,2016-01-20,Toronto Maple Leafs,2,Atlantic,Eastern,41,2,88,0.4659090909090909,54,-13,51,-10
2015-16,2016-01-22,Toronto Maple Leafs,1,Atlantic,Eastern,42,2,90,0.4666666666666667,54,-12,53,-11
2015-16,2016-01-24,Toronto Maple Leafs,1,Atlantic,Eastern,43,2,92,0.4673913043478261,56,-13,55,-12
2015-16,2016-01-27,Toronto Maple Leafs,0,Atlantic,Eastern,43,2,94,0.4574468085106383,57,-14,55,-12
2015-16,2016-01-28,Toronto Maple Leafs,0,Atlantic,Eastern,43,2,96,0.4479166666666667,58,-15,55,-12
2015-16,2016-02-03,Toronto Maple Leafs,2,Atlantic,Eastern,45,2,98,0.45918367346938777,58,-13,57,-12
2015-16,2016-02-05,Toronto Maple Leafs,2,Atlantic,Eastern,47,2,100,0.47,60,-13,58,-11
2015-16,2016-02-07,Toronto Maple Leafs,0,Atlantic,Eastern,47,2,102,0.46078431372549017,62,-15,59,-12
2015-16,2016-02-10,Toronto Maple Leafs,0,Atlantic,Eastern,47,2,104,0.4519230769230769,62,-15,61,-14
2015-16,2016-02-12,Toronto Maple Leafs,0,Atlantic,Eastern,47,2,106,0.44339622641509435,64,-17,61,-14
2015-16,2016-02-14,Toronto Maple Leafs,2,Atlantic,Eastern,49,2,108,0.4537037037037037,66,-17,64,-15
2015-16,2016-02-16,Toronto Maple Leafs,0,Atlantic,Eastern,49,2,110,0.44545454545454544,66,-17,64,-15
2015-16,2016-02-19,Toronto Maple Leafs,0,Atlantic,Eastern,49,2,112,0.4375,67,-18,66,-17
2015-16,2016-02-21,Toronto Maple Leafs,1,Atlantic,Eastern,50,2,114,0.43859649122807015,68,-18,68,-18
2015-16,2016-02-24,Toronto Maple Leafs,0,Atlantic,Eastern,50,2,116,0.43103448275862066,71,-21,68,-18
2015-16,2016-02-26,Toronto Maple Leafs,2,Atlantic,Eastern,52,2,118,0.4406779661016949,72,-20,68,-16
2015-16,2016-02-28,Toronto Maple Leafs,0,Atlantic,Eastern,52,2,120,0.43333333333333335,74,-22,70,-18
2015-16,2016-03-01,Toronto Maple Leafs,0,Atlantic,Eastern,52,2,122,0.4262295081967213,75,-23,72,-20
2015-16,2016-03-03,Toronto Maple Leafs,0,Atlantic,Eastern,52,2,124,0.41935483870967744,76,-24,72,-20
2015-16,2016-03-04,Toronto Maple Leafs,0,Atlantic,Eastern,52,2,126,0.4126984126984127,78,-26,74,-22
2015-16,2016-03-06,Toronto Maple Leafs,0,Atlantic,Eastern,52,2,128,0.40625,79,-27,75,-23
2015-16,2016-03-08,Toronto Maple Leafs,1,Atlantic,Eastern,53,2,130,0.4076923076923077,81,-28,75,-22
2015-16,2016-03-10,Toronto Maple Leafs,2,Atlantic,Eastern,55,2,132,0.4166666666666667,81,-26,75,-20
2015-16,2016-03-13,Toronto Maple Leafs,0,Atlantic,Eastern,55,2,134,0.41044776119402987,85,-30,79,-24
2015-16,2016-03-13,Toronto Maple Leafs,2,Atlantic,Eastern,57,2,136,0.41911764705882354,85,-28,79,-22
2015-16,2016-03-15,Toronto Maple Leafs,2,Atlantic,Eastern,59,2,138,0.427536231884058,85,-26,79,-20
2015-16,2016-03-17,Toronto Maple Leafs,0,Atlantic,Eastern,59,2,140,0.42142857142857143,85,-26,81,-22
2015-16,2016-03-19,Toronto Maple Leafs,2,Atlantic,Eastern,61,2,142,0.4295774647887324,85,-24,83,-22
2015-16,2016-03-21,Toronto Maple Leafs,2,Atlantic,Eastern,63,2,144,0.4375,86,-23,83,-20
2015-16,2016-03-24,Toronto Maple Leafs,2,Atlantic,Eastern,65,2,146,0.4452054794520548,86,-21,85,-20
2015-16,2016-03-26,Toronto Maple Leafs,0,Atlantic,Eastern,65,2,148,0.4391891891891892,88,-23,85,-20
2015-16,2016-03-28,Toronto Maple Leafs,0,Atlantic,Eastern,65,2,150,0.43333333333333335,88,-23,87,-22
2015-16,2016-03-29,Toronto Maple Leafs,2,Atlantic,Eastern,67,2,152,0.4407894736842105,88,-21,87,-20
2015-16,2016-03-31,Toronto Maple Leafs,0,Atlantic,Eastern,67,2,154,0.43506493506493504,88,-21,88,-21
2015-16,2016-04-02,Toronto Maple Leafs,0,Atlantic,Eastern,67,2,156,0.42948717948717946,91,-24,91,-24
2015-16,2016-04-04,Toronto Maple Leafs,0,Atlantic,Eastern,67,2,158,0.4240506329113924,91,-24,91,-24
2015-16,2016-04-06,Toronto Maple Leafs,0,Atlantic,Eastern,67,2,160,0.41875,91,-24,91,-24
2015-16,2016-04-07,Toronto Maple Leafs,2,Atlantic,Eastern,69,2,162,0.42592592592592593,93,-24,93,-24
2015-16,2016-04-09,Toronto Maple Leafs,0,Atlantic,Eastern,69,2,164,0.42073170731707316,93,-24,93,-24
2015-16,2015-10-08,Vancouver Canucks,2,Pacific,Western,2,2,2,1.0,0,2,0,2
2015-16,2015-10-11,Vancouver Canucks,1,Pacific,Western,3,2,4,0.75,3,0,2,1
2015-16,2015-10-13,Vancouver Canucks,2,Pacific,Western,5,2,6,0.8333333333333334,4,1,2,3
2015-16,2015-10-14,Vancouver Canucks,2,Pacific,Western,7,2,8,0.875,4,3,4,3
2015-16,2015-10-17,Vancouver Canucks,0,Pacific,Western,7,2,10,0.7,6,1,6,1
2015-16,2015-10-19,Vancouver Canucks,1,Pacific,Western,8,2,12,0.6666666666666666,6,2,6,2
2015-16,2015-10-23,Vancouver Canucks,0,Pacific,Western,8,2,14,0.5714285714285714,7,1,8,0
2015-16,2015-10-25,Vancouver Canucks,1,Pacific,Western,9,2,16,0.5625,9,0,9,0
2015-16,2015-10-28,Vancouver Canucks,2,Pacific,Western,11,2,18,0.6111111111111112,11,0,11,0
2015-16,2015-10-30,Vancouver Canucks,1,Pacific,Western,12,2,20,0.6,11,1,12,0
2015-16,2015-10-31,Vancouver Canucks,2,Pacific,Western,14,2,22,0.6363636363636364,11,3,12,2
2015-16,2015-11-03,Vancouver Canucks,2,Pacific,Western,16,2,24,0.6666666666666666,12,4,14,2
2015-16,2015-11-05,Vancouver Canucks,0,Pacific,Western,16,2,26,0.6153846153846154,12,4,15,1
2015-16,2015-11-07,Vancouver Canucks,0,Pacific,Western,16,2,28,0.5714285714285714,14,2,15,1
2015-16,2015-11-08,Vancouver Canucks,1,Pacific,Western,17,2,30,0.5666666666666667,14,3,15,2
2015-16,2015-11-11,Vancouver Canucks,2,Pacific,Western,19,2,32,0.59375,17,2,17,2
2015-16,2015-11-13,Vancouver Canucks,0,Pacific,Western,19,2,34,0.5588235294117647,19,0,18,1
2015-16,2015-11-15,Vancouver Canucks,0,Pacific,Western,19,2,36,0.5277777777777778,19,0,19,0
2015-16,2015-11-17,Vancouver Canucks,1,Pacific,Western,20,2,38,0.5263157894736842,19,1,19,1
2015-16,2015-11-19,Vancouver Canucks,0,Pacific,Western,20,2,40,0.5,20,0,20,0
2015-16,2015-11-22,Vancouver Canucks,2,Pacific,Western,22,2,42,0.5238095238095238,22,0,22,0
2015-16,2015-11-23,Vancouver Canucks,0,Pacific,Western,22,2,44,0.5,22,0,22,0
2015-16,2015-11-26,Vancouver Canucks,2,Pacific,Western,24,2,46,0.5217391304347826,24,0,24,0
2015-16,2015-11-28,Vancouver Canucks,1,Pacific,Western,25,2,48,0.5208333333333334,25,0,25,0
2015-16,2015-12-01,Vancouver Canucks,0,Pacific,Western,25,2,50,0.5,27,-2,26,-1
2015-16,2015-12-02,Vancouver Canucks,1,Pacific,Western,26,2,52,0.5,27,-1,27,-1
2015-16,2015-12-04,Vancouver Canucks,0,Pacific,Western,26,2,54,0.48148148148148145,27,-1,27,-1
2015-16,2015-12-06,Vancouver Canucks,0,Pacific,Western,26,2,56,0.4642857142857143,27,-1,28,-2
2015-16,2015-12-08,Vancouver Canucks,2,Pacific,Western,28,2,58,0.4827586206896552,28,0,28,0
2015-16,2015-12-10,Vancouver Canucks,2,Pacific,Western,30,2,60,0.5,29,1,29,1
2015-16,2015-12-14,Vancouver Canucks,0,Pacific,Western,30,2,62,0.4838709677419355,30,0,30,0
2015-16,2015-12-16,Vancouver Canucks,0,Pacific,Western,30,2,64,0.46875,30,0,31,-1
2015-16,2015-12-18,Vancouver Canucks,0,Pacific,Western,30,2,66,0.45454545454545453,32,-2,33,-3
2015-16,2015-12-19,Vancouver Canucks,2,Pacific,Western,32,2,68,0.47058823529411764,32,0,33,-1
2015-16,2015-12-20,Vancouver Canucks,1,Pacific,Western,33,2,70,0.4714285714285714,33,0,33,0
2015-16,2015-12-23,Vancouver Canucks,2,Pacific,Western,35,2,72,0.4861111111111111,35,0,35,0
2015-16,2015-12-27,Vancouver Canucks,2,Pacific,Western,37,2,74,0.5,36,1,36,1
2015-16,2015-12-29,Vancouver Canucks,0,Pacific,Western,37,2,76,0.4868421052631579,37,0,37,0
2015-16,2016-01-02,Vancouver Canucks,2,Pacific,Western,39,2,78,0.5,39,0,39,0
2015-16,2016-01-05,Vancouver Canucks,0,Pacific,Western,39,2,80,0.4875,39,0,41,-2
2015-16,2016-01-07,Vancouver Canucks,2,Pacific,Western,41,2,82,0.5,41,0,42,-1
2015-16,2016-01-10,Vancouver Canucks,1,Pacific,Western,42,2,84,0.5,42,0,45,-3
2015-16,2016-01-12,Vancouver Canucks,2,Pacific,Western,44,2,86,0.5116279069767442,44,0,45,-1
2015-16,2016-01-15,Vancouver Canucks,0,Pacific,Western,44,2,88,0.5,46,-2,46,-2
2015-16,2016-01-16,Vancouver Canucks,2,Pacific,Western,46,2,90,0.5111111111111111,46,0,46,0
2015-16,2016-01-17,Vancouver Canucks,2,Pacific,Western,48,2,92,0.5217391304347826,48,0,48,0
2015-16,2016-01-20,Vancouver Canucks,1,Pacific,Western,49,2,94,0.5212765957446809,49,0,49,0
2015-16,2016-01-22,Vancouver Canucks,2,Pacific,Western,51,2,96,0.53125,51,0,51,0
2015-16,2016-01-23,Vancouver Canucks,0,Pacific,Western,51,2,98,0.5204081632653061,51,0,51,0
2015-16,2016-01-27,Vancouver Canucks,0,Pacific,Western,51,2,100,0.51,53,-2,54,-3
2015-16,2016-02-05,Vancouver Canucks,1,Pacific,Western,52,2,102,0.5098039215686274,55,-3,55,-3
2015-16,2016-02-07,Vancouver Canucks,0,Pacific,Western,52,2,104,0.5,57,-5,57,-5
2015-16,2016-02-10,Vancouver Canucks,2,Pacific,Western,54,2,106,0.5094339622641509,59,-5,58,-4
2015-16,2016-02-11,Vancouver Canucks,2,Pacific,Western,56,2,108,0.5185185185185185,59,-3,58,-2
2015-16,2016-02-14,Vancouver Canucks,0,Pacific,Western,56,2,110,0.509090909090909,62,-6,61,-5
2015-16,2016-02-16,Vancouver Canucks,0,Pacific,Western,56,2,112,0.5,63,-7,62,-6
2015-16,2016-02-19,Vancouver Canucks,0,Pacific,Western,56,2,114,0.49122807017543857,67,-11,64,-8
2015-16,2016-02-20,Vancouver Canucks,0,Pacific,Western,56,2,116,0.4827586206896552,67,-11,64,-8
2015-16,2016-02-22,Vancouver Canucks,2,Pacific,Western,58,2,118,0.4915254237288136,67,-9,65,-7
2015-16,2016-02-26,Vancouver Canucks,2,Pacific,Western,60,2,120,0.5,70,-10,68,-8
2015-16,2016-02-29,Vancouver Canucks,0,Pacific,Western,60,2,122,0.4918032786885246,72,-12,68,-8
2015-16,2016-03-02,Vancouver Canucks,0,Pacific,Western,60,2,124,0.4838709677419355,74,-14,68,-8
2015-16,2016-03-04,Vancouver Canucks,0,Pacific,Western,60,2,126,0.47619047619047616,76,-16,70,-10
2015-16,2016-03-06,Vancouver Canucks,2,Pacific,Western,62,2,128,0.484375,76,-14,72,-10
2015-16,2016-03-08,Vancouver Canucks,0,Pacific,Western,62,2,130,0.47692307692307695,78,-16,72,-10
2015-16,2016-03-10,Vancouver Canucks,2,Pacific,Western,64,2,132,0.48484848484848486,80,-16,74,-10
2015-16,2016-03-13,Vancouver Canucks,2,Pacific,Western,66,2,134,0.4925373134328358,82,-16,74,-8
2015-16,2016-03-15,Vancouver Canucks,0,Pacific,Western,66,2,136,0.4852941176470588,82,-16,75,-9
2015-16,2016-03-17,Vancouver Canucks,0,Pacific,Western,66,2,138,0.4782608695652174,84,-18,76,-10
2015-16,2016-03-19,Vancouver Canucks,0,Pacific,Western,66,2,140,0.4714285714285714,86,-20,78,-12
2015-16,2016-03-20,Vancouver Canucks,0,Pacific,Western,66,2,142,0.4647887323943662,86,-20,78,-12
2015-16,2016-03-23,Vancouver Canucks,0,Pacific,Western,66,2,144,0.4583333333333333,88,-22,81,-15
2015-16,2016-03-25,Vancouver Canucks,1,Pacific,Western,67,2,146,0.4589041095890411,88,-21,83,-16
2015-16,2016-03-26,Vancouver Canucks,0,Pacific,Western,67,2,148,0.4527027027027027,88,-21,85,-18
2015-16,2016-03-28,Vancouver Canucks,0,Pacific,Western,67,2,150,0.44666666666666666,88,-21,85,-18
2015-16,2016-03-30,Vancouver Canucks,0,Pacific,Western,67,2,152,0.4407894736842105,92,-25,87,-20
2015-16,2016-04-01,Vancouver Canucks,2,Pacific,Western,69,2,154,0.44805194805194803,92,-23,87,-18
2015-16,2016-04-02,Vancouver Canucks,2,Pacific,Western,71,2,156,0.4551282051282051,92,-21,87,-16
2015-16,2016-04-05,Vancouver Canucks,2,Pacific,Western,73,2,158,0.4620253164556962,94,-21,87,-14
2015-16,2016-04-06,Vancouver Canucks,0,Pacific,Western,73,2,160,0.45625,96,-23,87,-14
2015-16,2016-04-08,Vancouver Canucks,0,Pacific,Western,73,2,162,0.4506172839506173,96,-23,87,-14
2015-16,2016-04-10,Vancouver Canucks,2,Pacific,Western,75,2,164,0.4573170731707317,98,-23,87,-12
2015-16,2015-10-10,Washington Capitals,2,Metropolitan,Eastern,2,2,2,1.0,1,1,1,1
2015-16,2015-10-13,Washington Capitals,0,Metropolitan,Eastern,2,2,4,0.5,3,-1,3,-1
2015-16,2015-10-15,Washington Capitals,2,Metropolitan,Eastern,4,2,6,0.6666666666666666,5,-1,5,-1
2015-16,2015-10-17,Washington Capitals,2,Metropolitan,Eastern,6,2,8,0.75,6,0,6,0
2015-16,2015-10-21,Washington Capitals,2,Metropolitan,Eastern,8,2,10,0.8,8,0,6,2
2015-16,2015-10-23,Washington Capitals,2,Metropolitan,Eastern,10,2,12,0.8333333333333334,9,1,7,3
2015-16,2015-10-24,Washington Capitals,2,Metropolitan,Eastern,12,2,14,0.8571428571428571,9,3,8,4
2015-16,2015-10-29,Washington Capitals,0,Metropolitan,Eastern,12,2,16,0.75,12,0,11,1
2015-16,2015-10-30,Washington Capitals,2,Metropolitan,Eastern,14,2,18,0.7777777777777778,14,0,11,3
2015-16,2015-10-31,Washington Capitals,2,Metropolitan,Eastern,16,2,20,0.8,15,1,12,4
2015-16,2015-11-04,Washington Capitals,0,Metropolitan,Eastern,16,2,22,0.7272727272727273,16,0,13,3
2015-16,2015-11-06,Washington Capitals,2,Metropolitan,Eastern,18,2,24,0.75,17,1,13,5
2015-16,2015-11-08,Washington Capitals,2,Metropolitan,Eastern,20,2,26,0.7692307692307693,18,2,16,4
2015-16,2015-11-11,Washington Capitals,0,Metropolitan,Eastern,20,2,28,0.7142857142857143,19,1,17,3
2015-16,2015-11-13,Washington Capitals,2,Metropolitan,Eastern,22,2,30,0.7333333333333333,20,2,18,4
2015-16,2015-11-14,Washington Capitals,1,Metropolitan,Eastern,23,2,32,0.71875,21,2,18,5
2015-16,2015-11-19,Washington Capitals,2,Metropolitan,Eastern,25,2,34,0.7352941176470589,23,2,20,5
2015-16,2015-11-20,Washington Capitals,0,Metropolitan,Eastern,25,2,36,0.6944444444444444,24,1,21,4
2015-16,2015-11-22,Washington Capitals,2,Metropolitan,Eastern,27,2,38,0.7105263157894737,24,3,23,4
2015-16,2015-11-24,Washington Capitals,2,Metropolitan,Eastern,29,2,40,0.725,24,5,23,6
2015-16,2015-11-26,Washington Capitals,2,Metropolitan,Eastern,31,2,42,0.7380952380952381,26,5,25,6
2015-16,2015-11-27,Washington Capitals,2,Metropolitan,Eastern,33,2,44,0.75,26,7,25,8
2015-16,2015-11-29,Washington Capitals,2,Metropolitan,Eastern,35,2,46,0.7608695652173914,28,7,27,8
2015-16,2015-12-04,Washington Capitals,2,Metropolitan,Eastern,37,2,48,0.7708333333333334,32,5,28,9
2015-16,2015-12-05,Washington Capitals,1,Metropolitan,Eastern,38,2,50,0.76,34,4,30,8
2015-16,2015-12-09,Washington Capitals,2,Metropolitan,Eastern,40,2,52,0.7692307692307693,37,3,31,9
2015-16,2015-12-11,Washington Capitals,0,Metropolitan,Eastern,40,2,54,0.7407407407407407,37,3,32,8
2015-16,2015-12-13,Washington Capitals,2,Metropolitan,Eastern,42,2,56,0.75,39,3,34,8
2015-16,2015-12-15,Washington Capitals,2,Metropolitan,Eastern,44,2,58,0.7586206896551724,40,4,34,10
2015-16,2015-12-17,Washington Capitals,2,Metropolitan,Eastern,46,2,60,0.7666666666666667,41,5,36,10
2015-16,2015-12-19,Washington Capitals,2,Metropolitan,Eastern,48,2,62,0.7741935483870968,41,7,38,10
2015-16,2015-12-21,Washington Capitals,2,Metropolitan,Eastern,50,2,64,0.78125,41,9,39,11
2015-16,2015-12-22,Washington Capitals,2,Metropolitan,Eastern,52,2,66,0.7878787878787878,42,10,39,13
2015-16,2015-12-27,Washington Capitals,2,Metropolitan,Eastern,54,2,68,0.7941176470588235,43,11,42,12
2015-16,2015-12-29,Washington Capitals,2,Metropolitan,Eastern,56,2,70,0.8,43,13,42,14
2015-16,2015-12-31,Washington Capitals,0,Metropolitan,Eastern,56,2,72,0.7777777777777778,46,10,43,13
2015-16,2015-12-31,Washington Capitals,2,Metropolitan,Eastern,58,2,74,0.7837837837837838,46,12,43,15
2015-16,2016-01-03,Washington Capitals,1,Metropolitan,Eastern,59,2,76,0.7763157894736842,46,13,44,15
2015-16,2016-01-06,Washington Capitals,2,Metropolitan,Eastern,61,2,78,0.782051282051282,48,13,44,17
2015-16,2016-01-08,Washington Capitals,2,Metropolitan,Eastern,63,2,80,0.7875,48,15,44,19
2015-16,2016-01-09,Washington Capitals,2,Metropolitan,Eastern,65,2,82,0.7926829268292683,49,16,45,20
2015-16,2016-01-11,Washington Capitals,2,Metropolitan,Eastern,67,2,84,0.7976190476190477,49,18,47,20
2015-16,2016-01-15,Washington Capitals,2,Metropolitan,Eastern,69,2,86,0.8023255813953488,51,18,47,22
2015-16,2016-01-17,Washington Capitals,0,Metropolitan,Eastern,69,2,88,0.7840909090909091,53,16,50,19
2015-16,2016-01-17,Washington Capitals,2,Metropolitan,Eastern,71,2,90,0.7888888888888889,53,18,50,21
2015-16,2016-01-20,Washington Capitals,2,Metropolitan,Eastern,73,2,92,0.7934782608695652,54,19,51,22
2015-16,2016-01-28,Washington Capitals,1,Metropolitan,Eastern,74,2,94,0.7872340425531915,56,18,55,19
2015-16,2016-02-03,Washington Capitals,0,Metropolitan,Eastern,74,2,96,0.7708333333333334,58,16,57,17
2015-16,2016-02-05,Washington Capitals,2,Metropolitan,Eastern,76,2,98,0.7755102040816326,58,18,58,18
2015-16,2016-02-06,Washington Capitals,2,Metropolitan,Eastern,78,2,100,0.78,59,19,58,20
2015-16,2016-02-07,Washington Capitals,2,Metropolitan,Eastern,80,2,102,0.7843137254901961,60,20,59,21
2015-16,2016-02-10,Washington Capitals,2,Metropolitan,Eastern,82,2,104,0.7884615384615384,62,20,61,21
2015-16,2016-02-12,Washington Capitals,2,Metropolitan,Eastern,84,2,106,0.7924528301886793,64,20,61,23
2015-16,2016-02-14,Washington Capitals,0,Metropolitan,Eastern,84,2,108,0.7777777777777778,65,19,64,20
2015-16,2016-02-17,Washington Capitals,2,Metropolitan,Eastern,86,2,110,0.7818181818181819,66,20,64,22
2015-16,2016-02-19,Washington Capitals,2,Metropolitan,Eastern,88,2,112,0.7857142857142857,67,21,66,22
2015-16,2016-02-21,Washington Capitals,2,Metropolitan,Eastern,90,2,114,0.7894736842105263,69,21,68,22
2015-16,2016-02-23,Washington Capitals,2,Metropolitan,Eastern,92,2,116,0.7931034482758621,69,23,68,24
2015-16,2016-02-25,Washington Capitals,0,Metropolitan,Eastern,92,2,118,0.7796610169491526,71,21,68,24
2015-16,2016-02-27,Washington Capitals,2,Metropolitan,Eastern,94,2,120,0.7833333333333333,73,21,70,24
2015-16,2016-02-28,Washington Capitals,0,Metropolitan,Eastern,94,2,122,0.7704918032786885,73,21,70,24
2015-16,2016-03-02,Washington Capitals,2,Metropolitan,Eastern,96,2,124,0.7741935483870968,75,21,72,24
2015-16,2016-03-03,Washington Capitals,2,Metropolitan,Eastern,98,2,126,0.7777777777777778,75,23,72,26
2015-16,2016-03-05,Washington Capitals,0,Metropolitan,Eastern,98,2,128,0.765625,77,21,74,24
2015-16,2016-03-06,Washington Capitals,2,Metropolitan,Eastern,100,2,130,0.7692307692307693,79,21,75,25
2015-16,2016-03-08,Washington Capitals,2,Metropolitan,Eastern,102,2,132,0.7727272727272727,79,23,75,27
2015-16,2016-03-10,Washington Capitals,1,Metropolitan,Eastern,103,2,134,0.7686567164179104,82,21,75,28
2015-16,2016-03-13,Washington Capitals,0,Metropolitan,Eastern,103,2,136,0.7573529411764706,82,21,79,24
2015-16,2016-03-15,Washington Capitals,2,Metropolitan,Eastern,105,2,138,0.7608695652173914,85,20,79,26
2015-16,2016-03-18,Washington Capitals,2,Metropolitan,Eastern,107,2,140,0.7642857142857142,85,22,81,26
2015-16,2016-03-20,Washington Capitals,0,Metropolitan,Eastern,107,2,142,0.7535211267605634,88,19,83,24
2015-16,2016-03-22,Washington Capitals,2,Metropolitan,Eastern,109,2,144,0.7569444444444444,88,21,83,26
2015-16,2016-03-25,Washington Capitals,2,Metropolitan,Eastern,111,2,146,0.7602739726027398,88,23,85,26
2015-16,2016-03-26,Washington Capitals,0,Metropolitan,Eastern,111,2,148,0.75,90,21,85,26
2015-16,2016-03-28,Washington Capitals,2,Metropolitan,Eastern,113,2,150,0.7533333333333333,92,21,87,26
2015-16,2016-03-31,Washington Capitals,1,Metropolitan,Eastern,114,2,152,0.75,95,19,88,26
2015-16,2016-04-02,Washington Capitals,2,Metropolitan,Eastern,116,2,154,0.7532467532467533,95,21,91,25
2015-16,2016-04-03,Washington Capitals,0,Metropolitan,Eastern,116,2,156,0.7435897435897436,95,21,91,25
2015-16,2016-04-05,Washington Capitals,1,Metropolitan,Eastern,117,2,158,0.740506329113924,99,18,91,26
2015-16,2016-04-07,Washington Capitals,1,Metropolitan,Eastern,118,2,160,0.7375,99,19,93,25
2015-16,2016-04-10,Washington Capitals,2,Metropolitan,Eastern,120,2,162,0.7407407407407407,101,19,93,27
2015-16,2016-04-10,Washington Capitals,0,Metropolitan,Eastern,120,2,164,0.7317073170731707,101,19,93,27
2015-16,2015-10-08,Winnipeg Jets,2,Central,Western,2,2,2,1.0,0,2,0,2
2015-16,2015-10-09,Winnipeg Jets,2,Central,Western,4,2,4,1.0,2,2,2,2
2015-16,2015-10-12,Winnipeg Jets,0,Central,Western,4,2,6,0.6666666666666666,4,0,2,2
2015-16,2015-10-13,Winnipeg Jets,2,Central,Western,6,2,8,0.75,4,2,2,4
2015-16,2015-10-17,Winnipeg Jets,2,Central,Western,8,2,10,0.8,8,0,6,2
2015-16,2015-10-18,Winnipeg Jets,0,Central,Western,8,2,12,0.6666666666666666,8,0,6,2
2015-16,2015-10-24,Winnipeg Jets,1,Central,Western,9,2,14,0.6428571428571429,11,-2,8,1
2015-16,2015-10-25,Winnipeg Jets,2,Central,Western,11,2,16,0.6875,11,0,9,2
2015-16,2015-10-28,Winnipeg Jets,0,Central,Western,11,2,18,0.6111111111111112,13,-2,11,0
2015-16,2015-10-30,Winnipeg Jets,2,Central,Western,13,2,20,0.65,15,-2,12,1
2015-16,2015-10-31,Winnipeg Jets,2,Central,Western,15,2,22,0.6818181818181818,16,-1,12,3
2015-16,2015-11-02,Winnipeg Jets,0,Central,Western,15,2,24,0.625,16,-1,12,3
2015-16,2015-11-05,Winnipeg Jets,2,Central,Western,17,2,26,0.6538461538461539,17,0,15,2
2015-16,2015-11-06,Winnipeg Jets,1,Central,Western,18,2,28,0.6428571428571429,18,0,15,3
2015-16,2015-11-08,Winnipeg Jets,0,Central,Western,18,2,30,0.6,18,0,15,3
2015-16,2015-11-11,Winnipeg Jets,0,Central,Western,18,2,32,0.5625,20,-2,17,1
2015-16,2015-11-13,Winnipeg Jets,0,Central,Western,18,2,34,0.5294117647058824,22,-4,18,0
2015-16,2015-11-15,Winnipeg Jets,0,Central,Western,18,2,36,0.5,23,-5,19,-1
2015-16,2015-11-17,Winnipeg Jets,0,Central,Western,18,2,38,0.47368421052631576,23,-5,19,-1
2015-16,2015-11-19,Winnipeg Jets,2,Central,Western,20,2,40,0.5,25,-5,20,0
2015-16,2015-11-22,Winnipeg Jets,2,Central,Western,22,2,42,0.5238095238095238,25,-3,22,0
2015-16,2015-11-24,Winnipeg Jets,0,Central,Western,22,2,44,0.5,25,-3,22,0
2015-16,2015-11-26,Winnipeg Jets,0,Central,Western,22,2,46,0.4782608695652174,27,-5,24,-2
2015-16,2015-11-27,Winnipeg Jets,2,Central,Western,24,2,48,0.5,28,-4,24,0
2015-16,2015-11-29,Winnipeg Jets,0,Central,Western,24,2,50,0.48,29,-5,26,-2
2015-16,2015-12-03,Winnipeg Jets,2,Central,Western,26,2,52,0.5,30,-4,27,-1
2015-16,2015-12-05,Winnipeg Jets,2,Central,Western,28,2,54,0.5185185185185185,30,-2,28,0
2015-16,2015-12-06,Winnipeg Jets,0,Central,Western,28,2,56,0.5,32,-4,28,0
2015-16,2015-12-11,Winnipeg Jets,2,Central,Western,30,2,58,0.5172413793103449,35,-5,30,0
2015-16,2015-12-12,Winnipeg Jets,0,Central,Western,30,2,60,0.5,36,-6,30,0
2015-16,2015-12-16,Winnipeg Jets,0,Central,Western,30,2,62,0.4838709677419355,38,-8,31,-1
2015-16,2015-12-19,Winnipeg Jets,2,Central,Western,32,2,64,0.5,42,-10,33,-1
2015-16,2015-12-22,Winnipeg Jets,0,Central,Western,32,2,66,0.48484848484848486,44,-12,34,-2
2015-16,2015-12-23,Winnipeg Jets,0,Central,Western,32,2,68,0.47058823529411764,44,-12,35,-3
2015-16,2015-12-28,Winnipeg Jets,2,Central,Western,34,2,70,0.4857142857142857,44,-10,37,-3
2015-16,2015-12-30,Winnipeg Jets,2,Central,Western,36,2,72,0.5,46,-10,37,-1
2015-16,2016-01-01,Winnipeg Jets,0,Central,Western,36,2,74,0.4864864864864865,48,-12,39,-3
2015-16,2016-01-03,Winnipeg Jets,2,Central,Western,38,2,76,0.5,48,-10,39,-1
2015-16,2016-01-04,Winnipeg Jets,0,Central,Western,38,2,78,0.48717948717948717,50,-12,39,-1
2015-16,2016-01-06,Winnipeg Jets,2,Central,Western,40,2,80,0.5,51,-11,41,-1
2015-16,2016-01-08,Winnipeg Jets,1,Central,Western,41,2,82,0.5,52,-11,43,-2
2015-16,2016-01-10,Winnipeg Jets,0,Central,Western,41,2,84,0.4880952380952381,55,-14,45,-4
2015-16,2016-01-13,Winnipeg Jets,0,Central,Western,41,2,86,0.47674418604651164,57,-16,45,-4
2015-16,2016-01-15,Winnipeg Jets,2,Central,Western,43,2,88,0.48863636363636365,57,-14,46,-3
2015-16,2016-01-16,Winnipeg Jets,2,Central,Western,45,2,90,0.5,57,-12,46,-1
2015-16,2016-01-19,Winnipeg Jets,0,Central,Western,45,2,92,0.4891304347826087,61,-16,49,-4
2015-16,2016-01-22,Winnipeg Jets,0,Central,Western,45,2,94,0.4787234042553192,63,-18,51,-6
2015-16,2016-01-24,Winnipeg Jets,0,Central,Western,45,2,96,0.46875,64,-19,52,-7
2015-16,2016-01-27,Winnipeg Jets,2,Central,Western,47,2,98,0.47959183673469385,64,-17,54,-7
2015-16,2016-02-03,Winnipeg Jets,0,Central,Western,47,2,100,0.47,66,-19,55,-8
2015-16,2016-02-06,Winnipeg Jets,0,Central,Western,47,2,102,0.46078431372549017,66,-19,56,-9
2015-16,2016-02-07,Winnipeg Jets,2,Central,Western,49,2,104,0.47115384615384615,68,-19,57,-8
2015-16,2016-02-10,Winnipeg Jets,2,Central,Western,51,2,106,0.4811320754716981,69,-18,58,-7
2015-16,2016-02-12,Winnipeg Jets,0,Central,Western,51,2,108,0.4722222222222222,69,-18,58,-7
2015-16,2016-02-14,Winnipeg Jets,2,Central,Western,53,2,110,0.4818181818181818,73,-20,61,-8
2015-16,2016-02-17,Winnipeg Jets,0,Central,Western,53,2,112,0.4732142857142857,75,-22,62,-9
2015-16,2016-02-19,Winnipeg Jets,1,Central,Western,54,2,114,0.47368421052631576,77,-23,64,-10
2015-16,2016-02-21,Winnipeg Jets,0,Central,Western,54,2,116,0.46551724137931033,79,-25,65,-11
2015-16,2016-02-24,Winnipeg Jets,0,Central,Western,54,2,118,0.4576271186440678,79,-25,66,-12
2015-16,2016-02-26,Winnipeg Jets,2,Central,Western,56,2,120,0.4666666666666667,79,-23,68,-12
2015-16,2016-02-27,Winnipeg Jets,0,Central,Western,56,2,122,0.45901639344262296,79,-23,68,-12
2015-16,2016-03-02,Winnipeg Jets,0,Central,Western,56,2,124,0.45161290322580644,83,-27,68,-12
2015-16,2016-03-04,Winnipeg Jets,1,Central,Western,57,2,126,0.4523809523809524,83,-26,70,-13
2015-16,2016-03-06,Winnipeg Jets,2,Central,Western,59,2,128,0.4609375,83,-24,72,-13
2015-16,2016-03-07,Winnipeg Jets,0,Central,Western,59,2,130,0.45384615384615384,85,-26,72,-13
2015-16,2016-03-09,Winnipeg Jets,0,Central,Western,59,2,132,0.44696969696969696,85,-26,72,-13
2015-16,2016-03-11,Winnipeg Jets,0,Central,Western,59,2,134,0.44029850746268656,87,-28,74,-15
2015-16,2016-03-13,Winnipeg Jets,2,Central,Western,61,2,136,0.4485294117647059,88,-27,74,-13
2015-16,2016-03-15,Winnipeg Jets,2,Central,Western,63,2,138,0.45652173913043476,88,-25,75,-12
2015-16,2016-03-17,Winnipeg Jets,0,Central,Western,63,2,140,0.45,88,-25,76,-13
2015-16,2016-03-19,Winnipeg Jets,0,Central,Western,63,2,142,0.44366197183098594,90,-27,78,-15
2015-16,2016-03-20,Winnipeg Jets,1,Central,Western,64,2,144,0.4444444444444444,90,-26,78,-14
2015-16,2016-03-23,Winnipeg Jets,2,Central,Western,66,2,146,0.4520547945205479,91,-25,81,-15
2015-16,2016-03-25,Winnipeg Jets,2,Central,Western,68,2,148,0.4594594594594595,91,-23,83,-15
2015-16,2016-03-26,Winnipeg Jets,0,Central,Western,68,2,150,0.4533333333333333,91,-23,85,-17
2015-16,2016-03-28,Winnipeg Jets,1,Central,Western,69,2,152,0.45394736842105265,95,-26,85,-16
2015-16,2016-03-30,Winnipeg Jets,0,Central,Western,69,2,154,0.44805194805194803,95,-26,87,-18
2015-16,2016-04-02,Winnipeg Jets,1,Central,Western,70,2,156,0.44871794871794873,97,-27,87,-17
2015-16,2016-04-04,Winnipeg Jets,2,Central,Western,72,2,158,0.45569620253164556,99,-27,87,-15
2015-16,2016-04-06,Winnipeg Jets,2,Central,Western,74,2,160,0.4625,101,-27,87,-13
2015-16,2016-04-08,Winnipeg Jets,2,Central,Western,76,2,162,0.4691358024691358,102,-26,87,-11
2015-16,2016-04-10,Winnipeg Jets,2,Central,Western,78,2,164,0.47560975609756095,103,-25,87,-9
2016-17,2016-10-14,Anaheim Ducks,0,Pacific,Western,0,2,2,0.0,0,0,0,0
2016-17,2016-10-15,Anaheim Ducks,0,Pacific,Western,0,2,4,0.0,0,0,0,0
2016-17,2016-10-16,Anaheim Ducks,1,Pacific,Western,1,2,6,0.16666666666666666,2,-1,2,-1
2016-17,2016-10-18,Anaheim Ducks,0,Pacific,Western,1,2,8,0.125,4,-3,2,-1
2016-17,2016-10-20,Anaheim Ducks,2,Pacific,Western,3,2,10,0.3,6,-3,4,-1
2016-17,2016-10-24,Anaheim Ducks,2,Pacific,Western,5,2,12,0.4166666666666667,6,-1,5,0
2016-17,2016-10-26,Anaheim Ducks,1,Pacific,Western,6,2,14,0.42857142857142855,8,-2,7,-1
2016-17,2016-10-27,Anaheim Ducks,2,Pacific,Western,8,2,16,0.5,8,0,7,1
2016-17,2016-10-29,Anaheim Ducks,0,Pacific,Western,8,2,18,0.4444444444444444,9,-1,8,0
2016-17,2016-11-02,Anaheim Ducks,2,Pacific,Western,10,2,20,0.5,10,0,9,1
2016-17,2016-11-03,Anaheim Ducks,0,Pacific,Western,10,2,22,0.45454545454545453,10,0,9,1
2016-17,2016-11-05,Anaheim Ducks,2,Pacific,Western,12,2,24,0.5,12,0,11,1
2016-17,2016-11-07,Anaheim Ducks,2,Pacific,Western,14,2,26,0.5384615384615384,12,2,11,3
2016-17,2016-11-10,Anaheim Ducks,1,Pacific,Western,15,2,28,0.5357142857142857,14,1,13,2
2016-17,2016-11-11,Anaheim Ducks,2,Pacific,Western,17,2,30,0.5666666666666667,16,1,14,3
2016-17,2016-11-13,Anaheim Ducks,0,Pacific,Western,17,2,32,0.53125,17,0,16,1
2016-17,2016-11-16,Anaheim Ducks,2,Pacific,Western,19,2,34,0.5588235294117647,18,1,17,2
2016-17,2016-11-18,Anaheim Ducks,2,Pacific,Western,21,2,36,0.5833333333333334,18,3,18,3
2016-17,2016-11-21,Anaheim Ducks,0,Pacific,Western,21,2,38,0.5526315789473685,21,0,19,2
2016-17,2016-11-23,Anaheim Ducks,1,Pacific,Western,22,2,40,0.55,21,1,20,2
2016-17,2016-11-25,Anaheim Ducks,0,Pacific,Western,22,2,42,0.5238095238095238,23,-1,22,0
2016-17,2016-11-27,Anaheim Ducks,2,Pacific,Western,24,2,44,0.5454545454545454,25,-1,23,1
2016-17,2016-11-30,Anaheim Ducks,2,Pacific,Western,26,2,46,0.5652173913043478,26,0,25,1
2016-17,2016-12-02,Anaheim Ducks,2,Pacific,Western,28,2,48,0.5833333333333334,28,0,25,3
2016-17,2016-12-04,Anaheim Ducks,1,Pacific,Western,29,2,50,0.58,29,0,26,3
2016-17,2016-12-05,Anaheim Ducks,0,Pacific,Western,29,2,52,0.5576923076923077,29,0,28,1
2016-17,2016-12-08,Anaheim Ducks,2,Pacific,Western,31,2,54,0.5740740740740741,31,0,29,2
2016-17,2016-12-10,Anaheim Ducks,2,Pacific,Western,33,2,56,0.5892857142857143,32,1,30,3
2016-17,2016-12-11,Anaheim Ducks,2,Pacific,Western,35,2,58,0.603448275862069,33,2,30,5
2016-17,2016-12-14,Anaheim Ducks,0,Pacific,Western,35,2,60,0.5833333333333334,35,0,30,5
2016-17,2016-12-16,Anaheim Ducks,2,Pacific,Western,37,2,62,0.5967741935483871,35,2,32,5
2016-17,2016-12-18,Anaheim Ducks,0,Pacific,Western,37,2,64,0.578125,37,0,34,3
2016-17,2016-12-20,Anaheim Ducks,2,Pacific,Western,39,2,66,0.5909090909090909,39,0,34,5
2016-17,2016-12-21,Anaheim Ducks,0,Pacific,Western,39,2,68,0.5735294117647058,39,0,35,4
2016-17,2016-12-23,Anaheim Ducks,1,Pacific,Western,40,2,70,0.5714285714285714,40,0,36,4
2016-17,2016-12-28,Anaheim Ducks,1,Pacific,Western,41,2,72,0.5694444444444444,41,0,38,3
2016-17,2016-12-30,Anaheim Ducks,2,Pacific,Western,43,2,74,0.581081081081081,43,0,39,4
2016-17,2016-12-31,Anaheim Ducks,1,Pacific,Western,44,2,76,0.5789473684210527,44,0,39,5
2016-17,2017-01-02,Anaheim Ducks,2,Pacific,Western,46,2,78,0.5897435897435898,45,1,40,6
2016-17,2017-01-05,Anaheim Ducks,2,Pacific,Western,48,2,80,0.6,45,3,42,6
2016-17,2017-01-07,Anaheim Ducks,2,Pacific,Western,50,2,82,0.6097560975609756,47,3,44,6
2016-17,2017-01-09,Anaheim Ducks,0,Pacific,Western,50,2,84,0.5952380952380952,49,1,44,6
2016-17,2017-01-11,Anaheim Ducks,2,Pacific,Western,52,2,86,0.6046511627906976,49,3,44,8
2016-17,2017-01-13,Anaheim Ducks,2,Pacific,Western,54,2,88,0.6136363636363636,51,3,46,8
2016-17,2017-01-15,Anaheim Ducks,2,Pacific,Western,56,2,90,0.6222222222222222,52,4,48,8
2016-17,2017-01-16,Anaheim Ducks,1,Pacific,Western,57,2,92,0.6195652173913043,53,4,48,9
2016-17,2017-01-18,Anaheim Ducks,2,Pacific,Western,59,2,94,0.6276595744680851,54,5,48,11
2016-17,2017-01-20,Anaheim Ducks,2,Pacific,Western,61,2,96,0.6354166666666666,57,4,49,12
2016-17,2017-01-22,Anaheim Ducks,0,Pacific,Western,61,2,98,0.6224489795918368,60,1,51,10
2016-17,2017-01-24,Anaheim Ducks,2,Pacific,Western,63,2,100,0.63,60,3,51,12
2016-17,2017-01-26,Anaheim Ducks,0,Pacific,Western,63,2,102,0.6176470588235294,62,1,52,11
2016-17,2017-02-01,Anaheim Ducks,2,Pacific,Western,65,2,104,0.625,64,1,53,12
2016-17,2017-02-04,Anaheim Ducks,0,Pacific,Western,65,2,106,0.6132075471698113,64,1,57,8
2016-17,2017-02-05,Anaheim Ducks,1,Pacific,Western,66,2,108,0.6111111111111112,66,0,57,9
2016-17,2017-02-08,Anaheim Ducks,0,Pacific,Western,66,2,110,0.6,66,0,59,7
2016-17,2017-02-10,Anaheim Ducks,2,Pacific,Western,68,2,112,0.6071428571428571,66,2,60,8
2016-17,2017-02-12,Anaheim Ducks,0,Pacific,Western,68,2,114,0.5964912280701754,66,2,60,8
2016-17,2017-02-15,Anaheim Ducks,2,Pacific,Western,70,2,116,0.603448275862069,68,2,60,10
2016-17,2017-02-18,Anaheim Ducks,0,Pacific,Western,70,2,118,0.5932203389830508,70,0,61,9
2016-17,2017-02-20,Anaheim Ducks,2,Pacific,Western,72,2,120,0.6,72,0,62,10
2016-17,2017-02-21,Anaheim Ducks,0,Pacific,Western,72,2,122,0.5901639344262295,72,0,62,10
2016-17,2017-02-23,Anaheim Ducks,2,Pacific,Western,74,2,124,0.5967741935483871,74,0,64,10
2016-17,2017-02-25,Anaheim Ducks,0,Pacific,Western,74,2,126,0.5873015873015873,74,0,67,7
2016-17,2017-03-04,Anaheim Ducks,2,Pacific,Western,76,2,128,0.59375,76,0,68,8
2016-17,2017-03-06,Anaheim Ducks,0,Pacific,Western,76,2,130,0.5846153846153846,76,0,69,7
2016-17,2017-03-08,Anaheim Ducks,2,Pacific,Western,78,2,132,0.5909090909090909,78,0,71,7
2016-17,2017-03-10,Anaheim Ducks,2,Pacific,Western,80,2,134,0.5970149253731343,78,2,71,9
2016-17,2017-03-11,Anaheim Ducks,0,Pacific,Western,80,2,136,0.5882352941176471,79,1,73,7
2016-17,2017-03-13,Anaheim Ducks,2,Pacific,Western,82,2,138,0.5942028985507246,80,2,75,7
2016-17,2017-03-16,Anaheim Ducks,2,Pacific,Western,84,2,140,0.6,82,2,77,7
2016-17,2017-03-18,Anaheim Ducks,1,Pacific,Western,85,2,142,0.5985915492957746,84,1,79,6
2016-17,2017-03-19,Anaheim Ducks,2,Pacific,Western,87,2,144,0.6041666666666666,85,2,81,6
2016-17,2017-03-23,Anaheim Ducks,2,Pacific,Western,89,2,146,0.6095890410958904,87,2,83,6
2016-17,2017-03-25,Anaheim Ducks,2,Pacific,Western,91,2,148,0.6148648648648649,89,2,85,6
2016-17,2017-03-27,Anaheim Ducks,2,Pacific,Western,93,2,150,0.62,91,2,86,7
2016-17,2017-03-29,Anaheim Ducks,2,Pacific,Western,95,2,152,0.625,93,2,88,7
2016-17,2017-03-31,Anaheim Ducks,1,Pacific,Western,96,2,154,0.6233766233766234,93,3,89,7
2016-17,2017-04-02,Anaheim Ducks,1,Pacific,Western,97,2,156,0.6217948717948718,95,2,91,6
2016-17,2017-04-03,Anaheim Ducks,2,Pacific,Western,99,2,158,0.6265822784810127,95,4,91,8
2016-17,2017-04-05,Anaheim Ducks,2,Pacific,Western,101,2,160,0.63125,97,4,92,9
2016-17,2017-04-07,Anaheim Ducks,2,Pacific,Western,103,2,162,0.6358024691358025,97,6,94,9
2016-17,2017-04-10,Anaheim Ducks,2,Pacific,Western,105,2,164,0.6402439024390244,99,6,94,11
2016-17,2016-10-16,Arizona Coyotes,2,Pacific,Western,2,2,2,1.0,2,0,2,0
2016-17,2016-10-18,Arizona Coyotes,0,Pacific,Western,2,2,4,0.5,4,-2,2,0
2016-17,2016-10-20,Arizona Coyotes,0,Pacific,Western,2,2,6,0.3333333333333333,6,-4,4,-2
2016-17,2016-10-21,Arizona Coyotes,0,Pacific,Western,2,2,8,0.25,6,-4,4,-2
2016-17,2016-10-23,Arizona Coyotes,0,Pacific,Western,2,2,10,0.2,6,-4,5,-3
2016-17,2016-10-25,Arizona Coyotes,0,Pacific,Western,2,2,12,0.16666666666666666,6,-4,5,-3
2016-17,2016-10-27,Arizona Coyotes,2,Pacific,Western,4,2,14,0.2857142857142857,8,-4,7,-3
2016-17,2016-10-30,Arizona Coyotes,0,Pacific,Western,4,2,16,0.25,9,-5,8,-4
2016-17,2016-11-02,Arizona Coyotes,2,Pacific,Western,6,2,18,0.3333333333333333,10,-4,9,-3
2016-17,2016-11-04,Arizona Coyotes,2,Pacific,Western,8,2,20,0.4,11,-3,10,-2
2016-17,2016-11-05,Arizona Coyotes,0,Pacific,Western,8,2,22,0.36363636363636365,12,-4,11,-3
2016-17,2016-11-09,Arizona Coyotes,2,Pacific,Western,10,2,24,0.4166666666666667,14,-4,13,-3
2016-17,2016-11-11,Arizona Coyotes,0,Pacific,Western,10,2,26,0.38461538461538464,16,-6,14,-4
2016-17,2016-11-13,Arizona Coyotes,0,Pacific,Western,10,2,28,0.35714285714285715,17,-7,16,-6
2016-17,2016-11-17,Arizona Coyotes,1,Pacific,Western,11,2,30,0.36666666666666664,18,-7,17,-6
2016-17,2016-11-18,Arizona Coyotes,1,Pacific,Western,12,2,32,0.375,18,-6,18,-6
2016-17,2016-11-20,Arizona Coyotes,2,Pacific,Western,14,2,34,0.4117647058823529,19,-5,19,-5
2016-17,2016-11-24,Arizona Coyotes,0,Pacific,Western,14,2,36,0.3888888888888889,23,-9,21,-7
2016-17,2016-11-26,Arizona Coyotes,2,Pacific,Western,16,2,38,0.42105263157894735,23,-7,23,-7
2016-17,2016-11-27,Arizona Coyotes,2,Pacific,Western,18,2,40,0.45,25,-7,23,-5
2016-17,2016-11-30,Arizona Coyotes,1,Pacific,Western,19,2,42,0.4523809523809524,26,-7,25,-6
2016-17,2016-12-02,Arizona Coyotes,0,Pacific,Western,19,2,44,0.4318181818181818,28,-9,25,-6
2016-17,2016-12-04,Arizona Coyotes,1,Pacific,Western,20,2,46,0.43478260869565216,29,-9,26,-6
2016-17,2016-12-06,Arizona Coyotes,0,Pacific,Western,20,2,48,0.4166666666666667,29,-9,28,-8
2016-17,2016-12-07,Arizona Coyotes,0,Pacific,Western,20,2,50,0.4,30,-10,28,-8
2016-17,2016-12-09,Arizona Coyotes,1,Pacific,Western,21,2,52,0.40384615384615385,31,-10,29,-8
2016-17,2016-12-11,Arizona Coyotes,2,Pacific,Western,23,2,54,0.42592592592592593,33,-10,30,-7
2016-17,2016-12-13,Arizona Coyotes,0,Pacific,Western,23,2,56,0.4107142857142857,34,-11,30,-7
2016-17,2016-12-14,Arizona Coyotes,2,Pacific,Western,25,2,58,0.43103448275862066,35,-10,30,-5
2016-17,2016-12-16,Arizona Coyotes,2,Pacific,Western,27,2,60,0.45,35,-8,32,-5
2016-17,2016-12-17,Arizona Coyotes,0,Pacific,Western,27,2,62,0.43548387096774194,35,-8,34,-7
2016-17,2016-12-20,Arizona Coyotes,0,Pacific,Western,27,2,64,0.421875,39,-12,34,-7
2016-17,2016-12-22,Arizona Coyotes,0,Pacific,Western,27,2,66,0.4090909090909091,39,-12,35,-8
2016-17,2016-12-24,Arizona Coyotes,0,Pacific,Western,27,2,68,0.39705882352941174,40,-13,38,-11
2016-17,2016-12-28,Arizona Coyotes,0,Pacific,Western,27,2,70,0.38571428571428573,41,-14,38,-11
2016-17,2016-12-30,Arizona Coyotes,0,Pacific,Western,27,2,72,0.375,43,-16,39,-12
2016-17,2017-01-01,Arizona Coyotes,0,Pacific,Western,27,2,74,0.36486486486486486,44,-17,40,-13
2016-17,2017-01-05,Arizona Coyotes,0,Pacific,Western,27,2,76,0.35526315789473684,45,-18,42,-15
2016-17,2017-01-07,Arizona Coyotes,1,Pacific,Western,28,2,78,0.358974358974359,47,-19,44,-16
2016-17,2017-01-08,Arizona Coyotes,2,Pacific,Western,30,2,80,0.375,49,-19,44,-14
2016-17,2017-01-14,Arizona Coyotes,2,Pacific,Western,32,2,82,0.3902439024390244,51,-19,47,-15
2016-17,2017-01-15,Arizona Coyotes,0,Pacific,Western,32,2,84,0.38095238095238093,52,-20,48,-16
2016-17,2017-01-17,Arizona Coyotes,0,Pacific,Western,32,2,86,0.37209302325581395,54,-22,48,-16
2016-17,2017-01-19,Arizona Coyotes,0,Pacific,Western,32,2,88,0.36363636363636365,56,-24,48,-16
2016-17,2017-01-20,Arizona Coyotes,0,Pacific,Western,32,2,90,0.35555555555555557,57,-25,49,-17
2016-17,2017-01-22,Arizona Coyotes,2,Pacific,Western,34,2,92,0.3695652173913043,60,-26,51,-17
2016-17,2017-01-24,Arizona Coyotes,2,Pacific,Western,36,2,94,0.3829787234042553,60,-24,51,-15
2016-17,2017-01-27,Arizona Coyotes,2,Pacific,Western,38,2,96,0.3958333333333333,63,-25,53,-15
2016-17,2017-02-01,Arizona Coyotes,0,Pacific,Western,38,2,98,0.3877551020408163,64,-26,53,-15
2016-17,2017-02-03,Arizona Coyotes,0,Pacific,Western,38,2,100,0.38,64,-26,55,-17
2016-17,2017-02-05,Arizona Coyotes,2,Pacific,Western,40,2,102,0.39215686274509803,66,-26,57,-17
2016-17,2017-02-10,Arizona Coyotes,1,Pacific,Western,41,2,104,0.3942307692307692,66,-25,60,-19
2016-17,2017-02-12,Arizona Coyotes,2,Pacific,Western,43,2,106,0.4056603773584906,66,-23,60,-17
2016-17,2017-02-14,Arizona Coyotes,2,Pacific,Western,45,2,108,0.4166666666666667,66,-21,60,-15
2016-17,2017-02-15,Arizona Coyotes,0,Pacific,Western,45,2,110,0.4090909090909091,68,-23,60,-15
2016-17,2017-02-17,Arizona Coyotes,2,Pacific,Western,47,2,112,0.41964285714285715,70,-23,61,-14
2016-17,2017-02-19,Arizona Coyotes,0,Pacific,Western,47,2,114,0.41228070175438597,70,-23,62,-15
2016-17,2017-02-21,Arizona Coyotes,2,Pacific,Western,49,2,116,0.4224137931034483,72,-23,62,-13
2016-17,2017-02-24,Arizona Coyotes,0,Pacific,Western,49,2,118,0.4152542372881356,74,-25,66,-17
2016-17,2017-02-25,Arizona Coyotes,0,Pacific,Western,49,2,120,0.4083333333333333,74,-25,67,-18
2016-17,2017-02-27,Arizona Coyotes,2,Pacific,Western,51,2,122,0.4180327868852459,74,-23,67,-16
2016-17,2017-03-01,Arizona Coyotes,0,Pacific,Western,51,2,124,0.4112903225806452,74,-23,67,-16
2016-17,2017-03-03,Arizona Coyotes,0,Pacific,Western,51,2,126,0.40476190476190477,74,-23,68,-17
2016-17,2017-03-04,Arizona Coyotes,2,Pacific,Western,53,2,128,0.4140625,76,-23,68,-15
2016-17,2017-03-06,Arizona Coyotes,0,Pacific,Western,53,2,130,0.4076923076923077,76,-23,69,-16
2016-17,2017-03-10,Arizona Coyotes,1,Pacific,Western,54,2,132,0.4090909090909091,78,-24,71,-17
2016-17,2017-03-12,Arizona Coyotes,2,Pacific,Western,56,2,134,0.417910447761194,80,-24,75,-19
2016-17,2017-03-14,Arizona Coyotes,2,Pacific,Western,58,2,136,0.4264705882352941,82,-24,77,-19
2016-17,2017-03-15,Arizona Coyotes,2,Pacific,Western,60,2,138,0.43478260869565216,82,-22,77,-17
2016-17,2017-03-17,Arizona Coyotes,1,Pacific,Western,61,2,140,0.4357142857142857,83,-22,79,-18
2016-17,2017-03-19,Arizona Coyotes,0,Pacific,Western,61,2,142,0.4295774647887324,85,-24,81,-20
2016-17,2017-03-21,Arizona Coyotes,0,Pacific,Western,61,2,144,0.4236111111111111,87,-26,81,-20
2016-17,2017-03-21,Arizona Coyotes,2,Pacific,Western,63,2,146,0.4315068493150685,87,-24,81,-18
2016-17,2017-03-23,Arizona Coyotes,0,Pacific,Western,63,2,148,0.42567567567567566,87,-24,83,-20
2016-17,2017-03-25,Arizona Coyotes,0,Pacific,Western,63,2,150,0.42,89,-26,85,-22
2016-17,2017-03-28,Arizona Coyotes,0,Pacific,Western,63,2,152,0.4144736842105263,91,-28,88,-25
2016-17,2017-03-30,Arizona Coyotes,0,Pacific,Western,63,2,154,0.4090909090909091,93,-30,89,-26
2016-17,2017-04-01,Arizona Coyotes,2,Pacific,Western,65,2,156,0.4166666666666667,93,-28,91,-26
2016-17,2017-04-03,Arizona Coyotes,2,Pacific,Western,67,2,158,0.4240506329113924,95,-28,91,-24
2016-17,2017-04-05,Arizona Coyotes,1,Pacific,Western,68,2,160,0.425,97,-29,92,-24
2016-17,2017-04-07,Arizona Coyotes,2,Pacific,Western,70,2,162,0.43209876543209874,97,-27,94,-24
2016-17,2017-04-09,Arizona Coyotes,0,Pacific,Western,70,2,164,0.4268292682926829,99,-29,94,-24
2016-17,2016-10-13,Boston Bruins,2,Atlantic,Eastern,2,2,2,1.0,2,0,1,1
2016-17,2016-10-15,Boston Bruins,0,Atlantic,Eastern,2,2,4,0.5,4,-2,2,0
2016-17,2016-10-18,Boston Bruins,2,Atlantic,Eastern,4,2,6,0.6666666666666666,5,-1,4,0
2016-17,2016-10-20,Boston Bruins,2,Atlantic,Eastern,6,2,8,0.75,6,0,4,2
2016-17,2016-10-22,Boston Bruins,0,Atlantic,Eastern,6,2,10,0.6,8,-2,6,0
2016-17,2016-10-25,Boston Bruins,0,Atlantic,Eastern,6,2,12,0.5,10,-4,7,-1
2016-17,2016-10-27,Boston Bruins,0,Atlantic,Eastern,6,2,14,0.42857142857142855,10,-4,7,-1
2016-17,2016-10-29,Boston Bruins,2,Atlantic,Eastern,8,2,16,0.5,10,-2,8,0
2016-17,2016-11-01,Boston Bruins,2,Atlantic,Eastern,10,2,18,0.5555555555555556,12,-2,10,0
2016-17,2016-11-03,Boston Bruins,2,Atlantic,Eastern,12,2,20,0.6,13,-1,13,-1
2016-17,2016-11-05,Boston Bruins,0,Atlantic,Eastern,12,2,22,0.5454545454545454,14,-2,13,-1
2016-17,2016-11-08,Boston Bruins,2,Atlantic,Eastern,14,2,24,0.5833333333333334,14,0,13,1
2016-17,2016-11-09,Boston Bruins,0,Atlantic,Eastern,14,2,26,0.5384615384615384,15,-1,14,0
2016-17,2016-11-11,Boston Bruins,2,Atlantic,Eastern,16,2,28,0.5714285714285714,17,-1,16,0
2016-17,2016-11-13,Boston Bruins,2,Atlantic,Eastern,18,2,30,0.6,18,0,17,1
2016-17,2016-11-14,Boston Bruins,2,Atlantic,Eastern,20,2,32,0.625,19,1,17,3
2016-17,2016-11-18,Boston Bruins,0,Atlantic,Eastern,20,2,34,0.5882352941176471,21,-1,20,0
2016-17,2016-11-20,Boston Bruins,2,Atlantic,Eastern,22,2,36,0.6111111111111112,22,0,21,1
2016-17,2016-11-23,Boston Bruins,0,Atlantic,Eastern,22,2,38,0.5789473684210527,23,-1,22,0
2016-17,2016-11-25,Boston Bruins,0,Atlantic,Eastern,22,2,40,0.55,25,-3,23,-1
2016-17,2016-11-26,Boston Bruins,0,Atlantic,Eastern,22,2,42,0.5238095238095238,25,-3,24,-2
2016-17,2016-11-27,Boston Bruins,2,Atlantic,Eastern,24,2,44,0.5454545454545454,27,-3,25,-1
2016-17,2016-11-30,Boston Bruins,1,Atlantic,Eastern,25,2,46,0.5434782608695652,27,-2,25,0
2016-17,2016-12-02,Boston Bruins,2,Atlantic,Eastern,27,2,48,0.5625,27,0,27,0
2016-17,2016-12-03,Boston Bruins,2,Atlantic,Eastern,29,2,50,0.58,29,0,28,1
2016-17,2016-12-06,Boston Bruins,2,Atlantic,Eastern,31,2,52,0.5961538461538461,31,0,31,0
2016-17,2016-12-08,Boston Bruins,1,Atlantic,Eastern,32,2,54,0.5925925925925926,32,0,32,0
2016-17,2016-12-09,Boston Bruins,0,Atlantic,Eastern,32,2,56,0.5714285714285714,32,0,32,0
2016-17,2016-12-11,Boston Bruins,0,Atlantic,Eastern,32,2,58,0.5517241379310345,32,0,32,0
2016-17,2016-12-13,Boston Bruins,2,Atlantic,Eastern,34,2,60,0.5666666666666667,34,0,34,0
2016-17,2016-12-15,Boston Bruins,1,Atlantic,Eastern,35,2,62,0.5645161290322581,35,0,35,0
2016-17,2016-12-16,Boston Bruins,0,Atlantic,Eastern,35,2,64,0.546875,35,0,35,0
2016-17,2016-12-18,Boston Bruins,2,Atlantic,Eastern,37,2,66,0.5606060606060606,37,0,37,0
2016-17,2016-12-21,Boston Bruins,0,Atlantic,Eastern,37,2,68,0.5441176470588235,37,0,37,0
2016-17,2016-12-23,Boston Bruins,2,Atlantic,Eastern,39,2,70,0.5571428571428572,39,0,39,0
2016-17,2016-12-24,Boston Bruins,1,Atlantic,Eastern,40,2,72,0.5555555555555556,40,0,40,0
2016-17,2016-12-28,Boston Bruins,0,Atlantic,Eastern,40,2,74,0.5405405405405406,40,0,40,0
2016-17,2016-12-30,Boston Bruins,2,Atlantic,Eastern,42,2,76,0.5526315789473685,42,0,42,0
2016-17,2016-12-31,Boston Bruins,2,Atlantic,Eastern,44,2,78,0.5641025641025641,44,0,44,0
2016-17,2017-01-03,Boston Bruins,0,Atlantic,Eastern,44,2,80,0.55,44,0,44,0
2016-17,2017-01-06,Boston Bruins,0,Atlantic,Eastern,44,2,82,0.5365853658536586,44,0,44,0
2016-17,2017-01-08,Boston Bruins,2,Atlantic,Eastern,46,2,84,0.5476190476190477,44,2,44,2
2016-17,2017-01-08,Boston Bruins,1,Atlantic,Eastern,47,2,86,0.5465116279069767,44,3,44,3
2016-17,2017-01-11,Boston Bruins,2,Atlantic,Eastern,49,2,88,0.5568181818181818,46,3,46,3
2016-17,2017-01-13,Boston Bruins,0,Atlantic,Eastern,49,2,90,0.5444444444444444,48,1,48,1
2016-17,2017-01-14,Boston Bruins,2,Atlantic,Eastern,51,2,92,0.5543478260869565,48,3,48,3
2016-17,2017-01-16,Boston Bruins,0,Atlantic,Eastern,51,2,94,0.5425531914893617,48,3,49,2
2016-17,2017-01-19,Boston Bruins,1,Atlantic,Eastern,52,2,96,0.5416666666666666,50,2,50,2
2016-17,2017-01-21,Boston Bruins,0,Atlantic,Eastern,52,2,98,0.5306122448979592,52,0,50,2
2016-17,2017-01-22,Boston Bruins,0,Atlantic,Eastern,52,2,100,0.52,52,0,52,0
2016-17,2017-01-25,Boston Bruins,2,Atlantic,Eastern,54,2,102,0.5294117647058824,54,0,53,1
2016-17,2017-01-27,Boston Bruins,2,Atlantic,Eastern,56,2,104,0.5384615384615384,56,0,56,0
2016-17,2017-02-01,Boston Bruins,2,Atlantic,Eastern,58,2,106,0.5471698113207547,58,0,56,2
2016-17,2017-02-02,Boston Bruins,0,Atlantic,Eastern,58,2,108,0.5370370370370371,58,0,56,2
2016-17,2017-02-05,Boston Bruins,0,Atlantic,Eastern,58,2,110,0.5272727272727272,58,0,58,0
2016-17,2017-02-10,Boston Bruins,2,Atlantic,Eastern,60,2,112,0.5357142857142857,61,-1,60,0
2016-17,2017-02-11,Boston Bruins,2,Atlantic,Eastern,62,2,114,0.543859649122807,62,0,61,1
2016-17,2017-02-13,Boston Bruins,2,Atlantic,Eastern,64,2,116,0.5517241379310345,64,0,61,3
2016-17,2017-02-20,Boston Bruins,2,Atlantic,Eastern,66,2,118,0.559322033898305,66,0,65,1
2016-17,2017-02-23,Boston Bruins,0,Atlantic,Eastern,66,2,120,0.55,67,-1,66,0
2016-17,2017-02-24,Boston Bruins,2,Atlantic,Eastern,68,2,122,0.5573770491803278,68,0,68,0
2016-17,2017-02-26,Boston Bruins,2,Atlantic,Eastern,70,2,124,0.5645161290322581,70,0,69,1
2016-17,2017-03-01,Boston Bruins,2,Atlantic,Eastern,72,2,126,0.5714285714285714,72,0,69,3
2016-17,2017-03-03,Boston Bruins,0,Atlantic,Eastern,72,2,128,0.5625,72,0,70,2
2016-17,2017-03-05,Boston Bruins,2,Atlantic,Eastern,74,2,130,0.5692307692307692,74,0,71,3
2016-17,2017-03-07,Boston Bruins,0,Atlantic,Eastern,74,2,132,0.5606060606060606,74,0,71,3
2016-17,2017-03-09,Boston Bruins,2,Atlantic,Eastern,76,2,134,0.5671641791044776,76,0,73,3
2016-17,2017-03-11,Boston Bruins,2,Atlantic,Eastern,78,2,136,0.5735294117647058,78,0,75,3
2016-17,2017-03-14,Boston Bruins,2,Atlantic,Eastern,80,2,138,0.5797101449275363,80,0,77,3
2016-17,2017-03-16,Boston Bruins,2,Atlantic,Eastern,82,2,140,0.5857142857142857,82,0,78,4
2016-17,2017-03-17,Boston Bruins,0,Atlantic,Eastern,82,2,142,0.5774647887323944,82,0,78,4
2016-17,2017-03-20,Boston Bruins,0,Atlantic,Eastern,82,2,144,0.5694444444444444,82,0,81,1
2016-17,2017-03-21,Boston Bruins,0,Atlantic,Eastern,82,2,146,0.5616438356164384,82,0,81,1
2016-17,2017-03-23,Boston Bruins,0,Atlantic,Eastern,82,2,148,0.5540540540540541,85,-3,82,0
2016-17,2017-03-25,Boston Bruins,2,Atlantic,Eastern,84,2,150,0.56,85,-1,84,0
2016-17,2017-03-28,Boston Bruins,2,Atlantic,Eastern,86,2,152,0.5657894736842105,87,-1,86,0
2016-17,2017-03-30,Boston Bruins,2,Atlantic,Eastern,88,2,154,0.5714285714285714,88,0,87,1
2016-17,2017-04-01,Boston Bruins,2,Atlantic,Eastern,90,2,156,0.5769230769230769,91,-1,90,0
2016-17,2017-04-02,Boston Bruins,2,Atlantic,Eastern,92,2,158,0.5822784810126582,91,1,91,1
2016-17,2017-04-04,Boston Bruins,2,Atlantic,Eastern,94,2,160,0.5875,94,0,93,1
2016-17,2017-04-06,Boston Bruins,1,Atlantic,Eastern,95,2,162,0.5864197530864198,95,0,93,2
2016-17,2017-04-08,Boston Bruins,0,Atlantic,Eastern,95,2,164,0.5792682926829268,95,0,95,0
2016-17,2016-10-13,Buffalo Sabres,0,Atlantic,Eastern,0,2,2,0.0,2,-2,1,-1
2016-17,2016-10-16,Buffalo Sabres,2,Atlantic,Eastern,2,2,4,0.5,4,-2,3,-1
2016-17,2016-10-19,Buffalo Sabres,1,Atlantic,Eastern,3,2,6,0.5,5,-2,4,-1
2016-17,2016-10-21,Buffalo Sabres,0,Atlantic,Eastern,3,2,8,0.375,6,-3,5,-2
2016-17,2016-10-25,Buffalo Sabres,1,Atlantic,Eastern,4,2,10,0.4,10,-6,7,-3
2016-17,2016-10-27,Buffalo Sabres,0,Atlantic,Eastern,4,2,12,0.3333333333333333,10,-6,7,-3
2016-17,2016-10-29,Buffalo Sabres,2,Atlantic,Eastern,6,2,14,0.42857142857142855,10,-4,8,-2
2016-17,2016-10-30,Buffalo Sabres,2,Atlantic,Eastern,8,2,16,0.5,10,-2,9,-1
2016-17,2016-11-02,Buffalo Sabres,2,Atlantic,Eastern,10,2,18,0.5555555555555556,12,-2,10,0
2016-17,2016-11-03,Buffalo Sabres,0,Atlantic,Eastern,10,2,20,0.5,13,-3,13,-3
2016-17,2016-11-05,Buffalo Sabres,2,Atlantic,Eastern,12,2,22,0.5454545454545454,14,-2,13,-1
2016-17,2016-11-08,Buffalo Sabres,0,Atlantic,Eastern,12,2,24,0.5,14,-2,13,-1
2016-17,2016-11-10,Buffalo Sabres,1,Atlantic,Eastern,13,2,26,0.5,15,-2,15,-2
2016-17,2016-11-12,Buffalo Sabres,1,Atlantic,Eastern,14,2,28,0.5,17,-3,17,-3
2016-17,2016-11-13,Buffalo Sabres,0,Atlantic,Eastern,14,2,30,0.4666666666666667,18,-4,17,-3
2016-17,2016-11-16,Buffalo Sabres,0,Atlantic,Eastern,14,2,32,0.4375,21,-7,20,-6
2016-17,2016-11-18,Buffalo Sabres,0,Atlantic,Eastern,14,2,34,0.4117647058823529,21,-7,20,-6
2016-17,2016-11-20,Buffalo Sabres,2,Atlantic,Eastern,16,2,36,0.4444444444444444,22,-6,21,-5
2016-17,2016-11-22,Buffalo Sabres,2,Atlantic,Eastern,18,2,38,0.47368421052631576,22,-4,21,-3
2016-17,2016-11-24,Buffalo Sabres,1,Atlantic,Eastern,19,2,40,0.475,23,-4,23,-4
2016-17,2016-11-25,Buffalo Sabres,0,Atlantic,Eastern,19,2,42,0.4523809523809524,25,-6,23,-4
2016-17,2016-11-30,Buffalo Sabres,2,Atlantic,Eastern,21,2,44,0.4772727272727273,27,-6,25,-4
2016-17,2016-12-02,Buffalo Sabres,2,Atlantic,Eastern,23,2,46,0.5,27,-4,27,-4
2016-17,2016-12-03,Buffalo Sabres,0,Atlantic,Eastern,23,2,48,0.4791666666666667,29,-6,28,-5
2016-17,2016-12-06,Buffalo Sabres,1,Atlantic,Eastern,24,2,50,0.48,31,-7,31,-7
2016-17,2016-12-07,Buffalo Sabres,2,Atlantic,Eastern,26,2,52,0.5,31,-5,31,-5
2016-17,2016-12-10,Buffalo Sabres,0,Atlantic,Eastern,26,2,54,0.48148148148148145,32,-6,32,-6
2016-17,2016-12-14,Buffalo Sabres,2,Atlantic,Eastern,28,2,56,0.5,34,-6,34,-6
2016-17,2016-12-17,Buffalo Sabres,2,Atlantic,Eastern,30,2,58,0.5172413793103449,35,-5,35,-5
2016-17,2016-12-18,Buffalo Sabres,1,Atlantic,Eastern,31,2,60,0.5166666666666667,37,-6,37,-6
2016-17,2016-12-21,Buffalo Sabres,1,Atlantic,Eastern,32,2,62,0.5161290322580645,37,-5,37,-5
2016-17,2016-12-23,Buffalo Sabres,0,Atlantic,Eastern,32,2,64,0.5,39,-7,39,-7
2016-17,2016-12-24,Buffalo Sabres,0,Atlantic,Eastern,32,2,66,0.48484848484848486,40,-8,40,-8
2016-17,2016-12-28,Buffalo Sabres,2,Atlantic,Eastern,34,2,68,0.5,40,-6,40,-6
2016-17,2016-12-30,Buffalo Sabres,0,Atlantic,Eastern,34,2,70,0.4857142857142857,42,-8,42,-8
2016-17,2016-12-31,Buffalo Sabres,0,Atlantic,Eastern,34,2,72,0.4722222222222222,44,-10,44,-10
2016-17,2017-01-04,Buffalo Sabres,2,Atlantic,Eastern,36,2,74,0.4864864864864865,44,-8,44,-8
2016-17,2017-01-06,Buffalo Sabres,1,Atlantic,Eastern,37,2,76,0.4868421052631579,44,-7,44,-7
2016-17,2017-01-07,Buffalo Sabres,2,Atlantic,Eastern,39,2,78,0.5,44,-5,44,-5
2016-17,2017-01-11,Buffalo Sabres,2,Atlantic,Eastern,41,2,80,0.5125,46,-5,46,-5
2016-17,2017-01-13,Buffalo Sabres,0,Atlantic,Eastern,41,2,82,0.5,48,-7,48,-7
2016-17,2017-01-14,Buffalo Sabres,0,Atlantic,Eastern,41,2,84,0.4880952380952381,48,-7,48,-7
2016-17,2017-01-16,Buffalo Sabres,2,Atlantic,Eastern,43,2,86,0.5,48,-5,49,-6
2016-17,2017-01-18,Buffalo Sabres,0,Atlantic,Eastern,43,2,88,0.48863636363636365,50,-7,50,-7
2016-17,2017-01-21,Buffalo Sabres,2,Atlantic,Eastern,45,2,90,0.5,52,-7,50,-5
2016-17,2017-01-22,Buffalo Sabres,2,Atlantic,Eastern,47,2,92,0.5108695652173914,52,-5,52,-5
2016-17,2017-01-25,Buffalo Sabres,2,Atlantic,Eastern,49,2,94,0.5212765957446809,54,-5,53,-4
2016-17,2017-01-27,Buffalo Sabres,0,Atlantic,Eastern,49,2,96,0.5104166666666666,56,-7,56,-7
2016-17,2017-02-01,Buffalo Sabres,0,Atlantic,Eastern,49,2,98,0.5,58,-9,56,-7
2016-17,2017-02-03,Buffalo Sabres,1,Atlantic,Eastern,50,2,100,0.5,58,-8,58,-8
2016-17,2017-02-05,Buffalo Sabres,2,Atlantic,Eastern,52,2,102,0.5098039215686274,58,-6,58,-6
2016-17,2017-02-07,Buffalo Sabres,0,Atlantic,Eastern,52,2,104,0.5,58,-6,58,-6
2016-17,2017-02-08,Buffalo Sabres,2,Atlantic,Eastern,54,2,106,0.5094339622641509,60,-6,59,-5
2016-17,2017-02-10,Buffalo Sabres,0,Atlantic,Eastern,54,2,108,0.5,61,-7,60,-6
2016-17,2017-02-12,Buffalo Sabres,2,Atlantic,Eastern,56,2,110,0.509090909090909,62,-6,61,-5
2016-17,2017-02-13,Buffalo Sabres,0,Atlantic,Eastern,56,2,112,0.5,64,-8,61,-5
2016-17,2017-02-15,Buffalo Sabres,2,Atlantic,Eastern,58,2,114,0.5087719298245614,64,-6,63,-5
2016-17,2017-02-17,Buffalo Sabres,2,Atlantic,Eastern,60,2,116,0.5172413793103449,64,-4,63,-3
2016-17,2017-02-18,Buffalo Sabres,2,Atlantic,Eastern,62,2,118,0.5254237288135594,64,-2,63,-1
2016-17,2017-02-19,Buffalo Sabres,0,Atlantic,Eastern,62,2,120,0.5166666666666667,64,-2,64,-2
2016-17,2017-02-26,Buffalo Sabres,0,Atlantic,Eastern,62,2,122,0.5081967213114754,70,-8,69,-7
2016-17,2017-02-27,Buffalo Sabres,0,Atlantic,Eastern,62,2,124,0.5,70,-8,69,-7
2016-17,2017-03-01,Buffalo Sabres,1,Atlantic,Eastern,63,2,126,0.5,72,-9,69,-6
2016-17,2017-03-03,Buffalo Sabres,2,Atlantic,Eastern,65,2,128,0.5078125,72,-7,70,-5
2016-17,2017-03-05,Buffalo Sabres,1,Atlantic,Eastern,66,2,130,0.5076923076923077,74,-8,71,-5
2016-17,2017-03-05,Buffalo Sabres,0,Atlantic,Eastern,66,2,132,0.5,74,-8,71,-5
2016-17,2017-03-08,Buffalo Sabres,0,Atlantic,Eastern,66,2,134,0.4925373134328358,74,-8,73,-7
2016-17,2017-03-11,Buffalo Sabres,0,Atlantic,Eastern,66,2,136,0.4852941176470588,78,-12,75,-9
2016-17,2017-03-12,Buffalo Sabres,2,Atlantic,Eastern,68,2,138,0.4927536231884058,78,-10,76,-8
2016-17,2017-03-15,Buffalo Sabres,0,Atlantic,Eastern,68,2,140,0.4857142857142857,80,-12,77,-9
2016-17,2017-03-17,Buffalo Sabres,0,Atlantic,Eastern,68,2,142,0.4788732394366197,82,-14,78,-10
2016-17,2017-03-18,Buffalo Sabres,2,Atlantic,Eastern,70,2,144,0.4861111111111111,82,-12,79,-9
2016-17,2017-03-20,Buffalo Sabres,2,Atlantic,Eastern,72,2,146,0.4931506849315068,82,-10,81,-9
2016-17,2017-03-21,Buffalo Sabres,0,Atlantic,Eastern,72,2,148,0.4864864864864865,82,-10,81,-9
2016-17,2017-03-25,Buffalo Sabres,2,Atlantic,Eastern,74,2,150,0.49333333333333335,85,-11,84,-10
2016-17,2017-03-27,Buffalo Sabres,2,Atlantic,Eastern,76,2,152,0.5,85,-9,84,-8
2016-17,2017-03-28,Buffalo Sabres,0,Atlantic,Eastern,76,2,154,0.4935064935064935,87,-11,86,-10
2016-17,2017-04-02,Buffalo Sabres,0,Atlantic,Eastern,76,2,156,0.48717948717948717,91,-15,91,-15
2016-17,2017-04-03,Buffalo Sabres,0,Atlantic,Eastern,76,2,158,0.4810126582278481,92,-16,92,-16
2016-17,2017-04-05,Buffalo Sabres,2,Atlantic,Eastern,78,2,160,0.4875,94,-16,93,-15
2016-17,2017-04-08,Buffalo Sabres,0,Atlantic,Eastern,78,2,162,0.48148148148148145,95,-17,95,-17
2016-17,2017-04-09,Buffalo Sabres,0,Atlantic,Eastern,78,2,164,0.47560975609756095,95,-17,95,-17
2016-17,2016-10-13,Calgary Flames,0,Pacific,Western,0,2,2,0.0,0,0,0,0
2016-17,2016-10-15,Calgary Flames,0,Pacific,Western,0,2,4,0.0,0,0,0,0
2016-17,2016-10-16,Calgary Flames,1,Pacific,Western,1,2,6,0.16666666666666666,2,-1,2,-1
2016-17,2016-10-19,Calgary Flames,2,Pacific,Western,3,2,8,0.375,6,-3,4,-1
2016-17,2016-10-21,Calgary Flames,0,Pacific,Western,3,2,10,0.3,6,-3,4,-1
2016-17,2016-10-23,Calgary Flames,0,Pacific,Western,3,2,12,0.25,6,-3,5,-2
2016-17,2016-10-25,Calgary Flames,2,Pacific,Western,5,2,14,0.35714285714285715,6,-1,5,0
2016-17,2016-10-26,Calgary Flames,2,Pacific,Western,7,2,16,0.4375,8,-1,7,0
2016-17,2016-10-29,Calgary Flames,2,Pacific,Western,9,2,18,0.5,9,0,8,1
2016-17,2016-10-31,Calgary Flames,0,Pacific,Western,9,2,20,0.45,9,0,8,1
2016-17,2016-11-02,Calgary Flames,0,Pacific,Western,9,2,22,0.4090909090909091,10,-1,9,0
2016-17,2016-11-04,Calgary Flames,2,Pacific,Western,11,2,24,0.4583333333333333,11,0,10,1
2016-17,2016-11-06,Calgary Flames,0,Pacific,Western,11,2,26,0.4230769230769231,12,-1,11,0
2016-17,2016-11-07,Calgary Flames,0,Pacific,Western,11,2,28,0.39285714285714285,12,-1,11,0
2016-17,2016-11-11,Calgary Flames,0,Pacific,Western,11,2,30,0.36666666666666664,16,-5,14,-3
2016-17,2016-11-13,Calgary Flames,0,Pacific,Western,11,2,32,0.34375,17,-6,16,-5
2016-17,2016-11-16,Calgary Flames,2,Pacific,Western,13,2,34,0.38235294117647056,18,-5,17,-4
2016-17,2016-11-17,Calgary Flames,2,Pacific,Western,15,2,36,0.4166666666666667,18,-3,17,-2
2016-17,2016-11-19,Calgary Flames,0,Pacific,Western,15,2,38,0.39473684210526316,19,-4,19,-4
2016-17,2016-11-21,Calgary Flames,2,Pacific,Western,17,2,40,0.425,21,-4,19,-2
2016-17,2016-11-22,Calgary Flames,0,Pacific,Western,17,2,42,0.40476190476190477,21,-4,20,-3
2016-17,2016-11-24,Calgary Flames,2,Pacific,Western,19,2,44,0.4318181818181818,23,-4,21,-2
2016-17,2016-11-26,Calgary Flames,2,Pacific,Western,21,2,46,0.45652173913043476,23,-2,23,-2
2016-17,2016-11-28,Calgary Flames,0,Pacific,Western,21,2,48,0.4375,25,-4,23,-2
2016-17,2016-11-29,Calgary Flames,1,Pacific,Western,22,2,50,0.44,25,-3,24,-2
2016-17,2016-12-01,Calgary Flames,2,Pacific,Western,24,2,52,0.46153846153846156,26,-2,25,-1
2016-17,2016-12-03,Calgary Flames,2,Pacific,Western,26,2,54,0.48148148148148145,28,-2,26,0
2016-17,2016-12-05,Calgary Flames,2,Pacific,Western,28,2,56,0.5,29,-1,28,0
2016-17,2016-12-07,Calgary Flames,2,Pacific,Western,30,2,58,0.5172413793103449,30,0,28,2
2016-17,2016-12-09,Calgary Flames,2,Pacific,Western,32,2,60,0.5333333333333333,31,1,29,3
2016-17,2016-12-11,Calgary Flames,2,Pacific,Western,34,2,62,0.5483870967741935,33,1,30,4
2016-17,2016-12-15,Calgary Flames,0,Pacific,Western,34,2,64,0.53125,35,-1,30,4
2016-17,2016-12-17,Calgary Flames,0,Pacific,Western,34,2,66,0.5151515151515151,35,-1,34,0
2016-17,2016-12-20,Calgary Flames,2,Pacific,Western,36,2,68,0.5294117647058824,39,-3,34,2
2016-17,2016-12-21,Calgary Flames,0,Pacific,Western,36,2,70,0.5142857142857142,39,-3,35,1
2016-17,2016-12-24,Calgary Flames,2,Pacific,Western,38,2,72,0.5277777777777778,40,-2,38,0
2016-17,2016-12-28,Calgary Flames,2,Pacific,Western,40,2,74,0.5405405405405406,41,-1,38,2
2016-17,2016-12-30,Calgary Flames,0,Pacific,Western,40,2,76,0.5263157894736842,43,-3,39,1
2016-17,2017-01-01,Calgary Flames,2,Pacific,Western,42,2,78,0.5384615384615384,44,-2,40,2
2016-17,2017-01-05,Calgary Flames,2,Pacific,Western,44,2,80,0.55,45,-1,42,2
2016-17,2017-01-07,Calgary Flames,0,Pacific,Western,44,2,82,0.5365853658536586,47,-3,44,0
2016-17,2017-01-08,Calgary Flames,2,Pacific,Western,46,2,84,0.5476190476190477,49,-3,44,2
2016-17,2017-01-10,Calgary Flames,0,Pacific,Western,46,2,86,0.5348837209302325,49,-3,44,2
2016-17,2017-01-12,Calgary Flames,2,Pacific,Western,48,2,88,0.5454545454545454,49,-1,44,4
2016-17,2017-01-14,Calgary Flames,0,Pacific,Western,48,2,90,0.5333333333333333,51,-3,47,1
2016-17,2017-01-15,Calgary Flames,1,Pacific,Western,49,2,92,0.532608695652174,52,-3,48,1
2016-17,2017-01-18,Calgary Flames,2,Pacific,Western,51,2,94,0.5425531914893617,54,-3,48,3
2016-17,2017-01-20,Calgary Flames,0,Pacific,Western,51,2,96,0.53125,57,-6,49,2
2016-17,2017-01-22,Calgary Flames,0,Pacific,Western,51,2,98,0.5204081632653061,60,-9,51,0
2016-17,2017-01-24,Calgary Flames,0,Pacific,Western,51,2,100,0.51,60,-9,51,0
2016-17,2017-01-25,Calgary Flames,0,Pacific,Western,51,2,102,0.5,60,-9,51,0
2016-17,2017-01-27,Calgary Flames,2,Pacific,Western,53,2,104,0.5096153846153846,63,-10,53,0
2016-17,2017-02-02,Calgary Flames,2,Pacific,Western,55,2,106,0.5188679245283019,64,-9,55,0
2016-17,2017-02-04,Calgary Flames,2,Pacific,Western,57,2,108,0.5277777777777778,64,-7,57,0
2016-17,2017-02-05,Calgary Flames,0,Pacific,Western,57,2,110,0.5181818181818182,66,-9,57,0
2016-17,2017-02-08,Calgary Flames,2,Pacific,Western,59,2,112,0.5267857142857143,66,-7,59,0
2016-17,2017-02-14,Calgary Flames,0,Pacific,Western,59,2,114,0.5175438596491229,66,-7,60,-1
2016-17,2017-02-16,Calgary Flames,2,Pacific,Western,61,2,116,0.5258620689655172,68,-7,61,0
2016-17,2017-02-19,Calgary Flames,1,Pacific,Western,62,2,118,0.5254237288135594,70,-8,62,0
2016-17,2017-02-22,Calgary Flames,2,Pacific,Western,64,2,120,0.5333333333333333,72,-8,64,0
2016-17,2017-02-24,Calgary Flames,2,Pacific,Western,66,2,122,0.5409836065573771,74,-8,66,0
2016-17,2017-02-25,Calgary Flames,2,Pacific,Western,68,2,124,0.5483870967741935,74,-6,67,1
2016-17,2017-02-26,Calgary Flames,2,Pacific,Western,70,2,126,0.5555555555555556,74,-4,67,3
2016-17,2017-03-01,Calgary Flames,2,Pacific,Western,72,2,128,0.5625,74,-2,67,5
2016-17,2017-03-04,Calgary Flames,2,Pacific,Western,74,2,130,0.5692307692307692,76,-2,68,6
2016-17,2017-03-05,Calgary Flames,2,Pacific,Western,76,2,132,0.5757575757575758,76,0,68,8
2016-17,2017-03-10,Calgary Flames,2,Pacific,Western,78,2,134,0.582089552238806,78,0,71,7
2016-17,2017-03-12,Calgary Flames,2,Pacific,Western,80,2,136,0.5882352941176471,80,0,75,5
2016-17,2017-03-14,Calgary Flames,2,Pacific,Western,82,2,138,0.5942028985507246,82,0,77,5
2016-17,2017-03-16,Calgary Flames,0,Pacific,Western,82,2,140,0.5857142857142857,82,0,77,5
2016-17,2017-03-18,Calgary Flames,2,Pacific,Western,84,2,142,0.5915492957746479,84,0,79,5
2016-17,2017-03-20,Calgary Flames,2,Pacific,Western,86,2,144,0.5972222222222222,86,0,81,5
2016-17,2017-03-21,Calgary Flames,0,Pacific,Western,86,2,146,0.589041095890411,87,-1,81,5
2016-17,2017-03-24,Calgary Flames,0,Pacific,Western,86,2,148,0.581081081081081,89,-3,85,1
2016-17,2017-03-25,Calgary Flames,2,Pacific,Western,88,2,150,0.5866666666666667,89,-1,85,3
2016-17,2017-03-28,Calgary Flames,2,Pacific,Western,90,2,152,0.5921052631578947,91,-1,88,2
2016-17,2017-03-30,Calgary Flames,0,Pacific,Western,90,2,154,0.5844155844155844,93,-3,89,1
2016-17,2017-04-01,Calgary Flames,2,Pacific,Western,92,2,156,0.5897435897435898,93,-1,91,1
2016-17,2017-04-03,Calgary Flames,0,Pacific,Western,92,2,158,0.5822784810126582,95,-3,91,1
2016-17,2017-04-05,Calgary Flames,0,Pacific,Western,92,2,160,0.575,97,-5,92,0
2016-17,2017-04-07,Calgary Flames,2,Pacific,Western,94,2,162,0.5802469135802469,97,-3,94,0
2016-17,2017-04-09,Calgary Flames,0,Pacific,Western,94,2,164,0.573170731707317,99,-5,94,0
2016-17,2016-10-14,Carolina Hurricanes,1,Metropolitan,Eastern,1,2,2,0.5,1,0,1,0
2016-17,2016-10-17,Carolina Hurricanes,1,Metropolitan,Eastern,2,2,4,0.5,3,-1,3,-1
2016-17,2016-10-19,Carolina Hurricanes,0,Metropolitan,Eastern,2,2,6,0.3333333333333333,4,-2,4,-2
2016-17,2016-10-21,Carolina Hurricanes,2,Metropolitan,Eastern,4,2,8,0.5,4,0,5,-1
2016-17,2016-10-22,Carolina Hurricanes,0,Metropolitan,Eastern,4,2,10,0.4,6,-2,6,-2
2016-17,2016-10-25,Carolina Hurricanes,0,Metropolitan,Eastern,4,2,12,0.3333333333333333,7,-3,7,-3
2016-17,2016-10-28,Carolina Hurricanes,2,Metropolitan,Eastern,6,2,14,0.42857142857142855,8,-2,7,-1
2016-17,2016-10-30,Carolina Hurricanes,0,Metropolitan,Eastern,6,2,16,0.375,10,-4,9,-3
2016-17,2016-11-01,Carolina Hurricanes,1,Metropolitan,Eastern,7,2,18,0.3888888888888889,11,-4,10,-3
2016-17,2016-11-06,Carolina Hurricanes,0,Metropolitan,Eastern,7,2,20,0.35,17,-10,13,-6
2016-17,2016-11-06,Carolina Hurricanes,2,Metropolitan,Eastern,9,2,22,0.4090909090909091,17,-8,13,-4
2016-17,2016-11-09,Carolina Hurricanes,1,Metropolitan,Eastern,10,2,24,0.4166666666666667,17,-7,14,-4
2016-17,2016-11-11,Carolina Hurricanes,0,Metropolitan,Eastern,10,2,26,0.38461538461538464,17,-7,16,-6
2016-17,2016-11-13,Carolina Hurricanes,2,Metropolitan,Eastern,12,2,28,0.42857142857142855,19,-7,17,-5
2016-17,2016-11-16,Carolina Hurricanes,2,Metropolitan,Eastern,14,2,30,0.4666666666666667,21,-7,20,-6
2016-17,2016-11-19,Carolina Hurricanes,2,Metropolitan,Eastern,16,2,32,0.5,24,-8,20,-4
2016-17,2016-11-20,Carolina Hurricanes,2,Metropolitan,Eastern,18,2,34,0.5294117647058824,24,-6,21,-3
2016-17,2016-11-23,Carolina Hurricanes,2,Metropolitan,Eastern,20,2,36,0.5555555555555556,24,-4,22,-2
2016-17,2016-11-25,Carolina Hurricanes,0,Metropolitan,Eastern,20,2,38,0.5263157894736842,27,-7,23,-3
2016-17,2016-11-27,Carolina Hurricanes,0,Metropolitan,Eastern,20,2,40,0.5,28,-8,25,-5
2016-17,2016-11-27,Carolina Hurricanes,2,Metropolitan,Eastern,22,2,42,0.5238095238095238,28,-6,25,-3
2016-17,2016-11-30,Carolina Hurricanes,0,Metropolitan,Eastern,22,2,44,0.5,28,-6,25,-3
2016-17,2016-12-02,Carolina Hurricanes,1,Metropolitan,Eastern,23,2,46,0.5,30,-7,27,-4
2016-17,2016-12-03,Carolina Hurricanes,0,Metropolitan,Eastern,23,2,48,0.4791666666666667,30,-7,28,-5
2016-17,2016-12-04,Carolina Hurricanes,2,Metropolitan,Eastern,25,2,50,0.5,32,-7,29,-4
2016-17,2016-12-08,Carolina Hurricanes,1,Metropolitan,Eastern,26,2,52,0.5,34,-8,32,-6
2016-17,2016-12-09,Carolina Hurricanes,2,Metropolitan,Eastern,28,2,54,0.5185185185185185,35,-7,32,-4
2016-17,2016-12-11,Carolina Hurricanes,0,Metropolitan,Eastern,28,2,56,0.5,39,-11,32,-4
2016-17,2016-12-14,Carolina Hurricanes,2,Metropolitan,Eastern,30,2,58,0.5172413793103449,40,-10,34,-4
2016-17,2016-12-17,Carolina Hurricanes,1,Metropolitan,Eastern,31,2,60,0.5166666666666667,42,-11,35,-4
2016-17,2016-12-18,Carolina Hurricanes,2,Metropolitan,Eastern,33,2,62,0.532258064516129,44,-11,37,-4
2016-17,2016-12-23,Carolina Hurricanes,2,Metropolitan,Eastern,35,2,64,0.546875,47,-12,39,-4
2016-17,2016-12-24,Carolina Hurricanes,2,Metropolitan,Eastern,37,2,66,0.5606060606060606,47,-10,40,-3
2016-17,2016-12-29,Carolina Hurricanes,0,Metropolitan,Eastern,37,2,68,0.5441176470588235,49,-12,40,-3
2016-17,2016-12-31,Carolina Hurricanes,2,Metropolitan,Eastern,39,2,70,0.5571428571428572,51,-12,44,-5
2016-17,2017-01-01,Carolina Hurricanes,0,Metropolitan,Eastern,39,2,72,0.5416666666666666,53,-14,44,-5
2016-17,2017-01-04,Carolina Hurricanes,0,Metropolitan,Eastern,39,2,74,0.527027027027027,53,-14,44,-5
2016-17,2017-01-06,Carolina Hurricanes,2,Metropolitan,Eastern,41,2,76,0.5394736842105263,55,-14,44,-3
2016-17,2017-01-07,Carolina Hurricanes,0,Metropolitan,Eastern,41,2,78,0.5256410256410257,55,-14,44,-3
2016-17,2017-01-08,Carolina Hurricanes,2,Metropolitan,Eastern,43,2,80,0.5375,57,-14,44,-1
2016-17,2017-01-11,Carolina Hurricanes,2,Metropolitan,Eastern,45,2,82,0.5487804878048781,57,-12,46,-1
2016-17,2017-01-14,Carolina Hurricanes,2,Metropolitan,Eastern,47,2,84,0.5595238095238095,57,-10,48,-1
2016-17,2017-01-15,Carolina Hurricanes,2,Metropolitan,Eastern,49,2,86,0.5697674418604651,57,-8,49,0
2016-17,2017-01-18,Carolina Hurricanes,0,Metropolitan,Eastern,49,2,88,0.5568181818181818,59,-10,50,-1
2016-17,2017-01-21,Carolina Hurricanes,0,Metropolitan,Eastern,49,2,90,0.5444444444444444,63,-14,50,-1
2016-17,2017-01-21,Carolina Hurricanes,0,Metropolitan,Eastern,49,2,92,0.532608695652174,63,-14,50,-1
2016-17,2017-01-24,Carolina Hurricanes,0,Metropolitan,Eastern,49,2,94,0.5212765957446809,65,-16,52,-3
2016-17,2017-01-27,Carolina Hurricanes,0,Metropolitan,Eastern,49,2,96,0.5104166666666666,65,-16,56,-7
2016-17,2017-02-01,Carolina Hurricanes,2,Metropolitan,Eastern,51,2,98,0.5204081632653061,67,-16,56,-5
2016-17,2017-02-04,Carolina Hurricanes,2,Metropolitan,Eastern,53,2,100,0.53,69,-16,58,-5
2016-17,2017-02-05,Carolina Hurricanes,2,Metropolitan,Eastern,55,2,102,0.5392156862745098,71,-16,58,-3
2016-17,2017-02-08,Carolina Hurricanes,0,Metropolitan,Eastern,55,2,104,0.5288461538461539,72,-17,59,-4
2016-17,2017-02-11,Carolina Hurricanes,0,Metropolitan,Eastern,55,2,106,0.5188679245283019,74,-19,61,-6
2016-17,2017-02-18,Carolina Hurricanes,1,Metropolitan,Eastern,56,2,108,0.5185185185185185,79,-23,63,-7
2016-17,2017-02-20,Carolina Hurricanes,0,Metropolitan,Eastern,56,2,110,0.509090909090909,79,-23,65,-9
2016-17,2017-02-22,Carolina Hurricanes,0,Metropolitan,Eastern,56,2,112,0.5,79,-23,66,-10
2016-17,2017-02-25,Carolina Hurricanes,2,Metropolitan,Eastern,58,2,114,0.5087719298245614,82,-24,68,-10
2016-17,2017-02-26,Carolina Hurricanes,0,Metropolitan,Eastern,58,2,116,0.5,83,-25,69,-11
2016-17,2017-03-01,Carolina Hurricanes,1,Metropolitan,Eastern,59,2,118,0.5,84,-25,69,-10
2016-17,2017-03-02,Carolina Hurricanes,1,Metropolitan,Eastern,60,2,120,0.5,84,-24,69,-9
2016-17,2017-03-04,Carolina Hurricanes,0,Metropolitan,Eastern,60,2,122,0.4918032786885246,86,-26,71,-11
2016-17,2017-03-06,Carolina Hurricanes,2,Metropolitan,Eastern,62,2,124,0.5,88,-26,71,-9
2016-17,2017-03-08,Carolina Hurricanes,0,Metropolitan,Eastern,62,2,126,0.49206349206349204,88,-26,73,-11
2016-17,2017-03-10,Carolina Hurricanes,2,Metropolitan,Eastern,64,2,128,0.5,90,-26,75,-11
2016-17,2017-03-12,Carolina Hurricanes,1,Metropolitan,Eastern,65,2,130,0.5,92,-27,76,-11
2016-17,2017-03-13,Carolina Hurricanes,2,Metropolitan,Eastern,67,2,132,0.5075757575757576,94,-27,76,-9
2016-17,2017-03-14,Carolina Hurricanes,1,Metropolitan,Eastern,68,2,134,0.5074626865671642,94,-26,77,-9
2016-17,2017-03-16,Carolina Hurricanes,2,Metropolitan,Eastern,70,2,136,0.5147058823529411,95,-25,78,-8
2016-17,2017-03-18,Carolina Hurricanes,2,Metropolitan,Eastern,72,2,138,0.5217391304347826,97,-25,79,-7
2016-17,2017-03-19,Carolina Hurricanes,1,Metropolitan,Eastern,73,2,140,0.5214285714285715,99,-26,79,-6
2016-17,2017-03-21,Carolina Hurricanes,2,Metropolitan,Eastern,75,2,142,0.528169014084507,100,-25,81,-6
2016-17,2017-03-23,Carolina Hurricanes,2,Metropolitan,Eastern,77,2,144,0.5347222222222222,101,-24,82,-5
2016-17,2017-03-25,Carolina Hurricanes,2,Metropolitan,Eastern,79,2,146,0.541095890410959,103,-24,84,-5
2016-17,2017-03-27,Carolina Hurricanes,1,Metropolitan,Eastern,80,2,148,0.5405405405405406,103,-23,84,-4
2016-17,2017-03-28,Carolina Hurricanes,2,Metropolitan,Eastern,82,2,150,0.5466666666666666,103,-21,86,-4
2016-17,2017-03-30,Carolina Hurricanes,2,Metropolitan,Eastern,84,2,152,0.5526315789473685,103,-19,87,-3
2016-17,2017-04-01,Carolina Hurricanes,0,Metropolitan,Eastern,84,2,154,0.5454545454545454,105,-21,90,-6
2016-17,2017-04-02,Carolina Hurricanes,0,Metropolitan,Eastern,84,2,156,0.5384615384615384,106,-22,91,-7
2016-17,2017-04-05,Carolina Hurricanes,0,Metropolitan,Eastern,84,2,158,0.5316455696202531,106,-22,93,-9
2016-17,2017-04-06,Carolina Hurricanes,0,Metropolitan,Eastern,84,2,160,0.525,106,-22,93,-9
2016-17,2017-04-08,Carolina Hurricanes,1,Metropolitan,Eastern,85,2,162,0.5246913580246914,106,-21,95,-10
2016-17,2017-04-09,Carolina Hurricanes,2,Metropolitan,Eastern,87,2,164,0.5304878048780488,108,-21,95,-8
2016-17,2016-10-13,Chicago Blackhawks,0,Central,Western,0,2,2,0.0,0,0,0,0
2016-17,2016-10-15,Chicago Blackhawks,0,Central,Western,0,2,4,0.0,2,-2,0,0
2016-17,2016-10-16,Chicago Blackhawks,2,Central,Western,2,2,6,0.3333333333333333,2,0,2,0
2016-17,2016-10-19,Chicago Blackhawks,2,Central,Western,4,2,8,0.5,4,0,4,0
2016-17,2016-10-21,Chicago Blackhawks,0,Central,Western,4,2,10,0.4,6,-2,4,0
2016-17,2016-10-22,Chicago Blackhawks,2,Central,Western,6,2,12,0.5,6,0,5,1
2016-17,2016-10-25,Chicago Blackhawks,1,Central,Western,7,2,14,0.5,7,0,5,2
2016-17,2016-10-28,Chicago Blackhawks,2,Central,Western,9,2,16,0.5625,9,0,8,1
2016-17,2016-10-30,Chicago Blackhawks,2,Central,Western,11,2,18,0.6111111111111112,11,0,8,3
2016-17,2016-11-02,Chicago Blackhawks,2,Central,Western,13,2,20,0.65,12,1,9,4
2016-17,2016-11-04,Chicago Blackhawks,2,Central,Western,15,2,22,0.6818181818181818,12,3,10,5
2016-17,2016-11-06,Chicago Blackhawks,2,Central,Western,17,2,24,0.7083333333333334,13,4,11,6
2016-17,2016-11-07,Chicago Blackhawks,2,Central,Western,19,2,26,0.7307692307692307,13,6,11,8
2016-17,2016-11-10,Chicago Blackhawks,2,Central,Western,21,2,28,0.75,13,8,13,8
2016-17,2016-11-12,Chicago Blackhawks,1,Central,Western,22,2,30,0.7333333333333333,16,6,15,7
2016-17,2016-11-14,Chicago Blackhawks,2,Central,Western,24,2,32,0.75,17,7,16,8
2016-17,2016-11-16,Chicago Blackhawks,0,Central,Western,24,2,34,0.7058823529411765,19,5,17,7
2016-17,2016-11-19,Chicago Blackhawks,2,Central,Western,26,2,36,0.7222222222222222,20,6,19,7
2016-17,2016-11-20,Chicago Blackhawks,2,Central,Western,28,2,38,0.7368421052631579,20,8,19,9
2016-17,2016-11-22,Chicago Blackhawks,0,Central,Western,28,2,40,0.7,21,7,20,8
2016-17,2016-11-24,Chicago Blackhawks,0,Central,Western,28,2,42,0.6666666666666666,22,6,21,7
2016-17,2016-11-25,Chicago Blackhawks,2,Central,Western,30,2,44,0.6818181818181818,24,6,22,8
2016-17,2016-11-27,Chicago Blackhawks,1,Central,Western,31,2,46,0.6739130434782609,25,6,23,8
2016-17,2016-11-30,Chicago Blackhawks,2,Central,Western,33,2,48,0.6875,25,8,25,8
2016-17,2016-12-02,Chicago Blackhawks,2,Central,Western,35,2,50,0.7,25,10,25,10
2016-17,2016-12-03,Chicago Blackhawks,0,Central,Western,35,2,52,0.6730769230769231,26,9,26,9
2016-17,2016-12-05,Chicago Blackhawks,0,Central,Western,35,2,54,0.6481481481481481,28,7,28,7
2016-17,2016-12-07,Chicago Blackhawks,2,Central,Western,37,2,56,0.6607142857142857,29,8,28,9
2016-17,2016-12-10,Chicago Blackhawks,1,Central,Western,38,2,58,0.6551724137931034,32,6,30,8
2016-17,2016-12-12,Chicago Blackhawks,2,Central,Western,40,2,60,0.6666666666666666,34,6,30,10
2016-17,2016-12-14,Chicago Blackhawks,2,Central,Western,42,2,62,0.6774193548387096,36,6,30,12
2016-17,2016-12-16,Chicago Blackhawks,2,Central,Western,44,2,64,0.6875,38,6,32,12
2016-17,2016-12-18,Chicago Blackhawks,2,Central,Western,46,2,66,0.696969696969697,38,8,34,12
2016-17,2016-12-19,Chicago Blackhawks,2,Central,Western,48,2,68,0.7058823529411765,38,10,34,14
2016-17,2016-12-21,Chicago Blackhawks,0,Central,Western,48,2,70,0.6857142857142857,41,7,35,13
2016-17,2016-12-24,Chicago Blackhawks,1,Central,Western,49,2,72,0.6805555555555556,41,8,38,11
2016-17,2016-12-28,Chicago Blackhawks,0,Central,Western,49,2,74,0.6621621621621622,41,8,38,11
2016-17,2016-12-30,Chicago Blackhawks,2,Central,Western,51,2,76,0.6710526315789473,43,8,39,12
2016-17,2016-12-31,Chicago Blackhawks,0,Central,Western,51,2,78,0.6538461538461539,43,8,39,12
2016-17,2017-01-02,Chicago Blackhawks,0,Central,Western,51,2,80,0.6375,45,6,40,11
2016-17,2017-01-06,Chicago Blackhawks,2,Central,Western,53,2,82,0.6463414634146342,45,8,42,11
2016-17,2017-01-07,Chicago Blackhawks,2,Central,Western,55,2,84,0.6547619047619048,45,10,44,11
2016-17,2017-01-09,Chicago Blackhawks,2,Central,Western,57,2,86,0.6627906976744186,47,10,44,13
2016-17,2017-01-11,Chicago Blackhawks,2,Central,Western,59,2,88,0.6704545454545454,47,12,44,15
2016-17,2017-01-14,Chicago Blackhawks,0,Central,Western,59,2,90,0.6555555555555556,47,12,47,12
2016-17,2017-01-16,Chicago Blackhawks,0,Central,Western,59,2,92,0.6413043478260869,51,8,48,11
2016-17,2017-01-18,Chicago Blackhawks,2,Central,Western,61,2,94,0.648936170212766,51,10,48,13
2016-17,2017-01-21,Chicago Blackhawks,2,Central,Western,63,2,96,0.65625,51,12,51,12
2016-17,2017-01-23,Chicago Blackhawks,2,Central,Western,65,2,98,0.6632653061224489,53,12,51,14
2016-17,2017-01-25,Chicago Blackhawks,0,Central,Western,65,2,100,0.65,54,11,51,14
2016-17,2017-01-27,Chicago Blackhawks,0,Central,Western,65,2,102,0.6372549019607843,56,9,53,12
2016-17,2017-02-01,Chicago Blackhawks,0,Central,Western,65,2,104,0.625,56,9,53,12
2016-17,2017-02-03,Chicago Blackhawks,2,Central,Western,67,2,106,0.6320754716981132,58,9,55,12
2016-17,2017-02-05,Chicago Blackhawks,2,Central,Western,69,2,108,0.6388888888888888,58,11,57,12
2016-17,2017-02-09,Chicago Blackhawks,2,Central,Western,71,2,110,0.6454545454545455,60,11,59,12
2016-17,2017-02-11,Chicago Blackhawks,2,Central,Western,73,2,112,0.6517857142857143,61,12,60,13
2016-17,2017-02-12,Chicago Blackhawks,2,Central,Western,75,2,114,0.6578947368421053,63,12,60,15
2016-17,2017-02-19,Chicago Blackhawks,2,Central,Western,77,2,116,0.6637931034482759,67,10,62,15
2016-17,2017-02-19,Chicago Blackhawks,0,Central,Western,77,2,118,0.652542372881356,67,10,62,15
2016-17,2017-02-22,Chicago Blackhawks,2,Central,Western,79,2,120,0.6583333333333333,67,12,64,15
2016-17,2017-02-24,Chicago Blackhawks,2,Central,Western,81,2,122,0.6639344262295082,67,14,66,15
2016-17,2017-02-27,Chicago Blackhawks,2,Central,Western,83,2,124,0.6693548387096774,71,12,67,16
2016-17,2017-03-02,Chicago Blackhawks,2,Central,Western,85,2,126,0.6746031746031746,73,12,67,18
2016-17,2017-03-04,Chicago Blackhawks,2,Central,Western,87,2,128,0.6796875,73,14,68,19
2016-17,2017-03-05,Chicago Blackhawks,2,Central,Western,89,2,130,0.6846153846153846,73,16,68,21
2016-17,2017-03-10,Chicago Blackhawks,0,Central,Western,89,2,132,0.6742424242424242,75,14,71,18
2016-17,2017-03-11,Chicago Blackhawks,0,Central,Western,89,2,134,0.664179104477612,77,12,73,16
2016-17,2017-03-12,Chicago Blackhawks,2,Central,Western,91,2,136,0.6691176470588235,77,14,75,16
2016-17,2017-03-14,Chicago Blackhawks,2,Central,Western,93,2,138,0.6739130434782609,79,14,77,16
2016-17,2017-03-16,Chicago Blackhawks,2,Central,Western,95,2,140,0.6785714285714286,81,14,77,18
2016-17,2017-03-18,Chicago Blackhawks,2,Central,Western,97,2,142,0.6830985915492958,81,16,79,18
2016-17,2017-03-19,Chicago Blackhawks,2,Central,Western,99,2,144,0.6875,81,18,81,18
2016-17,2017-03-22,Chicago Blackhawks,1,Central,Western,100,2,146,0.684931506849315,83,17,83,17
2016-17,2017-03-24,Chicago Blackhawks,2,Central,Western,102,2,148,0.6891891891891891,85,17,85,17
2016-17,2017-03-25,Chicago Blackhawks,0,Central,Western,102,2,150,0.68,86,16,85,17
2016-17,2017-03-27,Chicago Blackhawks,1,Central,Western,103,2,152,0.6776315789473685,89,14,86,17
2016-17,2017-03-30,Chicago Blackhawks,2,Central,Western,105,2,154,0.6818181818181818,90,15,89,16
2016-17,2017-04-01,Chicago Blackhawks,2,Central,Western,107,2,156,0.6858974358974359,91,16,91,16
2016-17,2017-04-02,Chicago Blackhawks,0,Central,Western,107,2,158,0.6772151898734177,93,14,91,16
2016-17,2017-04-05,Chicago Blackhawks,1,Central,Western,108,2,160,0.675,93,15,92,16
2016-17,2017-04-07,Chicago Blackhawks,0,Central,Western,108,2,162,0.6666666666666666,95,13,94,14
2016-17,2017-04-08,Chicago Blackhawks,1,Central,Western,109,2,164,0.6646341463414634,97,12,94,15
2016-17,2016-10-16,Colorado Avalanche,2,Central,Western,2,2,2,1.0,2,0,2,0
2016-17,2016-10-17,Colorado Avalanche,2,Central,Western,4,2,4,1.0,2,2,2,2
2016-17,2016-10-18,Colorado Avalanche,0,Central,Western,4,2,6,0.6666666666666666,2,2,2,2
2016-17,2016-10-20,Colorado Avalanche,2,Central,Western,6,2,8,0.75,4,2,4,2
2016-17,2016-10-22,Colorado Avalanche,0,Central,Western,6,2,10,0.6,6,0,5,1
2016-17,2016-10-29,Colorado Avalanche,0,Central,Western,6,2,12,0.5,9,-3,8,-2
2016-17,2016-10-30,Colorado Avalanche,2,Central,Western,8,2,14,0.5714285714285714,11,-3,8,0
2016-17,2016-11-02,Colorado Avalanche,0,Central,Western,8,2,16,0.5,12,-4,9,-1
2016-17,2016-11-04,Colorado Avalanche,0,Central,Western,8,2,18,0.4444444444444444,12,-4,10,-2
2016-17,2016-11-05,Colorado Avalanche,2,Central,Western,10,2,20,0.5,13,-3,11,-1
2016-17,2016-11-06,Colorado Avalanche,0,Central,Western,10,2,22,0.45454545454545453,13,-3,11,-1
2016-17,2016-11-09,Colorado Avalanche,0,Central,Western,10,2,24,0.4166666666666667,13,-3,13,-3
2016-17,2016-11-12,Colorado Avalanche,2,Central,Western,12,2,26,0.46153846153846156,16,-4,15,-3
2016-17,2016-11-14,Colorado Avalanche,0,Central,Western,12,2,28,0.42857142857142855,17,-5,16,-4
2016-17,2016-11-16,Colorado Avalanche,2,Central,Western,14,2,30,0.4666666666666667,19,-5,17,-3
2016-17,2016-11-18,Colorado Avalanche,0,Central,Western,14,2,32,0.4375,20,-6,18,-4
2016-17,2016-11-20,Colorado Avalanche,2,Central,Western,16,2,34,0.47058823529411764,20,-4,19,-3
2016-17,2016-11-22,Colorado Avalanche,2,Central,Western,18,2,36,0.5,21,-3,20,-2
2016-17,2016-11-24,Colorado Avalanche,0,Central,Western,18,2,38,0.47368421052631576,22,-4,21,-3
2016-17,2016-11-27,Colorado Avalanche,1,Central,Western,19,2,40,0.475,25,-6,23,-4
2016-17,2016-11-30,Colorado Avalanche,0,Central,Western,19,2,42,0.4523809523809524,25,-6,25,-6
2016-17,2016-12-02,Colorado Avalanche,0,Central,Western,19,2,44,0.4318181818181818,25,-6,25,-6
2016-17,2016-12-04,Colorado Avalanche,0,Central,Western,19,2,46,0.41304347826086957,26,-7,26,-7
2016-17,2016-12-07,Colorado Avalanche,0,Central,Western,19,2,48,0.3958333333333333,29,-10,28,-9
2016-17,2016-12-09,Colorado Avalanche,2,Central,Western,21,2,50,0.42,30,-9,29,-8
2016-17,2016-12-11,Colorado Avalanche,0,Central,Western,21,2,52,0.40384615384615385,34,-13,30,-9
2016-17,2016-12-12,Colorado Avalanche,2,Central,Western,23,2,54,0.42592592592592593,34,-11,30,-7
2016-17,2016-12-15,Colorado Avalanche,0,Central,Western,23,2,56,0.4107142857142857,36,-13,30,-7
2016-17,2016-12-17,Colorado Avalanche,0,Central,Western,23,2,58,0.39655172413793105,38,-15,34,-11
2016-17,2016-12-18,Colorado Avalanche,0,Central,Western,23,2,60,0.38333333333333336,38,-15,34,-11
2016-17,2016-12-21,Colorado Avalanche,0,Central,Western,23,2,62,0.3709677419354839,41,-18,35,-12
2016-17,2016-12-23,Colorado Avalanche,0,Central,Western,23,2,64,0.359375,41,-18,36,-13
2016-17,2016-12-24,Colorado Avalanche,2,Central,Western,25,2,66,0.3787878787878788,41,-16,38,-13
2016-17,2016-12-28,Colorado Avalanche,0,Central,Western,25,2,68,0.36764705882352944,41,-16,38,-13
2016-17,2016-12-30,Colorado Avalanche,0,Central,Western,25,2,70,0.35714285714285715,43,-18,39,-14
2016-17,2017-01-01,Colorado Avalanche,0,Central,Western,25,2,72,0.3472222222222222,43,-18,40,-15
2016-17,2017-01-03,Colorado Avalanche,0,Central,Western,25,2,74,0.33783783783783783,45,-20,40,-15
2016-17,2017-01-05,Colorado Avalanche,0,Central,Western,25,2,76,0.32894736842105265,45,-20,42,-17
2016-17,2017-01-07,Colorado Avalanche,2,Central,Western,27,2,78,0.34615384615384615,45,-18,44,-17
2016-17,2017-01-13,Colorado Avalanche,0,Central,Western,27,2,80,0.3375,47,-20,46,-19
2016-17,2017-01-14,Colorado Avalanche,0,Central,Western,27,2,82,0.32926829268292684,47,-20,47,-20
2016-17,2017-01-18,Colorado Avalanche,0,Central,Western,27,2,84,0.32142857142857145,51,-24,48,-21
2016-17,2017-01-20,Colorado Avalanche,0,Central,Western,27,2,86,0.313953488372093,51,-24,49,-22
2016-17,2017-01-22,Colorado Avalanche,1,Central,Western,28,2,88,0.3181818181818182,51,-23,51,-23
2016-17,2017-01-24,Colorado Avalanche,0,Central,Western,28,2,90,0.3111111111111111,53,-25,51,-23
2016-17,2017-01-26,Colorado Avalanche,0,Central,Western,28,2,92,0.30434782608695654,54,-26,52,-24
2016-17,2017-02-01,Colorado Avalanche,0,Central,Western,28,2,94,0.2978723404255319,56,-28,53,-25
2016-17,2017-02-02,Colorado Avalanche,0,Central,Western,28,2,96,0.2916666666666667,56,-28,55,-27
2016-17,2017-02-04,Colorado Avalanche,2,Central,Western,30,2,98,0.30612244897959184,58,-28,57,-27
2016-17,2017-02-08,Colorado Avalanche,2,Central,Western,32,2,100,0.32,60,-28,59,-27
2016-17,2017-02-10,Colorado Avalanche,0,Central,Western,32,2,102,0.3137254901960784,61,-29,60,-28
2016-17,2017-02-12,Colorado Avalanche,0,Central,Western,32,2,104,0.3076923076923077,63,-31,60,-28
2016-17,2017-02-12,Colorado Avalanche,0,Central,Western,32,2,106,0.3018867924528302,63,-31,60,-28
2016-17,2017-02-15,Colorado Avalanche,0,Central,Western,32,2,108,0.2962962962962963,63,-31,60,-28
2016-17,2017-02-17,Colorado Avalanche,0,Central,Western,32,2,110,0.2909090909090909,67,-35,61,-29
2016-17,2017-02-18,Colorado Avalanche,2,Central,Western,34,2,112,0.30357142857142855,67,-33,61,-27
2016-17,2017-02-20,Colorado Avalanche,1,Central,Western,35,2,114,0.30701754385964913,67,-32,62,-27
2016-17,2017-02-22,Colorado Avalanche,0,Central,Western,35,2,116,0.3017241379310345,67,-32,64,-29
2016-17,2017-02-24,Colorado Avalanche,0,Central,Western,35,2,118,0.2966101694915254,67,-32,66,-31
2016-17,2017-02-26,Colorado Avalanche,2,Central,Western,37,2,120,0.30833333333333335,71,-34,67,-30
2016-17,2017-03-01,Colorado Avalanche,0,Central,Western,37,2,122,0.30327868852459017,73,-36,67,-30
2016-17,2017-03-03,Colorado Avalanche,0,Central,Western,37,2,124,0.29838709677419356,73,-36,68,-31
2016-17,2017-03-05,Colorado Avalanche,0,Central,Western,37,2,126,0.29365079365079366,73,-36,68,-31
2016-17,2017-03-06,Colorado Avalanche,0,Central,Western,37,2,128,0.2890625,73,-36,69,-32
2016-17,2017-03-08,Colorado Avalanche,2,Central,Western,39,2,130,0.3,74,-35,71,-32
2016-17,2017-03-10,Colorado Avalanche,2,Central,Western,41,2,132,0.3106060606060606,75,-34,71,-30
2016-17,2017-03-12,Colorado Avalanche,0,Central,Western,41,2,134,0.30597014925373134,77,-36,75,-34
2016-17,2017-03-14,Colorado Avalanche,0,Central,Western,41,2,136,0.3014705882352941,79,-38,77,-36
2016-17,2017-03-16,Colorado Avalanche,2,Central,Western,43,2,138,0.3115942028985507,81,-38,77,-34
2016-17,2017-03-18,Colorado Avalanche,0,Central,Western,43,2,140,0.30714285714285716,81,-38,79,-36
2016-17,2017-03-19,Colorado Avalanche,0,Central,Western,43,2,142,0.3028169014084507,81,-38,81,-38
2016-17,2017-03-22,Colorado Avalanche,0,Central,Western,43,2,144,0.2986111111111111,83,-40,83,-40
2016-17,2017-03-24,Colorado Avalanche,0,Central,Western,43,2,146,0.2945205479452055,85,-42,85,-42
2016-17,2017-03-26,Colorado Avalanche,0,Central,Western,43,2,148,0.2905405405405405,87,-44,86,-43
2016-17,2017-03-28,Colorado Avalanche,0,Central,Western,43,2,150,0.2866666666666667,89,-46,88,-45
2016-17,2017-03-30,Colorado Avalanche,0,Central,Western,43,2,152,0.28289473684210525,90,-47,89,-46
2016-17,2017-04-01,Colorado Avalanche,2,Central,Western,45,2,154,0.2922077922077922,91,-46,91,-46
2016-17,2017-04-02,Colorado Avalanche,0,Central,Western,45,2,156,0.28846153846153844,93,-48,91,-46
2016-17,2017-04-05,Colorado Avalanche,2,Central,Western,47,2,158,0.2974683544303797,93,-46,92,-45
2016-17,2017-04-07,Colorado Avalanche,0,Central,Western,47,2,160,0.29375,95,-48,94,-47
2016-17,2017-04-09,Colorado Avalanche,1,Central,Western,48,2,162,0.2962962962962963,99,-51,94,-46
2016-17,2017-04-09,Colorado Avalanche,0,Central,Western,48,2,164,0.2926829268292683,99,-51,94,-46
2016-17,2016-10-13,Columbus Blue Jackets,0,Metropolitan,Eastern,0,2,2,0.0,0,0,1,-1
2016-17,2016-10-15,Columbus Blue Jackets,0,Metropolitan,Eastern,0,2,4,0.0,2,-2,2,-2
2016-17,2016-10-21,Columbus Blue Jackets,2,Metropolitan,Eastern,2,2,6,0.3333333333333333,4,-2,5,-3
2016-17,2016-10-23,Columbus Blue Jackets,2,Metropolitan,Eastern,4,2,8,0.5,7,-3,6,-2
2016-17,2016-10-26,Columbus Blue Jackets,1,Metropolitan,Eastern,5,2,10,0.5,7,-2,7,-2
2016-17,2016-10-28,Columbus Blue Jackets,0,Metropolitan,Eastern,5,2,12,0.4166666666666667,8,-3,7,-2
2016-17,2016-10-29,Columbus Blue Jackets,2,Metropolitan,Eastern,7,2,14,0.5,10,-3,8,-1
2016-17,2016-11-01,Columbus Blue Jackets,2,Metropolitan,Eastern,9,2,16,0.5625,11,-2,10,-1
2016-17,2016-11-04,Columbus Blue Jackets,2,Metropolitan,Eastern,11,2,18,0.6111111111111112,15,-4,12,-1
2016-17,2016-11-05,Columbus Blue Jackets,1,Metropolitan,Eastern,12,2,20,0.6,16,-4,13,-1
2016-17,2016-11-10,Columbus Blue Jackets,2,Metropolitan,Eastern,14,2,22,0.6363636363636364,17,-3,15,-1
2016-17,2016-11-11,Columbus Blue Jackets,0,Metropolitan,Eastern,14,2,24,0.5833333333333334,17,-3,16,-2
2016-17,2016-11-13,Columbus Blue Jackets,2,Metropolitan,Eastern,16,2,26,0.6153846153846154,19,-3,17,-1
2016-17,2016-11-16,Columbus Blue Jackets,2,Metropolitan,Eastern,18,2,28,0.6428571428571429,21,-3,20,-2
2016-17,2016-11-19,Columbus Blue Jackets,2,Metropolitan,Eastern,20,2,30,0.6666666666666666,24,-4,20,0
2016-17,2016-11-20,Columbus Blue Jackets,2,Metropolitan,Eastern,22,2,32,0.6875,24,-2,21,1
2016-17,2016-11-22,Columbus Blue Jackets,1,Metropolitan,Eastern,23,2,34,0.6764705882352942,24,-1,21,2
2016-17,2016-11-24,Columbus Blue Jackets,0,Metropolitan,Eastern,23,2,36,0.6388888888888888,26,-3,23,0
2016-17,2016-11-26,Columbus Blue Jackets,2,Metropolitan,Eastern,25,2,38,0.6578947368421053,27,-2,24,1
2016-17,2016-11-27,Columbus Blue Jackets,1,Metropolitan,Eastern,26,2,40,0.65,28,-2,25,1
2016-17,2016-11-30,Columbus Blue Jackets,2,Metropolitan,Eastern,28,2,42,0.6666666666666666,28,0,25,3
2016-17,2016-12-02,Columbus Blue Jackets,2,Metropolitan,Eastern,30,2,44,0.6818181818181818,30,0,27,3
2016-17,2016-12-04,Columbus Blue Jackets,2,Metropolitan,Eastern,32,2,46,0.6956521739130435,32,0,29,3
2016-17,2016-12-06,Columbus Blue Jackets,2,Metropolitan,Eastern,34,2,48,0.7083333333333334,34,0,31,3
2016-17,2016-12-10,Columbus Blue Jackets,2,Metropolitan,Eastern,36,2,50,0.72,37,-1,32,4
2016-17,2016-12-11,Columbus Blue Jackets,2,Metropolitan,Eastern,38,2,52,0.7307692307692307,39,-1,32,6
2016-17,2016-12-14,Columbus Blue Jackets,2,Metropolitan,Eastern,40,2,54,0.7407407407407407,40,0,34,6
2016-17,2016-12-17,Columbus Blue Jackets,2,Metropolitan,Eastern,42,2,56,0.75,42,0,35,7
2016-17,2016-12-18,Columbus Blue Jackets,2,Metropolitan,Eastern,44,2,58,0.7586206896551724,44,0,37,7
2016-17,2016-12-21,Columbus Blue Jackets,2,Metropolitan,Eastern,46,2,60,0.7666666666666667,46,0,37,9
2016-17,2016-12-23,Columbus Blue Jackets,2,Metropolitan,Eastern,48,2,62,0.7741935483870968,47,1,39,9
2016-17,2016-12-24,Columbus Blue Jackets,2,Metropolitan,Eastern,50,2,64,0.78125,47,3,40,10
2016-17,2016-12-28,Columbus Blue Jackets,2,Metropolitan,Eastern,52,2,66,0.7878787878787878,49,3,40,12
2016-17,2016-12-30,Columbus Blue Jackets,2,Metropolitan,Eastern,54,2,68,0.7941176470588235,51,3,42,12
2016-17,2016-12-31,Columbus Blue Jackets,2,Metropolitan,Eastern,56,2,70,0.8,51,5,44,12
2016-17,2017-01-04,Columbus Blue Jackets,2,Metropolitan,Eastern,58,2,72,0.8055555555555556,53,5,44,14
2016-17,2017-01-06,Columbus Blue Jackets,0,Metropolitan,Eastern,58,2,74,0.7837837837837838,55,3,44,14
2016-17,2017-01-08,Columbus Blue Jackets,0,Metropolitan,Eastern,58,2,76,0.7631578947368421,57,1,44,14
2016-17,2017-01-08,Columbus Blue Jackets,2,Metropolitan,Eastern,60,2,78,0.7692307692307693,57,3,44,16
2016-17,2017-01-11,Columbus Blue Jackets,0,Metropolitan,Eastern,60,2,80,0.75,57,3,46,14
2016-17,2017-01-14,Columbus Blue Jackets,2,Metropolitan,Eastern,62,2,82,0.7560975609756098,57,5,48,14
2016-17,2017-01-15,Columbus Blue Jackets,0,Metropolitan,Eastern,62,2,84,0.7380952380952381,57,5,49,13
2016-17,2017-01-18,Columbus Blue Jackets,2,Metropolitan,Eastern,64,2,86,0.7441860465116279,59,5,50,14
2016-17,2017-01-20,Columbus Blue Jackets,0,Metropolitan,Eastern,64,2,88,0.7272727272727273,61,3,50,14
2016-17,2017-01-21,Columbus Blue Jackets,2,Metropolitan,Eastern,66,2,90,0.7333333333333333,63,3,50,16
2016-17,2017-01-22,Columbus Blue Jackets,2,Metropolitan,Eastern,68,2,92,0.7391304347826086,65,3,52,16
2016-17,2017-01-25,Columbus Blue Jackets,0,Metropolitan,Eastern,68,2,94,0.723404255319149,65,3,53,15
2016-17,2017-01-27,Columbus Blue Jackets,0,Metropolitan,Eastern,68,2,96,0.7083333333333334,65,3,56,12
2016-17,2017-02-01,Columbus Blue Jackets,2,Metropolitan,Eastern,70,2,98,0.7142857142857143,67,3,56,14
2016-17,2017-02-04,Columbus Blue Jackets,1,Metropolitan,Eastern,71,2,100,0.71,69,2,58,13
2016-17,2017-02-05,Columbus Blue Jackets,0,Metropolitan,Eastern,71,2,102,0.696078431372549,71,0,58,13
2016-17,2017-02-08,Columbus Blue Jackets,2,Metropolitan,Eastern,73,2,104,0.7019230769230769,72,1,59,14
2016-17,2017-02-10,Columbus Blue Jackets,0,Metropolitan,Eastern,73,2,106,0.6886792452830188,73,0,60,13
2016-17,2017-02-11,Columbus Blue Jackets,2,Metropolitan,Eastern,75,2,108,0.6944444444444444,74,1,61,14
2016-17,2017-02-14,Columbus Blue Jackets,0,Metropolitan,Eastern,75,2,110,0.6818181818181818,75,0,61,14
2016-17,2017-02-16,Columbus Blue Jackets,2,Metropolitan,Eastern,77,2,112,0.6875,77,0,63,14
2016-17,2017-02-18,Columbus Blue Jackets,2,Metropolitan,Eastern,79,2,114,0.6929824561403509,79,0,63,16
2016-17,2017-02-19,Columbus Blue Jackets,0,Metropolitan,Eastern,79,2,116,0.6810344827586207,79,0,64,15
2016-17,2017-02-25,Columbus Blue Jackets,2,Metropolitan,Eastern,81,2,118,0.6864406779661016,82,-1,68,13
2016-17,2017-02-26,Columbus Blue Jackets,2,Metropolitan,Eastern,83,2,120,0.6916666666666667,83,0,69,14
2016-17,2017-03-01,Columbus Blue Jackets,1,Metropolitan,Eastern,84,2,122,0.6885245901639344,84,0,69,15
2016-17,2017-03-03,Columbus Blue Jackets,2,Metropolitan,Eastern,86,2,124,0.6935483870967742,84,2,70,16
2016-17,2017-03-05,Columbus Blue Jackets,0,Metropolitan,Eastern,86,2,126,0.6825396825396826,86,0,71,15
2016-17,2017-03-05,Columbus Blue Jackets,2,Metropolitan,Eastern,88,2,128,0.6875,86,2,71,17
2016-17,2017-03-08,Columbus Blue Jackets,2,Metropolitan,Eastern,90,2,130,0.6923076923076923,88,2,73,17
2016-17,2017-03-11,Columbus Blue Jackets,2,Metropolitan,Eastern,92,2,132,0.696969696969697,92,0,75,17
2016-17,2017-03-12,Columbus Blue Jackets,0,Metropolitan,Eastern,92,2,134,0.6865671641791045,92,0,76,16
2016-17,2017-03-13,Columbus Blue Jackets,2,Metropolitan,Eastern,94,2,136,0.6911764705882353,94,0,76,18
2016-17,2017-03-16,Columbus Blue Jackets,2,Metropolitan,Eastern,96,2,138,0.6956521739130435,95,1,78,18
2016-17,2017-03-18,Columbus Blue Jackets,2,Metropolitan,Eastern,98,2,140,0.7,97,1,79,19
2016-17,2017-03-19,Columbus Blue Jackets,2,Metropolitan,Eastern,100,2,142,0.704225352112676,99,1,79,21
2016-17,2017-03-22,Columbus Blue Jackets,0,Metropolitan,Eastern,100,2,144,0.6944444444444444,100,0,82,18
2016-17,2017-03-23,Columbus Blue Jackets,1,Metropolitan,Eastern,101,2,146,0.6917808219178082,101,0,82,19
2016-17,2017-03-25,Columbus Blue Jackets,2,Metropolitan,Eastern,103,2,148,0.6959459459459459,103,0,84,19
2016-17,2017-03-28,Columbus Blue Jackets,2,Metropolitan,Eastern,105,2,150,0.7,103,2,86,19
2016-17,2017-03-30,Columbus Blue Jackets,1,Metropolitan,Eastern,106,2,152,0.6973684210526315,103,3,87,19
2016-17,2017-04-01,Columbus Blue Jackets,0,Metropolitan,Eastern,106,2,154,0.6883116883116883,105,1,90,16
2016-17,2017-04-02,Columbus Blue Jackets,0,Metropolitan,Eastern,106,2,156,0.6794871794871795,106,0,91,15
2016-17,2017-04-04,Columbus Blue Jackets,0,Metropolitan,Eastern,106,2,158,0.6708860759493671,106,0,93,13
2016-17,2017-04-06,Columbus Blue Jackets,0,Metropolitan,Eastern,106,2,160,0.6625,106,0,93,13
2016-17,2017-04-08,Columbus Blue Jackets,0,Metropolitan,Eastern,106,2,162,0.654320987654321,106,0,95,11
2016-17,2017-04-09,Columbus Blue Jackets,2,Metropolitan,Eastern,108,2,164,0.6585365853658537,108,0,95,13
2016-17,2016-10-14,Dallas Stars,2,Central,Western,2,2,2,1.0,2,0,0,2
2016-17,2016-10-16,Dallas Stars,0,Central,Western,2,2,4,0.5,2,0,2,0
2016-17,2016-10-19,Dallas Stars,2,Central,Western,4,2,6,0.6666666666666666,4,0,4,0
2016-17,2016-10-21,Dallas Stars,1,Central,Western,5,2,8,0.625,6,-1,4,1
2016-17,2016-10-23,Dallas Stars,0,Central,Western,5,2,10,0.5,6,-1,5,0
2016-17,2016-10-26,Dallas Stars,2,Central,Western,7,2,12,0.5833333333333334,7,0,7,0
2016-17,2016-10-28,Dallas Stars,0,Central,Western,7,2,14,0.5,9,-2,8,-1
2016-17,2016-10-30,Dallas Stars,0,Central,Western,7,2,16,0.4375,11,-4,8,-1
2016-17,2016-11-01,Dallas Stars,1,Central,Western,8,2,18,0.4444444444444444,11,-3,8,0
2016-17,2016-11-04,Dallas Stars,2,Central,Western,10,2,20,0.5,12,-2,10,0
2016-17,2016-11-06,Dallas Stars,0,Central,Western,10,2,22,0.45454545454545453,13,-3,11,-1
2016-17,2016-11-07,Dallas Stars,1,Central,Western,11,2,24,0.4583333333333333,13,-2,11,0
2016-17,2016-11-09,Dallas Stars,0,Central,Western,11,2,26,0.4230769230769231,13,-2,13,-2
2016-17,2016-11-11,Dallas Stars,2,Central,Western,13,2,28,0.4642857142857143,15,-2,14,-1
2016-17,2016-11-12,Dallas Stars,2,Central,Western,15,2,30,0.5,16,-1,15,0
2016-17,2016-11-13,Dallas Stars,1,Central,Western,16,2,32,0.5,17,-1,16,0
2016-17,2016-11-16,Dallas Stars,1,Central,Western,17,2,34,0.5,19,-2,17,0
2016-17,2016-11-18,Dallas Stars,2,Central,Western,19,2,36,0.5277777777777778,20,-1,18,1
2016-17,2016-11-20,Dallas Stars,0,Central,Western,19,2,38,0.5,20,-1,19,0
2016-17,2016-11-22,Dallas Stars,2,Central,Western,21,2,40,0.525,21,0,20,1
2016-17,2016-11-24,Dallas Stars,0,Central,Western,21,2,42,0.5,22,-1,21,0
2016-17,2016-11-26,Dallas Stars,2,Central,Western,23,2,44,0.5227272727272727,24,-1,23,0
2016-17,2016-11-29,Dallas Stars,1,Central,Western,24,2,46,0.5217391304347826,25,-1,24,0
2016-17,2016-11-30,Dallas Stars,0,Central,Western,24,2,48,0.5,25,-1,25,-1
2016-17,2016-12-02,Dallas Stars,0,Central,Western,24,2,50,0.48,25,-1,25,-1
2016-17,2016-12-04,Dallas Stars,2,Central,Western,26,2,52,0.5,26,0,26,0
2016-17,2016-12-07,Dallas Stars,0,Central,Western,26,2,54,0.48148148148148145,29,-3,28,-2
2016-17,2016-12-09,Dallas Stars,2,Central,Western,28,2,56,0.5,30,-2,29,-1
2016-17,2016-12-10,Dallas Stars,0,Central,Western,28,2,58,0.4827586206896552,32,-4,30,-2
2016-17,2016-12-12,Dallas Stars,0,Central,Western,28,2,60,0.4666666666666667,34,-6,30,-2
2016-17,2016-12-14,Dallas Stars,2,Central,Western,30,2,62,0.4838709677419355,36,-6,30,0
2016-17,2016-12-16,Dallas Stars,0,Central,Western,30,2,64,0.46875,38,-8,32,-2
2016-17,2016-12-17,Dallas Stars,2,Central,Western,32,2,66,0.48484848484848486,38,-6,34,-2
2016-17,2016-12-21,Dallas Stars,1,Central,Western,33,2,68,0.4852941176470588,41,-8,35,-2
2016-17,2016-12-24,Dallas Stars,2,Central,Western,35,2,70,0.5,41,-6,38,-3
2016-17,2016-12-28,Dallas Stars,2,Central,Western,37,2,72,0.5138888888888888,41,-4,38,-1
2016-17,2016-12-30,Dallas Stars,2,Central,Western,39,2,74,0.527027027027027,43,-4,39,0
2016-17,2017-01-01,Dallas Stars,0,Central,Western,39,2,76,0.5131578947368421,43,-4,40,-1
2016-17,2017-01-05,Dallas Stars,1,Central,Western,40,2,78,0.5128205128205128,45,-5,42,-2
2016-17,2017-01-08,Dallas Stars,0,Central,Western,40,2,80,0.5,47,-7,44,-4
2016-17,2017-01-10,Dallas Stars,2,Central,Western,42,2,82,0.5121951219512195,47,-5,44,-2
2016-17,2017-01-11,Dallas Stars,0,Central,Western,42,2,84,0.5,47,-5,44,-2
2016-17,2017-01-13,Dallas Stars,2,Central,Western,44,2,86,0.5116279069767442,47,-3,46,-2
2016-17,2017-01-15,Dallas Stars,0,Central,Western,44,2,88,0.5,49,-5,48,-4
2016-17,2017-01-16,Dallas Stars,0,Central,Western,44,2,90,0.4888888888888889,51,-7,48,-4
2016-17,2017-01-18,Dallas Stars,2,Central,Western,46,2,92,0.5,51,-5,48,-2
2016-17,2017-01-20,Dallas Stars,0,Central,Western,46,2,94,0.48936170212765956,51,-5,49,-3
2016-17,2017-01-22,Dallas Stars,1,Central,Western,47,2,96,0.4895833333333333,51,-4,51,-4
2016-17,2017-01-25,Dallas Stars,1,Central,Western,48,2,98,0.4897959183673469,54,-6,51,-3
2016-17,2017-01-27,Dallas Stars,2,Central,Western,50,2,100,0.5,56,-6,53,-3
2016-17,2017-02-01,Dallas Stars,2,Central,Western,52,2,102,0.5098039215686274,56,-4,53,-1
2016-17,2017-02-03,Dallas Stars,0,Central,Western,52,2,104,0.5,58,-6,55,-3
2016-17,2017-02-05,Dallas Stars,0,Central,Western,52,2,106,0.49056603773584906,58,-6,57,-5
2016-17,2017-02-08,Dallas Stars,0,Central,Western,52,2,108,0.48148148148148145,60,-8,59,-7
2016-17,2017-02-10,Dallas Stars,0,Central,Western,52,2,110,0.4727272727272727,61,-9,60,-8
2016-17,2017-02-11,Dallas Stars,2,Central,Western,54,2,112,0.48214285714285715,61,-7,60,-6
2016-17,2017-02-12,Dallas Stars,0,Central,Western,54,2,114,0.47368421052631576,63,-9,60,-6
2016-17,2017-02-15,Dallas Stars,0,Central,Western,54,2,116,0.46551724137931033,63,-9,60,-6
2016-17,2017-02-17,Dallas Stars,0,Central,Western,54,2,118,0.4576271186440678,67,-13,61,-7
2016-17,2017-02-19,Dallas Stars,2,Central,Western,56,2,120,0.4666666666666667,67,-11,62,-6
2016-17,2017-02-25,Dallas Stars,2,Central,Western,58,2,122,0.47540983606557374,69,-11,67,-9
2016-17,2017-02-26,Dallas Stars,0,Central,Western,58,2,124,0.46774193548387094,71,-13,67,-9
2016-17,2017-03-01,Dallas Stars,2,Central,Western,60,2,126,0.47619047619047616,73,-13,67,-7
2016-17,2017-03-03,Dallas Stars,0,Central,Western,60,2,128,0.46875,73,-13,68,-8
2016-17,2017-03-05,Dallas Stars,2,Central,Western,62,2,130,0.47692307692307695,73,-11,68,-6
2016-17,2017-03-07,Dallas Stars,2,Central,Western,64,2,132,0.48484848484848486,73,-9,69,-5
2016-17,2017-03-09,Dallas Stars,0,Central,Western,64,2,134,0.47761194029850745,74,-10,71,-7
2016-17,2017-03-13,Dallas Stars,0,Central,Western,64,2,136,0.47058823529411764,77,-13,75,-11
2016-17,2017-03-15,Dallas Stars,0,Central,Western,64,2,138,0.463768115942029,79,-15,77,-13
2016-17,2017-03-17,Dallas Stars,2,Central,Western,66,2,140,0.4714285714285714,81,-15,79,-13
2016-17,2017-03-18,Dallas Stars,0,Central,Western,66,2,142,0.4647887323943662,81,-15,79,-13
2016-17,2017-03-21,Dallas Stars,2,Central,Western,68,2,144,0.4722222222222222,83,-15,81,-13
2016-17,2017-03-24,Dallas Stars,1,Central,Western,69,2,146,0.4726027397260274,85,-16,85,-16
2016-17,2017-03-25,Dallas Stars,2,Central,Western,71,2,148,0.4797297297297297,86,-15,85,-14
2016-17,2017-03-26,Dallas Stars,2,Central,Western,73,2,150,0.4866666666666667,87,-14,86,-13
2016-17,2017-03-28,Dallas Stars,0,Central,Western,73,2,152,0.48026315789473684,89,-16,88,-15
2016-17,2017-03-30,Dallas Stars,0,Central,Western,73,2,154,0.474025974025974,90,-17,89,-16
2016-17,2017-04-01,Dallas Stars,2,Central,Western,75,2,156,0.4807692307692308,91,-16,91,-16
2016-17,2017-04-02,Dallas Stars,0,Central,Western,75,2,158,0.47468354430379744,93,-18,91,-16
2016-17,2017-04-05,Dallas Stars,2,Central,Western,77,2,160,0.48125,93,-16,92,-15
2016-17,2017-04-07,Dallas Stars,0,Central,Western,77,2,162,0.47530864197530864,95,-18,94,-17
2016-17,2017-04-09,Dallas Stars,2,Central,Western,79,2,164,0.4817073170731707,99,-20,94,-15
2016-17,2016-10-13,Detroit Red Wings,0,Atlantic,Eastern,0,2,2,0.0,2,-2,1,-1
2016-17,2016-10-15,Detroit Red Wings,0,Atlantic,Eastern,0,2,4,0.0,4,-4,2,-2
2016-17,2016-10-17,Detroit Red Wings,2,Atlantic,Eastern,2,2,6,0.3333333333333333,4,-2,3,-1
2016-17,2016-10-20,Detroit Red Wings,2,Atlantic,Eastern,4,2,8,0.5,6,-2,4,0
2016-17,2016-10-21,Detroit Red Wings,2,Atlantic,Eastern,6,2,10,0.6,6,0,5,1
2016-17,2016-10-22,Detroit Red Wings,2,Atlantic,Eastern,8,2,12,0.6666666666666666,8,0,6,2
2016-17,2016-10-25,Detroit Red Wings,2,Atlantic,Eastern,10,2,14,0.7142857142857143,10,0,7,3
2016-17,2016-10-28,Detroit Red Wings,2,Atlantic,Eastern,12,2,16,0.75,10,2,7,5
2016-17,2016-10-29,Detroit Red Wings,0,Atlantic,Eastern,12,2,18,0.6666666666666666,10,2,8,4
2016-17,2016-10-30,Detroit Red Wings,0,Atlantic,Eastern,12,2,20,0.6,10,2,9,3
2016-17,2016-11-03,Detroit Red Wings,1,Atlantic,Eastern,13,2,22,0.5909090909090909,13,0,13,0
2016-17,2016-11-04,Detroit Red Wings,0,Atlantic,Eastern,13,2,24,0.5416666666666666,13,0,12,1
2016-17,2016-11-06,Detroit Red Wings,0,Atlantic,Eastern,13,2,26,0.5,14,-1,13,0
2016-17,2016-11-09,Detroit Red Wings,2,Atlantic,Eastern,15,2,28,0.5357142857142857,15,0,14,1
2016-17,2016-11-11,Detroit Red Wings,2,Atlantic,Eastern,17,2,30,0.5666666666666667,17,0,16,1
2016-17,2016-11-13,Detroit Red Wings,0,Atlantic,Eastern,17,2,32,0.53125,18,-1,17,0
2016-17,2016-11-16,Detroit Red Wings,0,Atlantic,Eastern,17,2,34,0.5,21,-4,20,-3
2016-17,2016-11-19,Detroit Red Wings,0,Atlantic,Eastern,17,2,36,0.4722222222222222,21,-4,20,-3
2016-17,2016-11-21,Detroit Red Wings,0,Atlantic,Eastern,17,2,38,0.4473684210526316,22,-5,21,-4
2016-17,2016-11-24,Detroit Red Wings,2,Atlantic,Eastern,19,2,40,0.475,23,-4,23,-4
2016-17,2016-11-26,Detroit Red Wings,2,Atlantic,Eastern,21,2,42,0.5,25,-4,24,-3
2016-17,2016-11-27,Detroit Red Wings,1,Atlantic,Eastern,22,2,44,0.5,27,-5,25,-3
2016-17,2016-11-30,Detroit Red Wings,2,Atlantic,Eastern,24,2,46,0.5217391304347826,27,-3,25,-1
2016-17,2016-12-02,Detroit Red Wings,1,Atlantic,Eastern,25,2,48,0.5208333333333334,27,-2,27,-2
2016-17,2016-12-04,Detroit Red Wings,0,Atlantic,Eastern,25,2,50,0.5,30,-5,29,-4
2016-17,2016-12-04,Detroit Red Wings,2,Atlantic,Eastern,27,2,52,0.5192307692307693,30,-3,29,-2
2016-17,2016-12-07,Detroit Red Wings,2,Atlantic,Eastern,29,2,54,0.5370370370370371,31,-2,31,-2
2016-17,2016-12-10,Detroit Red Wings,0,Atlantic,Eastern,29,2,56,0.5178571428571429,32,-3,32,-3
2016-17,2016-12-11,Detroit Red Wings,1,Atlantic,Eastern,30,2,58,0.5172413793103449,32,-2,32,-2
2016-17,2016-12-14,Detroit Red Wings,0,Atlantic,Eastern,30,2,60,0.5,34,-4,34,-4
2016-17,2016-12-16,Detroit Red Wings,0,Atlantic,Eastern,30,2,62,0.4838709677419355,35,-5,35,-5
2016-17,2016-12-18,Detroit Red Wings,2,Atlantic,Eastern,32,2,64,0.5,37,-5,37,-5
2016-17,2016-12-21,Detroit Red Wings,0,Atlantic,Eastern,32,2,66,0.48484848484848486,37,-5,37,-5
2016-17,2016-12-24,Detroit Red Wings,2,Atlantic,Eastern,34,2,68,0.5,40,-6,40,-6
2016-17,2016-12-28,Detroit Red Wings,0,Atlantic,Eastern,34,2,70,0.4857142857142857,40,-6,40,-6
2016-17,2016-12-30,Detroit Red Wings,2,Atlantic,Eastern,36,2,72,0.5,42,-6,42,-6
2016-17,2017-01-01,Detroit Red Wings,1,Atlantic,Eastern,37,2,74,0.5,44,-7,44,-7
2016-17,2017-01-05,Detroit Red Wings,0,Atlantic,Eastern,37,2,76,0.4868421052631579,44,-7,44,-7
2016-17,2017-01-06,Detroit Red Wings,2,Atlantic,Eastern,39,2,78,0.5,44,-5,44,-5
2016-17,2017-01-08,Detroit Red Wings,0,Atlantic,Eastern,39,2,80,0.4875,44,-5,44,-5
2016-17,2017-01-11,Detroit Red Wings,1,Atlantic,Eastern,40,2,82,0.4878048780487805,46,-6,46,-6
2016-17,2017-01-13,Detroit Red Wings,0,Atlantic,Eastern,40,2,84,0.47619047619047616,48,-8,48,-8
2016-17,2017-01-15,Detroit Red Wings,2,Atlantic,Eastern,42,2,86,0.4883720930232558,48,-6,49,-7
2016-17,2017-01-16,Detroit Red Wings,2,Atlantic,Eastern,44,2,88,0.5,48,-4,49,-5
2016-17,2017-01-19,Detroit Red Wings,2,Atlantic,Eastern,46,2,90,0.5111111111111111,50,-4,50,-4
2016-17,2017-01-21,Detroit Red Wings,1,Atlantic,Eastern,47,2,92,0.5108695652173914,52,-5,50,-3
2016-17,2017-01-22,Detroit Red Wings,1,Atlantic,Eastern,48,2,94,0.5106382978723404,52,-4,52,-4
2016-17,2017-01-25,Detroit Red Wings,1,Atlantic,Eastern,49,2,96,0.5104166666666666,54,-5,53,-4
2016-17,2017-01-26,Detroit Red Wings,0,Atlantic,Eastern,49,2,98,0.5,55,-6,54,-5
2016-17,2017-02-01,Detroit Red Wings,0,Atlantic,Eastern,49,2,100,0.49,58,-9,56,-7
2016-17,2017-02-04,Detroit Red Wings,2,Atlantic,Eastern,51,2,102,0.5,58,-7,58,-7
2016-17,2017-02-05,Detroit Red Wings,2,Atlantic,Eastern,53,2,104,0.5096153846153846,58,-5,58,-5
2016-17,2017-02-08,Detroit Red Wings,1,Atlantic,Eastern,54,2,106,0.5094339622641509,60,-6,59,-5
2016-17,2017-02-10,Detroit Red Wings,0,Atlantic,Eastern,54,2,108,0.5,61,-7,60,-6
2016-17,2017-02-11,Detroit Red Wings,0,Atlantic,Eastern,54,2,110,0.4909090909090909,62,-8,61,-7
2016-17,2017-02-12,Detroit Red Wings,0,Atlantic,Eastern,54,2,112,0.48214285714285715,62,-8,61,-7
2016-17,2017-02-16,Detroit Red Wings,0,Atlantic,Eastern,54,2,114,0.47368421052631576,64,-10,63,-9
2016-17,2017-02-18,Detroit Red Wings,2,Atlantic,Eastern,56,2,116,0.4827586206896552,64,-8,63,-7
2016-17,2017-02-19,Detroit Red Wings,2,Atlantic,Eastern,58,2,118,0.4915254237288136,64,-6,64,-6
2016-17,2017-02-22,Detroit Red Wings,0,Atlantic,Eastern,58,2,120,0.48333333333333334,67,-9,66,-8
2016-17,2017-03-01,Detroit Red Wings,2,Atlantic,Eastern,60,2,122,0.4918032786885246,72,-12,69,-9
2016-17,2017-03-04,Detroit Red Wings,1,Atlantic,Eastern,61,2,124,0.49193548387096775,72,-11,71,-10
2016-17,2017-03-05,Detroit Red Wings,0,Atlantic,Eastern,61,2,126,0.48412698412698413,74,-13,71,-10
2016-17,2017-03-08,Detroit Red Wings,0,Atlantic,Eastern,61,2,128,0.4765625,74,-13,73,-12
2016-17,2017-03-09,Detroit Red Wings,0,Atlantic,Eastern,61,2,130,0.46923076923076923,76,-15,73,-12
2016-17,2017-03-11,Detroit Red Wings,2,Atlantic,Eastern,63,2,132,0.4772727272727273,78,-15,75,-12
2016-17,2017-03-12,Detroit Red Wings,0,Atlantic,Eastern,63,2,134,0.4701492537313433,78,-15,76,-13
2016-17,2017-03-16,Detroit Red Wings,0,Atlantic,Eastern,63,2,136,0.4632352941176471,82,-19,78,-15
2016-17,2017-03-17,Detroit Red Wings,2,Atlantic,Eastern,65,2,138,0.47101449275362317,82,-17,78,-13
2016-17,2017-03-18,Detroit Red Wings,2,Atlantic,Eastern,67,2,140,0.4785714285714286,82,-15,79,-12
2016-17,2017-03-20,Detroit Red Wings,0,Atlantic,Eastern,67,2,142,0.47183098591549294,82,-15,81,-14
2016-17,2017-03-21,Detroit Red Wings,2,Atlantic,Eastern,69,2,144,0.4791666666666667,82,-13,81,-12
2016-17,2017-03-24,Detroit Red Wings,1,Atlantic,Eastern,70,2,146,0.4794520547945205,85,-15,82,-12
2016-17,2017-03-26,Detroit Red Wings,2,Atlantic,Eastern,72,2,148,0.4864864864864865,85,-13,84,-12
2016-17,2017-03-27,Detroit Red Wings,2,Atlantic,Eastern,74,2,150,0.49333333333333335,85,-11,84,-10
2016-17,2017-03-28,Detroit Red Wings,0,Atlantic,Eastern,74,2,152,0.4868421052631579,87,-13,86,-12
2016-17,2017-03-30,Detroit Red Wings,0,Atlantic,Eastern,74,2,154,0.4805194805194805,88,-14,87,-13
2016-17,2017-04-01,Detroit Red Wings,0,Atlantic,Eastern,74,2,156,0.47435897435897434,91,-17,90,-16
2016-17,2017-04-03,Detroit Red Wings,2,Atlantic,Eastern,76,2,158,0.4810126582278481,92,-16,92,-16
2016-17,2017-04-04,Detroit Red Wings,0,Atlantic,Eastern,76,2,160,0.475,94,-18,93,-17
2016-17,2017-04-08,Detroit Red Wings,1,Atlantic,Eastern,77,2,162,0.47530864197530864,95,-18,95,-18
2016-17,2017-04-09,Detroit Red Wings,2,Atlantic,Eastern,79,2,164,0.4817073170731707,95,-16,95,-16
2016-17,2016-10-13,Edmonton Oilers,2,Pacific,Western,2,2,2,1.0,0,2,0,2
2016-17,2016-10-15,Edmonton Oilers,2,Pacific,Western,4,2,4,1.0,0,4,0,4
2016-17,2016-10-16,Edmonton Oilers,0,Pacific,Western,4,2,6,0.6666666666666666,2,2,2,2
2016-17,2016-10-19,Edmonton Oilers,2,Pacific,Western,6,2,8,0.75,6,0,4,2
2016-17,2016-10-21,Edmonton Oilers,2,Pacific,Western,8,2,10,0.8,6,2,4,4
2016-17,2016-10-23,Edmonton Oilers,2,Pacific,Western,10,2,12,0.8333333333333334,6,4,5,5
2016-17,2016-10-27,Edmonton Oilers,2,Pacific,Western,12,2,14,0.8571428571428571,8,4,7,5
2016-17,2016-10-29,Edmonton Oilers,2,Pacific,Western,14,2,16,0.875,9,5,8,6
2016-17,2016-10-31,Edmonton Oilers,0,Pacific,Western,14,2,18,0.7777777777777778,9,5,8,6
2016-17,2016-11-01,Edmonton Oilers,1,Pacific,Western,15,2,20,0.75,9,6,8,7
2016-17,2016-11-03,Edmonton Oilers,0,Pacific,Western,15,2,22,0.6818181818181818,10,5,9,6
2016-17,2016-11-05,Edmonton Oilers,2,Pacific,Western,17,2,24,0.7083333333333334,12,5,11,6
2016-17,2016-11-06,Edmonton Oilers,2,Pacific,Western,19,2,26,0.7307692307692307,12,7,11,8
2016-17,2016-11-09,Edmonton Oilers,0,Pacific,Western,19,2,28,0.6785714285714286,14,5,13,6
2016-17,2016-11-12,Edmonton Oilers,0,Pacific,Western,19,2,30,0.6333333333333333,16,3,15,4
2016-17,2016-11-14,Edmonton Oilers,0,Pacific,Western,19,2,32,0.59375,17,2,16,3
2016-17,2016-11-16,Edmonton Oilers,0,Pacific,Western,19,2,34,0.5588235294117647,18,1,17,2
2016-17,2016-11-18,Edmonton Oilers,0,Pacific,Western,19,2,36,0.5277777777777778,18,1,18,1
2016-17,2016-11-20,Edmonton Oilers,2,Pacific,Western,21,2,38,0.5526315789473685,19,2,19,2
2016-17,2016-11-22,Edmonton Oilers,2,Pacific,Western,23,2,40,0.575,21,2,20,3
2016-17,2016-11-24,Edmonton Oilers,2,Pacific,Western,25,2,42,0.5952380952380952,23,2,21,4
2016-17,2016-11-26,Edmonton Oilers,1,Pacific,Western,26,2,44,0.5909090909090909,23,3,23,3
2016-17,2016-11-27,Edmonton Oilers,0,Pacific,Western,26,2,46,0.5652173913043478,25,1,23,3
2016-17,2016-11-30,Edmonton Oilers,0,Pacific,Western,26,2,48,0.5416666666666666,26,0,25,1
2016-17,2016-12-02,Edmonton Oilers,2,Pacific,Western,28,2,50,0.56,28,0,25,3
2016-17,2016-12-04,Edmonton Oilers,2,Pacific,Western,30,2,52,0.5769230769230769,29,1,26,4
2016-17,2016-12-05,Edmonton Oilers,1,Pacific,Western,31,2,54,0.5740740740740741,29,2,28,3
2016-17,2016-12-07,Edmonton Oilers,1,Pacific,Western,32,2,56,0.5714285714285714,30,2,28,4
2016-17,2016-12-09,Edmonton Oilers,0,Pacific,Western,32,2,58,0.5517241379310345,31,1,29,3
2016-17,2016-12-10,Edmonton Oilers,1,Pacific,Western,33,2,60,0.55,32,1,30,3
2016-17,2016-12-12,Edmonton Oilers,2,Pacific,Western,35,2,62,0.5645161290322581,34,1,30,5
2016-17,2016-12-14,Edmonton Oilers,0,Pacific,Western,35,2,64,0.546875,35,0,30,5
2016-17,2016-12-18,Edmonton Oilers,2,Pacific,Western,37,2,66,0.5606060606060606,37,0,34,3
2016-17,2016-12-20,Edmonton Oilers,2,Pacific,Western,39,2,68,0.5735294117647058,39,0,34,5
2016-17,2016-12-22,Edmonton Oilers,2,Pacific,Western,41,2,70,0.5857142857142857,39,2,35,6
2016-17,2016-12-24,Edmonton Oilers,1,Pacific,Western,42,2,72,0.5833333333333334,40,2,38,4
2016-17,2016-12-30,Edmonton Oilers,2,Pacific,Western,44,2,74,0.5945945945945946,43,1,39,5
2016-17,2017-01-01,Edmonton Oilers,1,Pacific,Western,45,2,76,0.5921052631578947,44,1,40,5
2016-17,2017-01-04,Edmonton Oilers,0,Pacific,Western,45,2,78,0.5769230769230769,45,0,42,3
2016-17,2017-01-06,Edmonton Oilers,2,Pacific,Western,47,2,80,0.5875,47,0,42,5
2016-17,2017-01-08,Edmonton Oilers,2,Pacific,Western,49,2,82,0.5975609756097561,49,0,44,5
2016-17,2017-01-09,Edmonton Oilers,0,Pacific,Western,49,2,84,0.5833333333333334,49,0,44,5
2016-17,2017-01-11,Edmonton Oilers,0,Pacific,Western,49,2,86,0.5697674418604651,49,0,44,5
2016-17,2017-01-13,Edmonton Oilers,2,Pacific,Western,51,2,88,0.5795454545454546,51,0,46,5
2016-17,2017-01-15,Edmonton Oilers,2,Pacific,Western,53,2,90,0.5888888888888889,52,1,48,5
2016-17,2017-01-17,Edmonton Oilers,2,Pacific,Western,55,2,92,0.5978260869565217,54,1,48,7
2016-17,2017-01-19,Edmonton Oilers,2,Pacific,Western,57,2,94,0.6063829787234043,56,1,48,9
2016-17,2017-01-21,Edmonton Oilers,1,Pacific,Western,58,2,96,0.6041666666666666,58,0,51,7
2016-17,2017-01-22,Edmonton Oilers,2,Pacific,Western,60,2,98,0.6122448979591837,60,0,51,9
2016-17,2017-01-26,Edmonton Oilers,2,Pacific,Western,62,2,100,0.62,62,0,52,10
2016-17,2017-01-27,Edmonton Oilers,2,Pacific,Western,64,2,102,0.6274509803921569,63,1,53,11
2016-17,2017-02-01,Edmonton Oilers,0,Pacific,Western,64,2,104,0.6153846153846154,64,0,53,11
2016-17,2017-02-03,Edmonton Oilers,0,Pacific,Western,64,2,106,0.6037735849056604,64,0,55,9
2016-17,2017-02-04,Edmonton Oilers,0,Pacific,Western,64,2,108,0.5925925925925926,64,0,57,7
2016-17,2017-02-05,Edmonton Oilers,2,Pacific,Western,66,2,110,0.6,66,0,57,9
2016-17,2017-02-12,Edmonton Oilers,0,Pacific,Western,66,2,112,0.5892857142857143,66,0,60,6
2016-17,2017-02-15,Edmonton Oilers,2,Pacific,Western,68,2,114,0.5964912280701754,68,0,60,8
2016-17,2017-02-17,Edmonton Oilers,2,Pacific,Western,70,2,116,0.603448275862069,70,0,61,9
2016-17,2017-02-19,Edmonton Oilers,2,Pacific,Western,72,2,118,0.6101694915254238,70,2,62,10
2016-17,2017-02-22,Edmonton Oilers,0,Pacific,Western,72,2,120,0.6,72,0,64,8
2016-17,2017-02-23,Edmonton Oilers,2,Pacific,Western,74,2,122,0.6065573770491803,74,0,64,10
2016-17,2017-02-25,Edmonton Oilers,0,Pacific,Western,74,2,124,0.5967741935483871,74,0,67,7
2016-17,2017-02-26,Edmonton Oilers,0,Pacific,Western,74,2,126,0.5873015873015873,74,0,67,7
2016-17,2017-03-01,Edmonton Oilers,2,Pacific,Western,76,2,128,0.59375,74,2,67,9
2016-17,2017-03-05,Edmonton Oilers,2,Pacific,Western,78,2,130,0.6,76,2,68,10
2016-17,2017-03-08,Edmonton Oilers,0,Pacific,Western,78,2,132,0.5909090909090909,78,0,71,7
2016-17,2017-03-11,Edmonton Oilers,1,Pacific,Western,79,2,134,0.5895522388059702,79,0,73,6
2016-17,2017-03-12,Edmonton Oilers,0,Pacific,Western,79,2,136,0.5808823529411765,80,-1,75,4
2016-17,2017-03-15,Edmonton Oilers,2,Pacific,Western,81,2,138,0.5869565217391305,82,-1,77,4
2016-17,2017-03-17,Edmonton Oilers,2,Pacific,Western,83,2,140,0.5928571428571429,83,0,79,4
2016-17,2017-03-19,Edmonton Oilers,2,Pacific,Western,85,2,142,0.5985915492957746,85,0,81,4
2016-17,2017-03-21,Edmonton Oilers,2,Pacific,Western,87,2,144,0.6041666666666666,87,0,81,6
2016-17,2017-03-23,Edmonton Oilers,0,Pacific,Western,87,2,146,0.5958904109589042,87,0,83,4
2016-17,2017-03-24,Edmonton Oilers,2,Pacific,Western,89,2,148,0.6013513513513513,89,0,85,4
2016-17,2017-03-26,Edmonton Oilers,2,Pacific,Western,91,2,150,0.6066666666666667,91,0,86,5
2016-17,2017-03-29,Edmonton Oilers,2,Pacific,Western,93,2,152,0.6118421052631579,93,0,88,5
2016-17,2017-03-31,Edmonton Oilers,2,Pacific,Western,95,2,154,0.6168831168831169,93,2,89,6
2016-17,2017-04-02,Edmonton Oilers,2,Pacific,Western,97,2,156,0.6217948717948718,95,2,91,6
2016-17,2017-04-05,Edmonton Oilers,0,Pacific,Western,97,2,158,0.6139240506329114,97,0,92,5
2016-17,2017-04-07,Edmonton Oilers,2,Pacific,Western,99,2,160,0.61875,97,2,94,5
2016-17,2017-04-09,Edmonton Oilers,2,Pacific,Western,101,2,162,0.6234567901234568,99,2,94,7
2016-17,2017-04-10,Edmonton Oilers,2,Pacific,Western,103,2,164,0.6280487804878049,99,4,94,9
2016-17,2016-10-13,Florida Panthers,2,Atlantic,Eastern,2,2,2,1.0,2,0,1,1
2016-17,2016-10-15,Florida Panthers,2,Atlantic,Eastern,4,2,4,1.0,4,0,2,2
2016-17,2016-10-18,Florida Panthers,1,Atlantic,Eastern,5,2,6,0.8333333333333334,5,0,4,1
2016-17,2016-10-20,Florida Panthers,0,Atlantic,Eastern,5,2,8,0.625,6,-1,4,1
2016-17,2016-10-22,Florida Panthers,2,Atlantic,Eastern,7,2,10,0.7,8,-1,6,1
2016-17,2016-10-25,Florida Panthers,0,Atlantic,Eastern,7,2,12,0.5833333333333334,10,-3,7,0
2016-17,2016-10-27,Florida Panthers,0,Atlantic,Eastern,7,2,14,0.5,10,-3,7,0
2016-17,2016-10-29,Florida Panthers,0,Atlantic,Eastern,7,2,16,0.4375,10,-3,8,-1
2016-17,2016-10-30,Florida Panthers,2,Atlantic,Eastern,9,2,18,0.5,10,-1,9,0
2016-17,2016-11-01,Florida Panthers,0,Atlantic,Eastern,9,2,20,0.45,12,-3,10,-1
2016-17,2016-11-03,Florida Panthers,2,Atlantic,Eastern,11,2,22,0.5,13,-2,13,-2
2016-17,2016-11-05,Florida Panthers,0,Atlantic,Eastern,11,2,24,0.4583333333333333,14,-3,13,-2
2016-17,2016-11-08,Florida Panthers,2,Atlantic,Eastern,13,2,26,0.5,14,-1,13,0
2016-17,2016-11-11,Florida Panthers,0,Atlantic,Eastern,13,2,28,0.4642857142857143,17,-4,16,-3
2016-17,2016-11-13,Florida Panthers,2,Atlantic,Eastern,15,2,30,0.5,18,-3,17,-2
2016-17,2016-11-16,Florida Panthers,2,Atlantic,Eastern,17,2,32,0.53125,21,-4,20,-3
2016-17,2016-11-18,Florida Panthers,0,Atlantic,Eastern,17,2,34,0.5,21,-4,20,-3
2016-17,2016-11-20,Florida Panthers,2,Atlantic,Eastern,19,2,36,0.5277777777777778,22,-3,21,-2
2016-17,2016-11-21,Florida Panthers,2,Atlantic,Eastern,21,2,38,0.5526315789473685,22,-1,21,0
2016-17,2016-11-23,Florida Panthers,0,Atlantic,Eastern,21,2,40,0.525,23,-2,22,-1
2016-17,2016-11-27,Florida Panthers,0,Atlantic,Eastern,21,2,42,0.5,27,-6,25,-4
2016-17,2016-11-27,Florida Panthers,2,Atlantic,Eastern,23,2,44,0.5227272727272727,27,-4,25,-2
2016-17,2016-11-30,Florida Panthers,1,Atlantic,Eastern,24,2,46,0.5217391304347826,27,-3,25,-1
2016-17,2016-12-02,Florida Panthers,2,Atlantic,Eastern,26,2,48,0.5416666666666666,27,-1,27,-1
2016-17,2016-12-04,Florida Panthers,0,Atlantic,Eastern,26,2,50,0.52,30,-4,29,-3
2016-17,2016-12-06,Florida Panthers,1,Atlantic,Eastern,27,2,52,0.5192307692307693,31,-4,31,-4
2016-17,2016-12-07,Florida Panthers,1,Atlantic,Eastern,28,2,54,0.5185185185185185,31,-3,31,-3
2016-17,2016-12-09,Florida Panthers,0,Atlantic,Eastern,28,2,56,0.5,32,-4,32,-4
2016-17,2016-12-11,Florida Panthers,2,Atlantic,Eastern,30,2,58,0.5172413793103449,32,-2,32,-2
2016-17,2016-12-14,Florida Panthers,0,Atlantic,Eastern,30,2,60,0.5,34,-4,34,-4
2016-17,2016-12-16,Florida Panthers,1,Atlantic,Eastern,31,2,62,0.5,35,-4,35,-4
2016-17,2016-12-17,Florida Panthers,2,Atlantic,Eastern,33,2,64,0.515625,35,-2,35,-2
2016-17,2016-12-21,Florida Panthers,2,Atlantic,Eastern,35,2,66,0.5303030303030303,37,-2,37,-2
2016-17,2016-12-23,Florida Panthers,0,Atlantic,Eastern,35,2,68,0.5147058823529411,39,-4,39,-4
2016-17,2016-12-24,Florida Panthers,1,Atlantic,Eastern,36,2,70,0.5142857142857142,40,-4,40,-4
2016-17,2016-12-29,Florida Panthers,1,Atlantic,Eastern,37,2,72,0.5138888888888888,40,-3,40,-3
2016-17,2016-12-30,Florida Panthers,1,Atlantic,Eastern,38,2,74,0.5135135135135135,42,-4,42,-4
2016-17,2017-01-01,Florida Panthers,2,Atlantic,Eastern,40,2,76,0.5263157894736842,44,-4,44,-4
2016-17,2017-01-05,Florida Panthers,0,Atlantic,Eastern,40,2,78,0.5128205128205128,44,-4,44,-4
2016-17,2017-01-07,Florida Panthers,2,Atlantic,Eastern,42,2,80,0.525,44,-2,44,-2
2016-17,2017-01-08,Florida Panthers,0,Atlantic,Eastern,42,2,82,0.5121951219512195,44,-2,44,-2
2016-17,2017-01-10,Florida Panthers,2,Atlantic,Eastern,44,2,84,0.5238095238095238,46,-2,46,-2
2016-17,2017-01-12,Florida Panthers,2,Atlantic,Eastern,46,2,86,0.5348837209302325,46,0,46,0
2016-17,2017-01-14,Florida Panthers,0,Atlantic,Eastern,46,2,88,0.5227272727272727,48,-2,48,-2
2016-17,2017-01-15,Florida Panthers,2,Atlantic,Eastern,48,2,90,0.5333333333333333,48,0,49,-1
2016-17,2017-01-18,Florida Panthers,0,Atlantic,Eastern,48,2,92,0.5217391304347826,50,-2,50,-2
2016-17,2017-01-19,Florida Panthers,1,Atlantic,Eastern,49,2,94,0.5212765957446809,50,-1,50,-1
2016-17,2017-01-21,Florida Panthers,0,Atlantic,Eastern,49,2,96,0.5104166666666666,52,-3,50,-1
2016-17,2017-01-24,Florida Panthers,1,Atlantic,Eastern,50,2,98,0.5102040816326531,53,-3,52,-2
2016-17,2017-01-27,Florida Panthers,2,Atlantic,Eastern,52,2,100,0.52,56,-4,56,-4
2016-17,2017-02-01,Florida Panthers,2,Atlantic,Eastern,54,2,102,0.5294117647058824,58,-4,56,-2
2016-17,2017-02-04,Florida Panthers,2,Atlantic,Eastern,56,2,104,0.5384615384615384,58,-2,58,-2
2016-17,2017-02-10,Florida Panthers,0,Atlantic,Eastern,56,2,106,0.5283018867924528,61,-5,60,-4
2016-17,2017-02-11,Florida Panthers,2,Atlantic,Eastern,58,2,108,0.5370370370370371,62,-4,61,-3
2016-17,2017-02-16,Florida Panthers,2,Atlantic,Eastern,60,2,110,0.5454545454545454,64,-4,63,-3
2016-17,2017-02-18,Florida Panthers,2,Atlantic,Eastern,62,2,112,0.5535714285714286,64,-2,63,-1
2016-17,2017-02-19,Florida Panthers,2,Atlantic,Eastern,64,2,114,0.5614035087719298,64,0,64,0
2016-17,2017-02-21,Florida Panthers,2,Atlantic,Eastern,66,2,116,0.5689655172413793,66,0,66,0
2016-17,2017-02-23,Florida Panthers,0,Atlantic,Eastern,66,2,118,0.559322033898305,67,-1,66,0
2016-17,2017-02-25,Florida Panthers,0,Atlantic,Eastern,66,2,120,0.55,68,-2,68,-2
2016-17,2017-02-27,Florida Panthers,0,Atlantic,Eastern,66,2,122,0.5409836065573771,70,-4,69,-3
2016-17,2017-03-01,Florida Panthers,2,Atlantic,Eastern,68,2,124,0.5483870967741935,72,-4,69,-1
2016-17,2017-03-03,Florida Panthers,1,Atlantic,Eastern,69,2,126,0.5476190476190477,72,-3,70,-1
2016-17,2017-03-05,Florida Panthers,0,Atlantic,Eastern,69,2,128,0.5390625,74,-5,71,-2
2016-17,2017-03-08,Florida Panthers,0,Atlantic,Eastern,69,2,130,0.5307692307692308,74,-5,73,-4
2016-17,2017-03-11,Florida Panthers,0,Atlantic,Eastern,69,2,132,0.5227272727272727,78,-9,75,-6
2016-17,2017-03-12,Florida Panthers,0,Atlantic,Eastern,69,2,134,0.5149253731343284,78,-9,76,-7
2016-17,2017-03-14,Florida Panthers,2,Atlantic,Eastern,71,2,136,0.5220588235294118,80,-9,77,-6
2016-17,2017-03-16,Florida Panthers,0,Atlantic,Eastern,71,2,138,0.5144927536231884,82,-11,78,-7
2016-17,2017-03-17,Florida Panthers,2,Atlantic,Eastern,73,2,140,0.5214285714285715,82,-9,78,-5
2016-17,2017-03-19,Florida Panthers,0,Atlantic,Eastern,73,2,142,0.5140845070422535,82,-9,79,-6
2016-17,2017-03-21,Florida Panthers,0,Atlantic,Eastern,73,2,144,0.5069444444444444,82,-9,81,-8
2016-17,2017-03-23,Florida Panthers,2,Atlantic,Eastern,75,2,146,0.5136986301369864,85,-10,82,-7
2016-17,2017-03-25,Florida Panthers,2,Atlantic,Eastern,77,2,148,0.5202702702702703,85,-8,84,-7
2016-17,2017-03-27,Florida Panthers,0,Atlantic,Eastern,77,2,150,0.5133333333333333,85,-8,84,-7
2016-17,2017-03-28,Florida Panthers,0,Atlantic,Eastern,77,2,152,0.506578947368421,87,-10,86,-9
2016-17,2017-03-30,Florida Panthers,0,Atlantic,Eastern,77,2,154,0.5,88,-11,87,-10
2016-17,2017-04-01,Florida Panthers,0,Atlantic,Eastern,77,2,156,0.4935897435897436,91,-14,90,-13
2016-17,2017-04-03,Florida Panthers,0,Atlantic,Eastern,77,2,158,0.4873417721518987,92,-15,92,-15
2016-17,2017-04-06,Florida Panthers,0,Atlantic,Eastern,77,2,160,0.48125,95,-18,93,-16
2016-17,2017-04-08,Florida Panthers,2,Atlantic,Eastern,79,2,162,0.4876543209876543,95,-16,95,-16
2016-17,2017-04-09,Florida Panthers,2,Atlantic,Eastern,81,2,164,0.49390243902439024,95,-14,95,-14
2016-17,2016-10-13,Los Angeles Kings,0,Pacific,Western,0,2,2,0.0,0,0,0,0
2016-17,2016-10-15,Los Angeles Kings,0,Pacific,Western,0,2,4,0.0,0,0,0,0
2016-17,2016-10-19,Los Angeles Kings,0,Pacific,Western,0,2,6,0.0,6,-6,4,-4
2016-17,2016-10-21,Los Angeles Kings,2,Pacific,Western,2,2,8,0.25,6,-4,4,-2
2016-17,2016-10-23,Los Angeles Kings,2,Pacific,Western,4,2,10,0.4,6,-2,5,-1
2016-17,2016-10-26,Los Angeles Kings,2,Pacific,Western,6,2,12,0.5,8,-2,7,-1
2016-17,2016-10-28,Los Angeles Kings,2,Pacific,Western,8,2,14,0.5714285714285714,9,-1,8,0
2016-17,2016-10-30,Los Angeles Kings,0,Pacific,Western,8,2,16,0.5,9,-1,8,0
2016-17,2016-10-30,Los Angeles Kings,0,Pacific,Western,8,2,18,0.4444444444444444,9,-1,8,0
2016-17,2016-11-02,Los Angeles Kings,0,Pacific,Western,8,2,20,0.4,10,-2,9,-1
2016-17,2016-11-04,Los Angeles Kings,2,Pacific,Western,10,2,22,0.45454545454545453,11,-1,10,0
2016-17,2016-11-06,Los Angeles Kings,2,Pacific,Western,12,2,24,0.5,12,0,11,1
2016-17,2016-11-09,Los Angeles Kings,2,Pacific,Western,14,2,26,0.5384615384615384,14,0,13,1
2016-17,2016-11-11,Los Angeles Kings,0,Pacific,Western,14,2,28,0.5,16,-2,14,0
2016-17,2016-11-12,Los Angeles Kings,0,Pacific,Western,14,2,30,0.4666666666666667,16,-2,15,-1
2016-17,2016-11-13,Los Angeles Kings,1,Pacific,Western,15,2,32,0.46875,17,-2,16,-1
2016-17,2016-11-16,Los Angeles Kings,0,Pacific,Western,15,2,34,0.4411764705882353,18,-3,17,-2
2016-17,2016-11-18,Los Angeles Kings,2,Pacific,Western,17,2,36,0.4722222222222222,18,-1,18,-1
2016-17,2016-11-19,Los Angeles Kings,2,Pacific,Western,19,2,38,0.5,19,0,19,0
2016-17,2016-11-21,Los Angeles Kings,2,Pacific,Western,21,2,40,0.525,21,0,19,2
2016-17,2016-11-24,Los Angeles Kings,2,Pacific,Western,23,2,42,0.5476190476190477,23,0,21,2
2016-17,2016-11-27,Los Angeles Kings,2,Pacific,Western,25,2,44,0.5681818181818182,25,0,23,2
2016-17,2016-12-01,Los Angeles Kings,0,Pacific,Western,25,2,46,0.5434782608695652,26,-1,25,0
2016-17,2016-12-02,Los Angeles Kings,2,Pacific,Western,27,2,48,0.5625,28,-1,25,2
2016-17,2016-12-04,Los Angeles Kings,1,Pacific,Western,28,2,50,0.56,29,-1,26,2
2016-17,2016-12-09,Los Angeles Kings,0,Pacific,Western,28,2,52,0.5384615384615384,31,-3,29,-1
2016-17,2016-12-10,Los Angeles Kings,2,Pacific,Western,30,2,54,0.5555555555555556,32,-2,30,0
2016-17,2016-12-14,Los Angeles Kings,0,Pacific,Western,30,2,56,0.5357142857142857,35,-5,30,0
2016-17,2016-12-16,Los Angeles Kings,2,Pacific,Western,32,2,58,0.5517241379310345,35,-3,32,0
2016-17,2016-12-17,Los Angeles Kings,2,Pacific,Western,34,2,60,0.5666666666666667,35,-1,34,0
2016-17,2016-12-18,Los Angeles Kings,0,Pacific,Western,34,2,62,0.5483870967741935,37,-3,34,0
2016-17,2016-12-21,Los Angeles Kings,1,Pacific,Western,35,2,64,0.546875,39,-4,35,0
2016-17,2016-12-23,Los Angeles Kings,2,Pacific,Western,37,2,66,0.5606060606060606,40,-3,36,1
2016-17,2016-12-24,Los Angeles Kings,1,Pacific,Western,38,2,68,0.5588235294117647,40,-2,38,0
2016-17,2016-12-29,Los Angeles Kings,0,Pacific,Western,38,2,70,0.5428571428571428,41,-3,38,0
2016-17,2016-12-30,Los Angeles Kings,0,Pacific,Western,38,2,72,0.5277777777777778,43,-5,39,-1
2016-17,2017-01-01,Los Angeles Kings,2,Pacific,Western,40,2,74,0.5405405405405406,44,-4,40,0
2016-17,2017-01-04,Los Angeles Kings,2,Pacific,Western,42,2,76,0.5526315789473685,45,-3,42,0
2016-17,2017-01-06,Los Angeles Kings,0,Pacific,Western,42,2,78,0.5384615384615384,47,-5,42,0
2016-17,2017-01-07,Los Angeles Kings,2,Pacific,Western,44,2,80,0.55,47,-3,44,0
2016-17,2017-01-10,Los Angeles Kings,0,Pacific,Western,44,2,82,0.5365853658536586,49,-5,44,0
2016-17,2017-01-13,Los Angeles Kings,2,Pacific,Western,46,2,84,0.5476190476190477,51,-5,46,0
2016-17,2017-01-15,Los Angeles Kings,2,Pacific,Western,48,2,86,0.5581395348837209,52,-4,48,0
2016-17,2017-01-16,Los Angeles Kings,0,Pacific,Western,48,2,88,0.5454545454545454,53,-5,48,0
2016-17,2017-01-19,Los Angeles Kings,0,Pacific,Western,48,2,90,0.5333333333333333,56,-8,48,0
2016-17,2017-01-22,Los Angeles Kings,0,Pacific,Western,48,2,92,0.5217391304347826,60,-12,51,-3
2016-17,2017-01-24,Los Angeles Kings,0,Pacific,Western,48,2,94,0.5106382978723404,60,-12,51,-3
2016-17,2017-01-25,Los Angeles Kings,2,Pacific,Western,50,2,96,0.5208333333333334,60,-10,51,-1
2016-17,2017-01-27,Los Angeles Kings,2,Pacific,Western,52,2,98,0.5306122448979592,63,-11,53,-1
2016-17,2017-02-01,Los Angeles Kings,2,Pacific,Western,54,2,100,0.54,64,-10,53,1
2016-17,2017-02-02,Los Angeles Kings,2,Pacific,Western,56,2,102,0.5490196078431373,64,-8,55,1
2016-17,2017-02-04,Los Angeles Kings,2,Pacific,Western,58,2,104,0.5576923076923077,64,-6,57,1
2016-17,2017-02-05,Los Angeles Kings,0,Pacific,Western,58,2,106,0.5471698113207547,66,-8,57,1
2016-17,2017-02-08,Los Angeles Kings,0,Pacific,Western,58,2,108,0.5370370370370371,66,-8,59,-1
2016-17,2017-02-10,Los Angeles Kings,2,Pacific,Western,60,2,110,0.5454545454545454,66,-6,60,0
2016-17,2017-02-17,Los Angeles Kings,0,Pacific,Western,60,2,112,0.5357142857142857,70,-10,61,-1
2016-17,2017-02-19,Los Angeles Kings,0,Pacific,Western,60,2,114,0.5263157894736842,70,-10,62,-2
2016-17,2017-02-20,Los Angeles Kings,0,Pacific,Western,60,2,116,0.5172413793103449,72,-12,62,-2
2016-17,2017-02-22,Los Angeles Kings,2,Pacific,Western,62,2,118,0.5254237288135594,72,-10,64,-2
2016-17,2017-02-24,Los Angeles Kings,0,Pacific,Western,62,2,120,0.5166666666666667,74,-12,66,-4
2016-17,2017-02-25,Los Angeles Kings,2,Pacific,Western,64,2,122,0.5245901639344263,74,-10,67,-3
2016-17,2017-02-28,Los Angeles Kings,1,Pacific,Western,65,2,124,0.5241935483870968,74,-9,67,-2
2016-17,2017-03-01,Los Angeles Kings,1,Pacific,Western,66,2,126,0.5238095238095238,74,-8,67,-1
2016-17,2017-03-03,Los Angeles Kings,2,Pacific,Western,68,2,128,0.53125,74,-6,68,0
2016-17,2017-03-05,Los Angeles Kings,0,Pacific,Western,68,2,130,0.5230769230769231,76,-8,68,0
2016-17,2017-03-10,Los Angeles Kings,2,Pacific,Western,70,2,132,0.5303030303030303,78,-8,71,-1
2016-17,2017-03-12,Los Angeles Kings,2,Pacific,Western,72,2,134,0.5373134328358209,80,-8,75,-3
2016-17,2017-03-14,Los Angeles Kings,0,Pacific,Western,72,2,136,0.5294117647058824,82,-10,77,-5
2016-17,2017-03-15,Los Angeles Kings,1,Pacific,Western,73,2,138,0.5289855072463768,82,-9,77,-4
2016-17,2017-03-17,Los Angeles Kings,2,Pacific,Western,75,2,140,0.5357142857142857,83,-8,79,-4
2016-17,2017-03-20,Los Angeles Kings,0,Pacific,Western,75,2,142,0.528169014084507,86,-11,81,-6
2016-17,2017-03-21,Los Angeles Kings,0,Pacific,Western,75,2,144,0.5208333333333334,87,-12,81,-6
2016-17,2017-03-24,Los Angeles Kings,2,Pacific,Western,77,2,146,0.5273972602739726,89,-12,85,-8
2016-17,2017-03-26,Los Angeles Kings,0,Pacific,Western,77,2,148,0.5202702702702703,91,-14,86,-9
2016-17,2017-03-29,Los Angeles Kings,0,Pacific,Western,77,2,150,0.5133333333333333,93,-16,88,-11
2016-17,2017-03-30,Los Angeles Kings,2,Pacific,Western,79,2,152,0.5197368421052632,93,-14,89,-10
2016-17,2017-04-01,Los Angeles Kings,2,Pacific,Western,81,2,154,0.525974025974026,93,-12,91,-10
2016-17,2017-04-03,Los Angeles Kings,0,Pacific,Western,81,2,156,0.5192307692307693,95,-14,91,-10
2016-17,2017-04-05,Los Angeles Kings,2,Pacific,Western,83,2,158,0.5253164556962026,97,-14,92,-9
2016-17,2017-04-07,Los Angeles Kings,0,Pacific,Western,83,2,160,0.51875,97,-14,94,-11
2016-17,2017-04-08,Los Angeles Kings,2,Pacific,Western,85,2,162,0.5246913580246914,97,-12,94,-9
2016-17,2017-04-10,Los Angeles Kings,1,Pacific,Western,86,2,164,0.524390243902439,99,-13,94,-8
2016-17,2016-10-14,Minnesota Wild,0,Central,Western,0,2,2,0.0,2,-2,0,0
2016-17,2016-10-15,Minnesota Wild,2,Central,Western,2,2,4,0.5,2,0,0,2
2016-17,2016-10-19,Minnesota Wild,2,Central,Western,4,2,6,0.6666666666666666,4,0,4,0
2016-17,2016-10-21,Minnesota Wild,2,Central,Western,6,2,8,0.75,6,0,4,2
2016-17,2016-10-22,Minnesota Wild,1,Central,Western,7,2,10,0.7,6,1,5,2
2016-17,2016-10-23,Minnesota Wild,0,Central,Western,7,2,12,0.5833333333333334,6,1,5,2
2016-17,2016-10-25,Minnesota Wild,2,Central,Western,9,2,14,0.6428571428571429,7,2,5,4
2016-17,2016-10-27,Minnesota Wild,2,Central,Western,11,2,16,0.6875,7,4,7,4
2016-17,2016-10-30,Minnesota Wild,2,Central,Western,13,2,18,0.7222222222222222,11,2,8,5
2016-17,2016-11-02,Minnesota Wild,0,Central,Western,13,2,20,0.65,12,1,9,4
2016-17,2016-11-05,Minnesota Wild,0,Central,Western,13,2,22,0.5909090909090909,13,0,11,2
2016-17,2016-11-11,Minnesota Wild,2,Central,Western,15,2,24,0.625,15,0,14,1
2016-17,2016-11-13,Minnesota Wild,2,Central,Western,17,2,26,0.6538461538461539,17,0,16,1
2016-17,2016-11-13,Minnesota Wild,0,Central,Western,17,2,28,0.6071428571428571,17,0,16,1
2016-17,2016-11-16,Minnesota Wild,0,Central,Western,17,2,30,0.5666666666666667,19,-2,17,0
2016-17,2016-11-18,Minnesota Wild,2,Central,Western,19,2,32,0.59375,20,-1,18,1
2016-17,2016-11-20,Minnesota Wild,0,Central,Western,19,2,34,0.5588235294117647,20,-1,19,0
2016-17,2016-11-22,Minnesota Wild,1,Central,Western,20,2,36,0.5555555555555556,21,-1,20,0
2016-17,2016-11-24,Minnesota Wild,2,Central,Western,22,2,38,0.5789473684210527,22,0,21,1
2016-17,2016-11-25,Minnesota Wild,2,Central,Western,24,2,40,0.6,24,0,22,2
2016-17,2016-11-27,Minnesota Wild,1,Central,Western,25,2,42,0.5952380952380952,25,0,23,2
2016-17,2016-11-30,Minnesota Wild,0,Central,Western,25,2,44,0.5681818181818182,25,0,25,0
2016-17,2016-12-03,Minnesota Wild,1,Central,Western,26,2,46,0.5652173913043478,26,0,26,0
2016-17,2016-12-05,Minnesota Wild,2,Central,Western,28,2,48,0.5833333333333334,28,0,28,0
2016-17,2016-12-08,Minnesota Wild,2,Central,Western,30,2,50,0.6,30,0,29,1
2016-17,2016-12-10,Minnesota Wild,2,Central,Western,32,2,52,0.6153846153846154,32,0,30,2
2016-17,2016-12-11,Minnesota Wild,2,Central,Western,34,2,54,0.6296296296296297,34,0,30,4
2016-17,2016-12-14,Minnesota Wild,2,Central,Western,36,2,56,0.6428571428571429,36,0,30,6
2016-17,2016-12-16,Minnesota Wild,2,Central,Western,38,2,58,0.6551724137931034,38,0,32,6
2016-17,2016-12-17,Minnesota Wild,2,Central,Western,40,2,60,0.6666666666666666,38,2,34,6
2016-17,2016-12-21,Minnesota Wild,2,Central,Western,42,2,62,0.6774193548387096,41,1,35,7
2016-17,2016-12-23,Minnesota Wild,2,Central,Western,44,2,64,0.6875,41,3,36,8
2016-17,2016-12-24,Minnesota Wild,2,Central,Western,46,2,66,0.696969696969697,41,5,38,8
2016-17,2016-12-28,Minnesota Wild,2,Central,Western,48,2,68,0.7058823529411765,41,7,38,10
2016-17,2016-12-30,Minnesota Wild,2,Central,Western,50,2,70,0.7142857142857143,43,7,39,11
2016-17,2016-12-31,Minnesota Wild,0,Central,Western,50,2,72,0.6944444444444444,43,7,39,11
2016-17,2017-01-06,Minnesota Wild,2,Central,Western,52,2,74,0.7027027027027027,45,7,42,10
2016-17,2017-01-07,Minnesota Wild,1,Central,Western,53,2,76,0.6973684210526315,45,8,44,9
2016-17,2017-01-09,Minnesota Wild,2,Central,Western,55,2,78,0.7051282051282052,47,8,44,11
2016-17,2017-01-13,Minnesota Wild,2,Central,Western,57,2,80,0.7125,47,10,46,11
2016-17,2017-01-15,Minnesota Wild,2,Central,Western,59,2,82,0.7195121951219512,49,10,48,11
2016-17,2017-01-16,Minnesota Wild,2,Central,Western,61,2,84,0.7261904761904762,51,10,48,13
2016-17,2017-01-18,Minnesota Wild,0,Central,Western,61,2,86,0.7093023255813954,51,10,48,13
2016-17,2017-01-20,Minnesota Wild,2,Central,Western,63,2,88,0.7159090909090909,51,12,49,14
2016-17,2017-01-22,Minnesota Wild,2,Central,Western,65,2,90,0.7222222222222222,51,14,51,14
2016-17,2017-01-23,Minnesota Wild,0,Central,Western,65,2,92,0.7065217391304348,53,12,51,14
2016-17,2017-01-25,Minnesota Wild,2,Central,Western,67,2,94,0.7127659574468085,54,13,51,16
2016-17,2017-01-27,Minnesota Wild,2,Central,Western,69,2,96,0.71875,56,13,53,16
2016-17,2017-02-01,Minnesota Wild,2,Central,Western,71,2,98,0.7244897959183674,56,15,53,18
2016-17,2017-02-02,Minnesota Wild,0,Central,Western,71,2,100,0.71,56,15,55,16
2016-17,2017-02-05,Minnesota Wild,2,Central,Western,73,2,102,0.7156862745098039,58,15,57,16
2016-17,2017-02-08,Minnesota Wild,2,Central,Western,75,2,104,0.7211538461538461,60,15,59,16
2016-17,2017-02-09,Minnesota Wild,1,Central,Western,76,2,106,0.7169811320754716,60,16,59,17
2016-17,2017-02-11,Minnesota Wild,2,Central,Western,78,2,108,0.7222222222222222,61,17,60,18
2016-17,2017-02-12,Minnesota Wild,2,Central,Western,80,2,110,0.7272727272727273,63,17,60,20
2016-17,2017-02-15,Minnesota Wild,0,Central,Western,80,2,112,0.7142857142857143,63,17,60,20
2016-17,2017-02-17,Minnesota Wild,2,Central,Western,82,2,114,0.7192982456140351,67,15,61,21
2016-17,2017-02-19,Minnesota Wild,2,Central,Western,84,2,116,0.7241379310344828,67,17,62,22
2016-17,2017-02-22,Minnesota Wild,0,Central,Western,84,2,118,0.711864406779661,67,17,64,20
2016-17,2017-02-28,Minnesota Wild,2,Central,Western,86,2,120,0.7166666666666667,71,15,67,19
2016-17,2017-03-01,Minnesota Wild,2,Central,Western,88,2,122,0.7213114754098361,73,15,67,21
2016-17,2017-03-03,Minnesota Wild,0,Central,Western,88,2,124,0.7096774193548387,73,15,68,20
2016-17,2017-03-05,Minnesota Wild,2,Central,Western,90,2,126,0.7142857142857143,73,17,68,22
2016-17,2017-03-08,Minnesota Wild,0,Central,Western,90,2,128,0.703125,74,16,71,19
2016-17,2017-03-10,Minnesota Wild,0,Central,Western,90,2,130,0.6923076923076923,75,15,71,19
2016-17,2017-03-11,Minnesota Wild,2,Central,Western,92,2,132,0.696969696969697,77,15,73,19
2016-17,2017-03-12,Minnesota Wild,0,Central,Western,92,2,134,0.6865671641791045,77,15,75,17
2016-17,2017-03-14,Minnesota Wild,0,Central,Western,92,2,136,0.6764705882352942,79,13,77,15
2016-17,2017-03-16,Minnesota Wild,0,Central,Western,92,2,138,0.6666666666666666,81,11,77,15
2016-17,2017-03-18,Minnesota Wild,0,Central,Western,92,2,140,0.6571428571428571,81,11,79,13
2016-17,2017-03-19,Minnesota Wild,0,Central,Western,92,2,142,0.647887323943662,81,11,81,11
2016-17,2017-03-22,Minnesota Wild,2,Central,Western,94,2,144,0.6527777777777778,83,11,83,11
2016-17,2017-03-24,Minnesota Wild,0,Central,Western,94,2,146,0.6438356164383562,85,9,85,9
2016-17,2017-03-25,Minnesota Wild,0,Central,Western,94,2,148,0.6351351351351351,86,8,85,9
2016-17,2017-03-26,Minnesota Wild,1,Central,Western,95,2,150,0.6333333333333333,87,8,86,9
2016-17,2017-03-29,Minnesota Wild,1,Central,Western,96,2,152,0.631578947368421,89,7,88,8
2016-17,2017-03-31,Minnesota Wild,2,Central,Western,98,2,154,0.6363636363636364,90,8,89,9
2016-17,2017-04-01,Minnesota Wild,0,Central,Western,98,2,156,0.6282051282051282,91,7,91,7
2016-17,2017-04-02,Minnesota Wild,2,Central,Western,100,2,158,0.6329113924050633,93,7,91,9
2016-17,2017-04-05,Minnesota Wild,2,Central,Western,102,2,160,0.6375,93,9,92,10
2016-17,2017-04-07,Minnesota Wild,2,Central,Western,104,2,162,0.6419753086419753,95,9,94,10
2016-17,2017-04-09,Minnesota Wild,2,Central,Western,106,2,164,0.6463414634146342,99,7,94,12
2016-17,2016-10-13,Montréal Canadiens,2,Atlantic,Eastern,2,2,2,1.0,2,0,1,1
2016-17,2016-10-15,Montréal Canadiens,1,Atlantic,Eastern,3,2,4,0.75,4,-1,2,1
2016-17,2016-10-18,Montréal Canadiens,2,Atlantic,Eastern,5,2,6,0.8333333333333334,5,0,4,1
2016-17,2016-10-20,Montréal Canadiens,2,Atlantic,Eastern,7,2,8,0.875,6,1,4,3
2016-17,2016-10-22,Montréal Canadiens,2,Atlantic,Eastern,9,2,10,0.9,8,1,6,3
2016-17,2016-10-24,Montréal Canadiens,2,Atlantic,Eastern,11,2,12,0.9166666666666666,8,3,6,5
2016-17,2016-10-26,Montréal Canadiens,2,Atlantic,Eastern,13,2,14,0.9285714285714286,10,3,7,6
2016-17,2016-10-27,Montréal Canadiens,2,Atlantic,Eastern,15,2,16,0.9375,10,5,7,8
2016-17,2016-10-29,Montréal Canadiens,2,Atlantic,Eastern,17,2,18,0.9444444444444444,10,7,8,9
2016-17,2016-11-02,Montréal Canadiens,2,Atlantic,Eastern,19,2,20,0.95,12,7,10,9
2016-17,2016-11-04,Montréal Canadiens,0,Atlantic,Eastern,19,2,22,0.8636363636363636,13,6,12,7
2016-17,2016-11-05,Montréal Canadiens,2,Atlantic,Eastern,21,2,24,0.875,14,7,13,8
2016-17,2016-11-09,Montréal Canadiens,2,Atlantic,Eastern,23,2,26,0.8846153846153846,15,8,14,9
2016-17,2016-11-11,Montréal Canadiens,2,Atlantic,Eastern,25,2,28,0.8928571428571429,17,8,16,9
2016-17,2016-11-13,Montréal Canadiens,2,Atlantic,Eastern,27,2,30,0.9,18,9,17,10
2016-17,2016-11-14,Montréal Canadiens,0,Atlantic,Eastern,27,2,32,0.84375,19,8,17,10
2016-17,2016-11-16,Montréal Canadiens,1,Atlantic,Eastern,28,2,34,0.8235294117647058,21,7,20,8
2016-17,2016-11-19,Montréal Canadiens,0,Atlantic,Eastern,28,2,36,0.7777777777777778,21,7,20,8
2016-17,2016-11-20,Montréal Canadiens,2,Atlantic,Eastern,30,2,38,0.7894736842105263,22,8,21,9
2016-17,2016-11-23,Montréal Canadiens,0,Atlantic,Eastern,30,2,40,0.75,23,7,22,8
2016-17,2016-11-25,Montréal Canadiens,2,Atlantic,Eastern,32,2,42,0.7619047619047619,25,7,23,9
2016-17,2016-11-27,Montréal Canadiens,2,Atlantic,Eastern,34,2,44,0.7727272727272727,27,7,25,9
2016-17,2016-11-30,Montréal Canadiens,0,Atlantic,Eastern,34,2,46,0.7391304347826086,27,7,25,9
2016-17,2016-12-03,Montréal Canadiens,0,Atlantic,Eastern,34,2,48,0.7083333333333334,29,5,28,6
2016-17,2016-12-04,Montréal Canadiens,2,Atlantic,Eastern,36,2,50,0.72,30,6,29,7
2016-17,2016-12-07,Montréal Canadiens,1,Atlantic,Eastern,37,2,52,0.7115384615384616,31,6,31,6
2016-17,2016-12-09,Montréal Canadiens,2,Atlantic,Eastern,39,2,54,0.7222222222222222,32,7,32,7
2016-17,2016-12-11,Montréal Canadiens,2,Atlantic,Eastern,41,2,56,0.7321428571428571,32,9,32,9
2016-17,2016-12-13,Montréal Canadiens,1,Atlantic,Eastern,42,2,58,0.7241379310344828,34,8,34,8
2016-17,2016-12-17,Montréal Canadiens,0,Atlantic,Eastern,42,2,60,0.7,35,7,35,7
2016-17,2016-12-18,Montréal Canadiens,2,Atlantic,Eastern,44,2,62,0.7096774193548387,37,7,37,7
2016-17,2016-12-21,Montréal Canadiens,2,Atlantic,Eastern,46,2,64,0.71875,37,9,37,9
2016-17,2016-12-23,Montréal Canadiens,0,Atlantic,Eastern,46,2,66,0.696969696969697,39,7,39,7
2016-17,2016-12-24,Montréal Canadiens,0,Atlantic,Eastern,46,2,68,0.6764705882352942,40,6,40,6
2016-17,2016-12-29,Montréal Canadiens,1,Atlantic,Eastern,47,2,70,0.6714285714285714,40,7,40,7
2016-17,2016-12-30,Montréal Canadiens,2,Atlantic,Eastern,49,2,72,0.6805555555555556,42,7,42,7
2016-17,2017-01-01,Montréal Canadiens,1,Atlantic,Eastern,50,2,74,0.6756756756756757,44,6,44,6
2016-17,2017-01-04,Montréal Canadiens,2,Atlantic,Eastern,52,2,76,0.6842105263157895,44,8,44,8
2016-17,2017-01-05,Montréal Canadiens,2,Atlantic,Eastern,54,2,78,0.6923076923076923,44,10,44,10
2016-17,2017-01-08,Montréal Canadiens,2,Atlantic,Eastern,56,2,80,0.7,44,12,44,12
2016-17,2017-01-10,Montréal Canadiens,0,Atlantic,Eastern,56,2,82,0.6829268292682927,46,10,46,10
2016-17,2017-01-12,Montréal Canadiens,2,Atlantic,Eastern,58,2,84,0.6904761904761905,46,12,46,12
2016-17,2017-01-13,Montréal Canadiens,0,Atlantic,Eastern,58,2,86,0.6744186046511628,48,10,48,10
2016-17,2017-01-15,Montréal Canadiens,2,Atlantic,Eastern,60,2,88,0.6818181818181818,48,12,49,11
2016-17,2017-01-16,Montréal Canadiens,0,Atlantic,Eastern,60,2,90,0.6666666666666666,48,12,49,11
2016-17,2017-01-19,Montréal Canadiens,0,Atlantic,Eastern,60,2,92,0.6521739130434783,50,10,50,10
2016-17,2017-01-21,Montréal Canadiens,2,Atlantic,Eastern,62,2,94,0.6595744680851063,52,10,50,12
2016-17,2017-01-22,Montréal Canadiens,1,Atlantic,Eastern,63,2,96,0.65625,52,11,52,11
2016-17,2017-01-25,Montréal Canadiens,2,Atlantic,Eastern,65,2,98,0.6632653061224489,54,11,53,12
2016-17,2017-01-27,Montréal Canadiens,0,Atlantic,Eastern,65,2,100,0.65,56,9,56,9
2016-17,2017-02-01,Montréal Canadiens,2,Atlantic,Eastern,67,2,102,0.6568627450980392,58,9,56,11
2016-17,2017-02-03,Montréal Canadiens,0,Atlantic,Eastern,67,2,104,0.6442307692307693,58,9,58,9
2016-17,2017-02-04,Montréal Canadiens,0,Atlantic,Eastern,67,2,106,0.6320754716981132,58,9,58,9
2016-17,2017-02-05,Montréal Canadiens,1,Atlantic,Eastern,68,2,108,0.6296296296296297,58,10,58,10
2016-17,2017-02-08,Montréal Canadiens,0,Atlantic,Eastern,68,2,110,0.6181818181818182,60,8,59,9
2016-17,2017-02-10,Montréal Canadiens,2,Atlantic,Eastern,70,2,112,0.625,61,9,60,10
2016-17,2017-02-12,Montréal Canadiens,0,Atlantic,Eastern,70,2,114,0.6140350877192983,62,8,61,9
2016-17,2017-02-13,Montréal Canadiens,0,Atlantic,Eastern,70,2,116,0.603448275862069,64,6,61,9
2016-17,2017-02-18,Montréal Canadiens,0,Atlantic,Eastern,70,2,118,0.5932203389830508,64,6,63,7
2016-17,2017-02-22,Montréal Canadiens,2,Atlantic,Eastern,72,2,120,0.6,67,5,66,6
2016-17,2017-02-24,Montréal Canadiens,0,Atlantic,Eastern,72,2,122,0.5901639344262295,68,4,68,4
2016-17,2017-02-26,Montréal Canadiens,2,Atlantic,Eastern,74,2,124,0.5967741935483871,70,4,69,5
2016-17,2017-02-28,Montréal Canadiens,2,Atlantic,Eastern,76,2,126,0.6031746031746031,70,6,69,7
2016-17,2017-03-01,Montréal Canadiens,2,Atlantic,Eastern,78,2,128,0.609375,72,6,69,9
2016-17,2017-03-03,Montréal Canadiens,2,Atlantic,Eastern,80,2,130,0.6153846153846154,72,8,70,10
2016-17,2017-03-05,Montréal Canadiens,2,Atlantic,Eastern,82,2,132,0.6212121212121212,74,8,71,11
2016-17,2017-03-08,Montréal Canadiens,2,Atlantic,Eastern,84,2,134,0.6268656716417911,74,10,73,11
2016-17,2017-03-10,Montréal Canadiens,0,Atlantic,Eastern,84,2,136,0.6176470588235294,76,8,75,9
2016-17,2017-03-12,Montréal Canadiens,2,Atlantic,Eastern,86,2,138,0.6231884057971014,78,8,76,10
2016-17,2017-03-14,Montréal Canadiens,0,Atlantic,Eastern,86,2,140,0.6142857142857143,80,6,77,9
2016-17,2017-03-18,Montréal Canadiens,2,Atlantic,Eastern,88,2,142,0.6197183098591549,82,6,79,9
2016-17,2017-03-19,Montréal Canadiens,2,Atlantic,Eastern,90,2,144,0.625,82,8,79,11
2016-17,2017-03-21,Montréal Canadiens,1,Atlantic,Eastern,91,2,146,0.6232876712328768,82,9,81,10
2016-17,2017-03-23,Montréal Canadiens,0,Atlantic,Eastern,91,2,148,0.6148648648648649,85,6,82,9
2016-17,2017-03-25,Montréal Canadiens,2,Atlantic,Eastern,93,2,150,0.62,85,8,84,9
2016-17,2017-03-28,Montréal Canadiens,2,Atlantic,Eastern,95,2,152,0.625,87,8,86,9
2016-17,2017-03-30,Montréal Canadiens,2,Atlantic,Eastern,97,2,154,0.6298701298701299,88,9,87,10
2016-17,2017-04-01,Montréal Canadiens,2,Atlantic,Eastern,99,2,156,0.6346153846153846,91,8,90,9
2016-17,2017-04-03,Montréal Canadiens,2,Atlantic,Eastern,101,2,158,0.6392405063291139,92,9,92,9
2016-17,2017-04-05,Montréal Canadiens,0,Atlantic,Eastern,101,2,160,0.63125,94,7,93,8
2016-17,2017-04-07,Montréal Canadiens,0,Atlantic,Eastern,101,2,162,0.6234567901234568,95,6,93,8
2016-17,2017-04-08,Montréal Canadiens,2,Atlantic,Eastern,103,2,164,0.6280487804878049,95,8,95,8
2016-17,2016-10-15,Nashville Predators,2,Central,Western,2,2,2,1.0,2,0,0,2
2016-17,2016-10-16,Nashville Predators,0,Central,Western,2,2,4,0.5,2,0,2,0
2016-17,2016-10-19,Nashville Predators,0,Central,Western,2,2,6,0.3333333333333333,4,-2,4,-2
2016-17,2016-10-21,Nashville Predators,0,Central,Western,2,2,8,0.25,6,-4,4,-2
2016-17,2016-10-23,Nashville Predators,2,Central,Western,4,2,10,0.4,6,-2,5,-1
2016-17,2016-10-27,Nashville Predators,0,Central,Western,4,2,12,0.3333333333333333,7,-3,7,-3
2016-17,2016-10-28,Nashville Predators,1,Central,Western,5,2,14,0.35714285714285715,9,-4,8,-3
2016-17,2016-10-30,Nashville Predators,0,Central,Western,5,2,16,0.3125,11,-6,8,-3
2016-17,2016-11-02,Nashville Predators,2,Central,Western,7,2,18,0.3888888888888889,12,-5,9,-2
2016-17,2016-11-04,Nashville Predators,1,Central,Western,8,2,20,0.4,12,-4,10,-2
2016-17,2016-11-06,Nashville Predators,1,Central,Western,9,2,22,0.4090909090909091,13,-4,11,-2
2016-17,2016-11-09,Nashville Predators,2,Central,Western,11,2,24,0.4583333333333333,13,-2,13,-2
2016-17,2016-11-11,Nashville Predators,2,Central,Western,13,2,26,0.5,15,-2,14,-1
2016-17,2016-11-13,Nashville Predators,2,Central,Western,15,2,28,0.5357142857142857,17,-2,16,-1
2016-17,2016-11-16,Nashville Predators,0,Central,Western,15,2,30,0.5,19,-4,17,-2
2016-17,2016-11-18,Nashville Predators,2,Central,Western,17,2,32,0.53125,20,-3,18,-1
2016-17,2016-11-20,Nashville Predators,0,Central,Western,17,2,34,0.5,20,-3,19,-2
2016-17,2016-11-22,Nashville Predators,2,Central,Western,19,2,36,0.5277777777777778,21,-2,20,-1
2016-17,2016-11-24,Nashville Predators,2,Central,Western,21,2,38,0.5526315789473685,22,-1,21,0
2016-17,2016-11-25,Nashville Predators,2,Central,Western,23,2,40,0.575,24,-1,22,1
2016-17,2016-11-27,Nashville Predators,0,Central,Western,23,2,42,0.5476190476190477,25,-2,23,0
2016-17,2016-11-30,Nashville Predators,2,Central,Western,25,2,44,0.5681818181818182,25,0,25,0
2016-17,2016-12-03,Nashville Predators,1,Central,Western,26,2,46,0.5652173913043478,26,0,26,0
2016-17,2016-12-04,Nashville Predators,0,Central,Western,26,2,48,0.5416666666666666,26,0,26,0
2016-17,2016-12-07,Nashville Predators,2,Central,Western,28,2,50,0.56,29,-1,28,0
2016-17,2016-12-09,Nashville Predators,0,Central,Western,28,2,52,0.5384615384615384,30,-2,29,-1
2016-17,2016-12-11,Nashville Predators,0,Central,Western,28,2,54,0.5185185185185185,34,-6,30,-2
2016-17,2016-12-14,Nashville Predators,2,Central,Western,30,2,56,0.5357142857142857,36,-6,30,0
2016-17,2016-12-16,Nashville Predators,0,Central,Western,30,2,58,0.5172413793103449,38,-8,32,-2
2016-17,2016-12-18,Nashville Predators,1,Central,Western,31,2,60,0.5166666666666667,38,-7,34,-3
2016-17,2016-12-20,Nashville Predators,2,Central,Western,33,2,62,0.532258064516129,39,-6,34,-1
2016-17,2016-12-21,Nashville Predators,2,Central,Western,35,2,64,0.546875,41,-6,35,0
2016-17,2016-12-23,Nashville Predators,0,Central,Western,35,2,66,0.5303030303030303,41,-6,36,-1
2016-17,2016-12-28,Nashville Predators,1,Central,Western,36,2,68,0.5294117647058824,41,-5,38,-2
2016-17,2016-12-30,Nashville Predators,0,Central,Western,36,2,70,0.5142857142857142,43,-7,39,-3
2016-17,2016-12-31,Nashville Predators,2,Central,Western,38,2,72,0.5277777777777778,43,-5,39,-1
2016-17,2017-01-04,Nashville Predators,1,Central,Western,39,2,74,0.527027027027027,45,-6,42,-3
2016-17,2017-01-06,Nashville Predators,2,Central,Western,41,2,76,0.5394736842105263,45,-4,42,-1
2016-17,2017-01-07,Nashville Predators,0,Central,Western,41,2,78,0.5256410256410257,45,-4,44,-3
2016-17,2017-01-09,Nashville Predators,0,Central,Western,41,2,80,0.5125,47,-6,44,-3
2016-17,2017-01-11,Nashville Predators,2,Central,Western,43,2,82,0.524390243902439,47,-4,44,-1
2016-17,2017-01-13,Nashville Predators,2,Central,Western,45,2,84,0.5357142857142857,47,-2,46,-1
2016-17,2017-01-14,Nashville Predators,2,Central,Western,47,2,86,0.5465116279069767,47,0,47,0
2016-17,2017-01-18,Nashville Predators,0,Central,Western,47,2,88,0.5340909090909091,51,-4,48,-1
2016-17,2017-01-20,Nashville Predators,2,Central,Western,49,2,90,0.5444444444444444,51,-2,49,0
2016-17,2017-01-21,Nashville Predators,2,Central,Western,51,2,92,0.5543478260869565,51,0,51,0
2016-17,2017-01-23,Nashville Predators,2,Central,Western,53,2,94,0.5638297872340425,53,0,51,2
2016-17,2017-01-25,Nashville Predators,1,Central,Western,54,2,96,0.5625,54,0,51,3
2016-17,2017-01-27,Nashville Predators,2,Central,Western,56,2,98,0.5714285714285714,56,0,53,3
2016-17,2017-02-01,Nashville Predators,0,Central,Western,56,2,100,0.56,56,0,53,3
2016-17,2017-02-03,Nashville Predators,2,Central,Western,58,2,102,0.5686274509803921,58,0,55,3
2016-17,2017-02-05,Nashville Predators,0,Central,Western,58,2,104,0.5576923076923077,58,0,57,1
2016-17,2017-02-08,Nashville Predators,2,Central,Western,60,2,106,0.5660377358490566,60,0,59,1
2016-17,2017-02-10,Nashville Predators,0,Central,Western,60,2,108,0.5555555555555556,61,-1,60,0
2016-17,2017-02-11,Nashville Predators,0,Central,Western,60,2,110,0.5454545454545454,61,-1,60,0
2016-17,2017-02-12,Nashville Predators,2,Central,Western,62,2,112,0.5535714285714286,63,-1,60,2
2016-17,2017-02-19,Nashville Predators,0,Central,Western,62,2,114,0.543859649122807,67,-5,62,0
2016-17,2017-02-19,Nashville Predators,2,Central,Western,64,2,116,0.5517241379310345,67,-3,62,2
2016-17,2017-02-22,Nashville Predators,1,Central,Western,65,2,118,0.5508474576271186,67,-2,64,1
2016-17,2017-02-24,Nashville Predators,2,Central,Western,67,2,120,0.5583333333333333,67,0,66,1
2016-17,2017-02-25,Nashville Predators,2,Central,Western,69,2,122,0.5655737704918032,69,0,67,2
2016-17,2017-02-26,Nashville Predators,2,Central,Western,71,2,124,0.5725806451612904,71,0,67,4
2016-17,2017-03-01,Nashville Predators,2,Central,Western,73,2,126,0.5793650793650794,73,0,67,6
2016-17,2017-03-03,Nashville Predators,0,Central,Western,73,2,128,0.5703125,73,0,68,5
2016-17,2017-03-05,Nashville Predators,0,Central,Western,73,2,130,0.5615384615384615,73,0,68,5
2016-17,2017-03-08,Nashville Predators,1,Central,Western,74,2,132,0.5606060606060606,74,0,71,3
2016-17,2017-03-10,Nashville Predators,1,Central,Western,75,2,134,0.5597014925373134,75,0,71,4
2016-17,2017-03-11,Nashville Predators,2,Central,Western,77,2,136,0.5661764705882353,77,0,73,4
2016-17,2017-03-14,Nashville Predators,2,Central,Western,79,2,138,0.572463768115942,79,0,77,2
2016-17,2017-03-16,Nashville Predators,2,Central,Western,81,2,140,0.5785714285714286,81,0,77,4
2016-17,2017-03-18,Nashville Predators,0,Central,Western,81,2,142,0.5704225352112676,81,0,79,2
2016-17,2017-03-21,Nashville Predators,2,Central,Western,83,2,144,0.5763888888888888,83,0,81,2
2016-17,2017-03-24,Nashville Predators,2,Central,Western,85,2,146,0.5821917808219178,85,0,85,0
2016-17,2017-03-26,Nashville Predators,2,Central,Western,87,2,148,0.5878378378378378,87,0,86,1
2016-17,2017-03-27,Nashville Predators,2,Central,Western,89,2,150,0.5933333333333334,89,0,86,3
2016-17,2017-03-28,Nashville Predators,0,Central,Western,89,2,152,0.5855263157894737,89,0,88,1
2016-17,2017-03-31,Nashville Predators,0,Central,Western,89,2,154,0.577922077922078,90,-1,89,0
2016-17,2017-04-01,Nashville Predators,2,Central,Western,91,2,156,0.5833333333333334,91,0,91,0
2016-17,2017-04-02,Nashville Predators,0,Central,Western,91,2,158,0.5759493670886076,93,-2,91,0
2016-17,2017-04-05,Nashville Predators,1,Central,Western,92,2,160,0.575,93,-1,92,0
2016-17,2017-04-07,Nashville Predators,2,Central,Western,94,2,162,0.5802469135802469,95,-1,94,0
2016-17,2017-04-08,Nashville Predators,0,Central,Western,94,2,164,0.573170731707317,97,-3,94,0
2016-17,2016-10-13,New Jersey Devils,1,Metropolitan,Eastern,1,2,2,0.5,0,1,1,0
2016-17,2016-10-15,New Jersey Devils,0,Metropolitan,Eastern,1,2,4,0.25,2,-1,2,-1
2016-17,2016-10-18,New Jersey Devils,2,Metropolitan,Eastern,3,2,6,0.5,4,-1,4,-1
2016-17,2016-10-20,New Jersey Devils,0,Metropolitan,Eastern,3,2,8,0.375,4,-1,4,-1
2016-17,2016-10-22,New Jersey Devils,2,Metropolitan,Eastern,5,2,10,0.5,6,-1,6,-1
2016-17,2016-10-25,New Jersey Devils,2,Metropolitan,Eastern,7,2,12,0.5833333333333334,7,0,7,0
2016-17,2016-10-28,New Jersey Devils,1,Metropolitan,Eastern,8,2,14,0.5714285714285714,8,0,7,1
2016-17,2016-10-29,New Jersey Devils,2,Metropolitan,Eastern,10,2,16,0.625,10,0,8,2
2016-17,2016-11-03,New Jersey Devils,1,Metropolitan,Eastern,11,2,18,0.6111111111111112,15,-4,13,-2
2016-17,2016-11-05,New Jersey Devils,0,Metropolitan,Eastern,11,2,20,0.55,16,-5,13,-2
2016-17,2016-11-06,New Jersey Devils,2,Metropolitan,Eastern,13,2,22,0.5909090909090909,17,-4,13,0
2016-17,2016-11-09,New Jersey Devils,2,Metropolitan,Eastern,15,2,24,0.625,17,-2,14,1
2016-17,2016-11-12,New Jersey Devils,2,Metropolitan,Eastern,17,2,26,0.6538461538461539,19,-2,17,0
2016-17,2016-11-13,New Jersey Devils,2,Metropolitan,Eastern,19,2,28,0.6785714285714286,19,0,17,2
2016-17,2016-11-16,New Jersey Devils,2,Metropolitan,Eastern,21,2,30,0.7,21,0,20,1
2016-17,2016-11-18,New Jersey Devils,0,Metropolitan,Eastern,21,2,32,0.65625,22,-1,20,1
2016-17,2016-11-19,New Jersey Devils,0,Metropolitan,Eastern,21,2,34,0.6176470588235294,24,-3,20,1
2016-17,2016-11-22,New Jersey Devils,0,Metropolitan,Eastern,21,2,36,0.5833333333333334,24,-3,21,0
2016-17,2016-11-24,New Jersey Devils,2,Metropolitan,Eastern,23,2,38,0.6052631578947368,26,-3,23,0
2016-17,2016-11-26,New Jersey Devils,1,Metropolitan,Eastern,24,2,40,0.6,27,-3,24,0
2016-17,2016-11-27,New Jersey Devils,1,Metropolitan,Eastern,25,2,42,0.5952380952380952,28,-3,25,0
2016-17,2016-11-30,New Jersey Devils,0,Metropolitan,Eastern,25,2,44,0.5681818181818182,28,-3,25,0
2016-17,2016-12-02,New Jersey Devils,1,Metropolitan,Eastern,26,2,46,0.5652173913043478,30,-4,27,-1
2016-17,2016-12-03,New Jersey Devils,2,Metropolitan,Eastern,28,2,48,0.5833333333333334,30,-2,28,0
2016-17,2016-12-07,New Jersey Devils,2,Metropolitan,Eastern,30,2,50,0.6,34,-4,31,-1
2016-17,2016-12-09,New Jersey Devils,0,Metropolitan,Eastern,30,2,52,0.5769230769230769,35,-5,32,-2
2016-17,2016-12-10,New Jersey Devils,0,Metropolitan,Eastern,30,2,54,0.5555555555555556,37,-7,32,-2
2016-17,2016-12-12,New Jersey Devils,0,Metropolitan,Eastern,30,2,56,0.5357142857142857,39,-9,32,-2
2016-17,2016-12-16,New Jersey Devils,0,Metropolitan,Eastern,30,2,58,0.5172413793103449,41,-11,35,-5
2016-17,2016-12-18,New Jersey Devils,0,Metropolitan,Eastern,30,2,60,0.5,44,-14,37,-7
2016-17,2016-12-19,New Jersey Devils,1,Metropolitan,Eastern,31,2,62,0.5,44,-13,37,-6
2016-17,2016-12-21,New Jersey Devils,0,Metropolitan,Eastern,31,2,64,0.484375,46,-15,37,-6
2016-17,2016-12-23,New Jersey Devils,2,Metropolitan,Eastern,33,2,66,0.5,47,-14,39,-6
2016-17,2016-12-24,New Jersey Devils,0,Metropolitan,Eastern,33,2,68,0.4852941176470588,47,-14,40,-7
2016-17,2016-12-28,New Jersey Devils,0,Metropolitan,Eastern,33,2,70,0.4714285714285714,49,-16,40,-7
2016-17,2016-12-30,New Jersey Devils,2,Metropolitan,Eastern,35,2,72,0.4861111111111111,51,-16,42,-7
2016-17,2016-12-31,New Jersey Devils,0,Metropolitan,Eastern,35,2,74,0.47297297297297297,51,-16,44,-9
2016-17,2017-01-03,New Jersey Devils,2,Metropolitan,Eastern,37,2,76,0.4868421052631579,53,-16,44,-7
2016-17,2017-01-04,New Jersey Devils,2,Metropolitan,Eastern,39,2,78,0.5,53,-14,44,-5
2016-17,2017-01-07,New Jersey Devils,0,Metropolitan,Eastern,39,2,80,0.4875,55,-16,44,-5
2016-17,2017-01-08,New Jersey Devils,1,Metropolitan,Eastern,40,2,82,0.4878048780487805,57,-17,44,-4
2016-17,2017-01-10,New Jersey Devils,0,Metropolitan,Eastern,40,2,84,0.47619047619047616,57,-17,46,-6
2016-17,2017-01-13,New Jersey Devils,1,Metropolitan,Eastern,41,2,86,0.47674418604651164,57,-16,48,-7
2016-17,2017-01-14,New Jersey Devils,2,Metropolitan,Eastern,43,2,88,0.48863636363636365,57,-14,48,-5
2016-17,2017-01-16,New Jersey Devils,2,Metropolitan,Eastern,45,2,90,0.5,57,-12,49,-4
2016-17,2017-01-18,New Jersey Devils,2,Metropolitan,Eastern,47,2,92,0.5108695652173914,59,-12,50,-3
2016-17,2017-01-21,New Jersey Devils,0,Metropolitan,Eastern,47,2,94,0.5,63,-16,50,-3
2016-17,2017-01-22,New Jersey Devils,2,Metropolitan,Eastern,49,2,96,0.5104166666666666,65,-16,52,-3
2016-17,2017-01-25,New Jersey Devils,0,Metropolitan,Eastern,49,2,98,0.5,65,-16,53,-4
2016-17,2017-01-27,New Jersey Devils,0,Metropolitan,Eastern,49,2,100,0.49,65,-16,56,-7
2016-17,2017-02-01,New Jersey Devils,2,Metropolitan,Eastern,51,2,102,0.5,67,-16,56,-5
2016-17,2017-02-04,New Jersey Devils,1,Metropolitan,Eastern,52,2,104,0.5,69,-17,58,-6
2016-17,2017-02-05,New Jersey Devils,2,Metropolitan,Eastern,54,2,106,0.5094339622641509,71,-17,58,-4
2016-17,2017-02-07,New Jersey Devils,2,Metropolitan,Eastern,56,2,108,0.5185185185185185,71,-15,58,-2
2016-17,2017-02-12,New Jersey Devils,0,Metropolitan,Eastern,56,2,110,0.509090909090909,75,-19,61,-5
2016-17,2017-02-15,New Jersey Devils,2,Metropolitan,Eastern,58,2,112,0.5178571428571429,75,-17,63,-5
2016-17,2017-02-17,New Jersey Devils,0,Metropolitan,Eastern,58,2,114,0.5087719298245614,77,-19,63,-5
2016-17,2017-02-19,New Jersey Devils,0,Metropolitan,Eastern,58,2,116,0.5,79,-21,64,-6
2016-17,2017-02-19,New Jersey Devils,2,Metropolitan,Eastern,60,2,118,0.5084745762711864,79,-19,64,-4
2016-17,2017-02-22,New Jersey Devils,0,Metropolitan,Eastern,60,2,120,0.5,79,-19,66,-6
2016-17,2017-02-25,New Jersey Devils,1,Metropolitan,Eastern,61,2,122,0.5,82,-21,68,-7
2016-17,2017-02-28,New Jersey Devils,1,Metropolitan,Eastern,62,2,124,0.5,83,-21,69,-7
2016-17,2017-03-03,New Jersey Devils,0,Metropolitan,Eastern,62,2,126,0.49206349206349204,84,-22,70,-8
2016-17,2017-03-05,New Jersey Devils,0,Metropolitan,Eastern,62,2,128,0.484375,86,-24,71,-9
2016-17,2017-03-05,New Jersey Devils,0,Metropolitan,Eastern,62,2,130,0.47692307692307695,86,-24,71,-9
2016-17,2017-03-08,New Jersey Devils,0,Metropolitan,Eastern,62,2,132,0.4696969696969697,88,-26,73,-11
2016-17,2017-03-10,New Jersey Devils,0,Metropolitan,Eastern,62,2,134,0.4626865671641791,90,-28,75,-13
2016-17,2017-03-12,New Jersey Devils,0,Metropolitan,Eastern,62,2,136,0.45588235294117646,92,-30,76,-14
2016-17,2017-03-16,New Jersey Devils,2,Metropolitan,Eastern,64,2,138,0.463768115942029,95,-31,78,-14
2016-17,2017-03-17,New Jersey Devils,0,Metropolitan,Eastern,64,2,140,0.45714285714285713,96,-32,78,-14
2016-17,2017-03-19,New Jersey Devils,0,Metropolitan,Eastern,64,2,142,0.4507042253521127,99,-35,79,-15
2016-17,2017-03-21,New Jersey Devils,2,Metropolitan,Eastern,66,2,144,0.4583333333333333,100,-34,81,-15
2016-17,2017-03-23,New Jersey Devils,0,Metropolitan,Eastern,66,2,146,0.4520547945205479,101,-35,82,-16
2016-17,2017-03-25,New Jersey Devils,0,Metropolitan,Eastern,66,2,148,0.44594594594594594,103,-37,84,-18
2016-17,2017-03-26,New Jersey Devils,1,Metropolitan,Eastern,67,2,150,0.44666666666666666,103,-36,84,-17
2016-17,2017-03-28,New Jersey Devils,1,Metropolitan,Eastern,68,2,152,0.4473684210526316,103,-35,86,-18
2016-17,2017-03-31,New Jersey Devils,0,Metropolitan,Eastern,68,2,154,0.44155844155844154,105,-37,88,-20
2016-17,2017-04-01,New Jersey Devils,0,Metropolitan,Eastern,68,2,156,0.4358974358974359,105,-37,90,-22
2016-17,2017-04-04,New Jersey Devils,2,Metropolitan,Eastern,70,2,158,0.4430379746835443,106,-36,93,-23
2016-17,2017-04-06,New Jersey Devils,0,Metropolitan,Eastern,70,2,160,0.4375,106,-36,93,-23
2016-17,2017-04-08,New Jersey Devils,0,Metropolitan,Eastern,70,2,162,0.43209876543209874,106,-36,95,-25
2016-17,2017-04-09,New Jersey Devils,0,Metropolitan,Eastern,70,2,164,0.4268292682926829,108,-38,95,-25
2016-17,2016-10-13,New York Islanders,0,Metropolitan,Eastern,0,2,2,0.0,0,0,1,-1
2016-17,2016-10-15,New York Islanders,0,Metropolitan,Eastern,0,2,4,0.0,2,-2,2,-2
2016-17,2016-10-16,New York Islanders,2,Metropolitan,Eastern,2,2,6,0.3333333333333333,3,-1,3,-1
2016-17,2016-10-18,New York Islanders,0,Metropolitan,Eastern,2,2,8,0.25,4,-2,4,-2
2016-17,2016-10-21,New York Islanders,2,Metropolitan,Eastern,4,2,10,0.4,4,0,5,-1
2016-17,2016-10-23,New York Islanders,2,Metropolitan,Eastern,6,2,12,0.5,7,-1,6,0
2016-17,2016-10-26,New York Islanders,0,Metropolitan,Eastern,6,2,14,0.42857142857142855,7,-1,7,-1
2016-17,2016-10-27,New York Islanders,0,Metropolitan,Eastern,6,2,16,0.375,7,-1,7,-1
2016-17,2016-10-30,New York Islanders,2,Metropolitan,Eastern,8,2,18,0.4444444444444444,10,-2,9,-1
2016-17,2016-11-01,New York Islanders,0,Metropolitan,Eastern,8,2,20,0.4,11,-3,10,-2
2016-17,2016-11-03,New York Islanders,1,Metropolitan,Eastern,9,2,22,0.4090909090909091,15,-6,13,-4
2016-17,2016-11-05,New York Islanders,1,Metropolitan,Eastern,10,2,24,0.4166666666666667,16,-6,13,-3
2016-17,2016-11-08,New York Islanders,2,Metropolitan,Eastern,12,2,26,0.46153846153846156,17,-5,13,-1
2016-17,2016-11-11,New York Islanders,0,Metropolitan,Eastern,12,2,28,0.42857142857142855,17,-5,16,-4
2016-17,2016-11-13,New York Islanders,1,Metropolitan,Eastern,13,2,30,0.43333333333333335,19,-6,17,-4
2016-17,2016-11-15,New York Islanders,0,Metropolitan,Eastern,13,2,32,0.40625,19,-6,19,-6
2016-17,2016-11-19,New York Islanders,1,Metropolitan,Eastern,14,2,34,0.4117647058823529,24,-10,20,-6
2016-17,2016-11-23,New York Islanders,2,Metropolitan,Eastern,16,2,36,0.4444444444444444,24,-8,22,-6
2016-17,2016-11-24,New York Islanders,0,Metropolitan,Eastern,16,2,38,0.42105263157894735,26,-10,23,-7
2016-17,2016-11-25,New York Islanders,0,Metropolitan,Eastern,16,2,40,0.4,27,-11,23,-7
2016-17,2016-11-29,New York Islanders,2,Metropolitan,Eastern,18,2,42,0.42857142857142855,28,-10,25,-7
2016-17,2016-12-01,New York Islanders,2,Metropolitan,Eastern,20,2,44,0.45454545454545453,28,-8,25,-5
2016-17,2016-12-02,New York Islanders,2,Metropolitan,Eastern,22,2,46,0.4782608695652174,30,-8,27,-5
2016-17,2016-12-04,New York Islanders,1,Metropolitan,Eastern,23,2,48,0.4791666666666667,32,-9,29,-6
2016-17,2016-12-07,New York Islanders,2,Metropolitan,Eastern,25,2,50,0.5,34,-9,31,-6
2016-17,2016-12-09,New York Islanders,2,Metropolitan,Eastern,27,2,52,0.5192307692307693,35,-8,32,-5
2016-17,2016-12-11,New York Islanders,0,Metropolitan,Eastern,27,2,54,0.5,39,-12,32,-5
2016-17,2016-12-14,New York Islanders,0,Metropolitan,Eastern,27,2,56,0.48214285714285715,40,-13,34,-7
2016-17,2016-12-16,New York Islanders,0,Metropolitan,Eastern,27,2,58,0.46551724137931033,41,-14,35,-8
2016-17,2016-12-17,New York Islanders,1,Metropolitan,Eastern,28,2,60,0.4666666666666667,42,-14,35,-7
2016-17,2016-12-19,New York Islanders,0,Metropolitan,Eastern,28,2,62,0.45161290322580644,44,-16,37,-9
2016-17,2016-12-21,New York Islanders,2,Metropolitan,Eastern,30,2,64,0.46875,46,-16,37,-7
2016-17,2016-12-24,New York Islanders,2,Metropolitan,Eastern,32,2,66,0.48484848484848486,47,-15,40,-8
2016-17,2016-12-28,New York Islanders,2,Metropolitan,Eastern,34,2,68,0.5,49,-15,40,-6
2016-17,2016-12-30,New York Islanders,0,Metropolitan,Eastern,34,2,70,0.4857142857142857,51,-17,42,-8
2016-17,2017-01-01,New York Islanders,2,Metropolitan,Eastern,36,2,72,0.5,53,-17,44,-8
2016-17,2017-01-07,New York Islanders,1,Metropolitan,Eastern,37,2,74,0.5,55,-18,44,-7
2016-17,2017-01-08,New York Islanders,1,Metropolitan,Eastern,38,2,76,0.5,57,-19,44,-6
2016-17,2017-01-12,New York Islanders,0,Metropolitan,Eastern,38,2,78,0.48717948717948717,57,-19,46,-8
2016-17,2017-01-14,New York Islanders,2,Metropolitan,Eastern,40,2,80,0.5,57,-17,48,-8
2016-17,2017-01-15,New York Islanders,0,Metropolitan,Eastern,40,2,82,0.4878048780487805,57,-17,49,-9
2016-17,2017-01-16,New York Islanders,2,Metropolitan,Eastern,42,2,84,0.5,57,-15,49,-7
2016-17,2017-01-20,New York Islanders,2,Metropolitan,Eastern,44,2,86,0.5116279069767442,61,-17,50,-6
2016-17,2017-01-22,New York Islanders,1,Metropolitan,Eastern,45,2,88,0.5113636363636364,65,-20,52,-7
2016-17,2017-01-22,New York Islanders,2,Metropolitan,Eastern,47,2,90,0.5222222222222223,65,-18,52,-5
2016-17,2017-01-25,New York Islanders,2,Metropolitan,Eastern,49,2,92,0.532608695652174,65,-16,53,-4
2016-17,2017-01-27,New York Islanders,2,Metropolitan,Eastern,51,2,94,0.5425531914893617,65,-14,56,-5
2016-17,2017-02-01,New York Islanders,2,Metropolitan,Eastern,53,2,96,0.5520833333333334,67,-14,56,-3
2016-17,2017-02-04,New York Islanders,0,Metropolitan,Eastern,53,2,98,0.5408163265306123,69,-16,58,-5
2016-17,2017-02-05,New York Islanders,1,Metropolitan,Eastern,54,2,100,0.54,71,-17,58,-4
2016-17,2017-02-07,New York Islanders,2,Metropolitan,Eastern,56,2,102,0.5490196078431373,71,-15,58,-2
2016-17,2017-02-10,New York Islanders,2,Metropolitan,Eastern,58,2,104,0.5576923076923077,73,-15,60,-2
2016-17,2017-02-11,New York Islanders,0,Metropolitan,Eastern,58,2,106,0.5471698113207547,74,-16,61,-3
2016-17,2017-02-12,New York Islanders,2,Metropolitan,Eastern,60,2,108,0.5555555555555556,75,-15,61,-1
2016-17,2017-02-15,New York Islanders,0,Metropolitan,Eastern,60,2,110,0.5454545454545454,75,-15,63,-3
2016-17,2017-02-17,New York Islanders,2,Metropolitan,Eastern,62,2,112,0.5535714285714286,77,-15,63,-1
2016-17,2017-02-19,New York Islanders,2,Metropolitan,Eastern,64,2,114,0.5614035087719298,79,-15,64,0
2016-17,2017-02-19,New York Islanders,0,Metropolitan,Eastern,64,2,116,0.5517241379310345,79,-15,64,0
2016-17,2017-02-22,New York Islanders,2,Metropolitan,Eastern,66,2,118,0.559322033898305,79,-13,66,0
2016-17,2017-02-24,New York Islanders,2,Metropolitan,Eastern,68,2,120,0.5666666666666667,80,-12,68,0
2016-17,2017-02-25,New York Islanders,0,Metropolitan,Eastern,68,2,122,0.5573770491803278,82,-14,68,0
2016-17,2017-03-03,New York Islanders,2,Metropolitan,Eastern,70,2,124,0.5645161290322581,84,-14,70,0
2016-17,2017-03-04,New York Islanders,1,Metropolitan,Eastern,71,2,126,0.5634920634920635,86,-15,71,0
2016-17,2017-03-05,New York Islanders,0,Metropolitan,Eastern,71,2,128,0.5546875,86,-15,71,0
2016-17,2017-03-08,New York Islanders,2,Metropolitan,Eastern,73,2,130,0.5615384615384615,88,-15,73,0
2016-17,2017-03-10,New York Islanders,2,Metropolitan,Eastern,75,2,132,0.5681818181818182,90,-15,75,0
2016-17,2017-03-12,New York Islanders,0,Metropolitan,Eastern,75,2,134,0.5597014925373134,92,-17,76,-1
2016-17,2017-03-13,New York Islanders,0,Metropolitan,Eastern,75,2,136,0.5514705882352942,94,-19,76,-1
2016-17,2017-03-14,New York Islanders,2,Metropolitan,Eastern,77,2,138,0.5579710144927537,94,-17,77,0
2016-17,2017-03-16,New York Islanders,0,Metropolitan,Eastern,77,2,140,0.55,95,-18,78,-1
2016-17,2017-03-18,New York Islanders,1,Metropolitan,Eastern,78,2,142,0.5492957746478874,97,-19,79,-1
2016-17,2017-03-23,New York Islanders,2,Metropolitan,Eastern,80,2,144,0.5555555555555556,101,-21,82,-2
2016-17,2017-03-24,New York Islanders,2,Metropolitan,Eastern,82,2,146,0.5616438356164384,101,-19,82,0
2016-17,2017-03-25,New York Islanders,0,Metropolitan,Eastern,82,2,148,0.5540540540540541,103,-21,84,-2
2016-17,2017-03-27,New York Islanders,0,Metropolitan,Eastern,82,2,150,0.5466666666666666,103,-21,84,-2
2016-17,2017-03-30,New York Islanders,0,Metropolitan,Eastern,82,2,152,0.5394736842105263,103,-21,87,-5
2016-17,2017-03-31,New York Islanders,2,Metropolitan,Eastern,84,2,154,0.5454545454545454,105,-21,88,-4
2016-17,2017-04-02,New York Islanders,2,Metropolitan,Eastern,86,2,156,0.5512820512820513,106,-20,91,-5
2016-17,2017-04-05,New York Islanders,2,Metropolitan,Eastern,88,2,158,0.5569620253164557,106,-18,93,-5
2016-17,2017-04-06,New York Islanders,2,Metropolitan,Eastern,90,2,160,0.5625,106,-16,93,-3
2016-17,2017-04-08,New York Islanders,2,Metropolitan,Eastern,92,2,162,0.5679012345679012,106,-14,95,-3
2016-17,2017-04-09,New York Islanders,2,Metropolitan,Eastern,94,2,164,0.573170731707317,108,-14,95,-1
2016-17,2016-10-13,New York Rangers,2,Metropolitan,Eastern,2,2,2,1.0,0,2,1,1
2016-17,2016-10-16,New York Rangers,0,Metropolitan,Eastern,2,2,4,0.5,3,-1,3,-1
2016-17,2016-10-17,New York Rangers,2,Metropolitan,Eastern,4,2,6,0.6666666666666666,3,1,3,1
2016-17,2016-10-20,New York Rangers,0,Metropolitan,Eastern,4,2,8,0.5,4,0,4,0
2016-17,2016-10-22,New York Rangers,2,Metropolitan,Eastern,6,2,10,0.6,6,0,6,0
2016-17,2016-10-23,New York Rangers,2,Metropolitan,Eastern,8,2,12,0.6666666666666666,7,1,6,2
2016-17,2016-10-27,New York Rangers,2,Metropolitan,Eastern,10,2,14,0.7142857142857143,7,3,7,3
2016-17,2016-10-28,New York Rangers,0,Metropolitan,Eastern,10,2,16,0.625,8,2,7,3
2016-17,2016-10-30,New York Rangers,2,Metropolitan,Eastern,12,2,18,0.6666666666666666,10,2,9,3
2016-17,2016-11-01,New York Rangers,2,Metropolitan,Eastern,14,2,20,0.7,11,3,10,4
2016-17,2016-11-03,New York Rangers,2,Metropolitan,Eastern,16,2,22,0.7272727272727273,15,1,13,3
2016-17,2016-11-05,New York Rangers,2,Metropolitan,Eastern,18,2,24,0.75,16,2,13,5
2016-17,2016-11-07,New York Rangers,2,Metropolitan,Eastern,20,2,26,0.7692307692307693,17,3,13,7
2016-17,2016-11-09,New York Rangers,0,Metropolitan,Eastern,20,2,28,0.7142857142857143,17,3,14,6
2016-17,2016-11-13,New York Rangers,2,Metropolitan,Eastern,22,2,30,0.7333333333333333,19,3,17,5
2016-17,2016-11-14,New York Rangers,2,Metropolitan,Eastern,24,2,32,0.75,19,5,17,7
2016-17,2016-11-16,New York Rangers,2,Metropolitan,Eastern,26,2,34,0.7647058823529411,21,5,20,6
2016-17,2016-11-19,New York Rangers,0,Metropolitan,Eastern,26,2,36,0.7222222222222222,24,2,20,6
2016-17,2016-11-21,New York Rangers,1,Metropolitan,Eastern,27,2,38,0.7105263157894737,24,3,21,6
2016-17,2016-11-22,New York Rangers,2,Metropolitan,Eastern,29,2,40,0.725,24,5,21,8
2016-17,2016-11-24,New York Rangers,0,Metropolitan,Eastern,29,2,42,0.6904761904761905,26,3,23,6
2016-17,2016-11-25,New York Rangers,2,Metropolitan,Eastern,31,2,44,0.7045454545454546,27,4,23,8
2016-17,2016-11-28,New York Rangers,0,Metropolitan,Eastern,31,2,46,0.6739130434782609,28,3,25,6
2016-17,2016-11-30,New York Rangers,2,Metropolitan,Eastern,33,2,48,0.6875,28,5,25,8
2016-17,2016-12-02,New York Rangers,0,Metropolitan,Eastern,33,2,50,0.66,30,3,27,6
2016-17,2016-12-03,New York Rangers,2,Metropolitan,Eastern,35,2,52,0.6730769230769231,30,5,28,7
2016-17,2016-12-07,New York Rangers,0,Metropolitan,Eastern,35,2,54,0.6481481481481481,34,1,31,4
2016-17,2016-12-09,New York Rangers,2,Metropolitan,Eastern,37,2,56,0.6607142857142857,35,2,32,5
2016-17,2016-12-10,New York Rangers,2,Metropolitan,Eastern,39,2,58,0.6724137931034483,37,2,32,7
2016-17,2016-12-12,New York Rangers,2,Metropolitan,Eastern,41,2,60,0.6833333333333333,39,2,32,9
2016-17,2016-12-14,New York Rangers,0,Metropolitan,Eastern,41,2,62,0.6612903225806451,40,1,34,7
2016-17,2016-12-16,New York Rangers,2,Metropolitan,Eastern,43,2,64,0.671875,41,2,35,8
2016-17,2016-12-18,New York Rangers,2,Metropolitan,Eastern,45,2,66,0.6818181818181818,44,1,37,8
2016-17,2016-12-19,New York Rangers,2,Metropolitan,Eastern,47,2,68,0.6911764705882353,44,3,37,10
2016-17,2016-12-21,New York Rangers,0,Metropolitan,Eastern,47,2,70,0.6714285714285714,46,1,37,10
2016-17,2016-12-24,New York Rangers,0,Metropolitan,Eastern,47,2,72,0.6527777777777778,47,0,40,7
2016-17,2016-12-28,New York Rangers,2,Metropolitan,Eastern,49,2,74,0.6621621621621622,49,0,40,9
2016-17,2016-12-30,New York Rangers,2,Metropolitan,Eastern,51,2,76,0.6710526315789473,51,0,42,9
2016-17,2017-01-01,New York Rangers,2,Metropolitan,Eastern,53,2,78,0.6794871794871795,53,0,44,9
2016-17,2017-01-04,New York Rangers,0,Metropolitan,Eastern,53,2,80,0.6625,53,0,44,9
2016-17,2017-01-05,New York Rangers,2,Metropolitan,Eastern,55,2,82,0.6707317073170732,55,0,44,11
2016-17,2017-01-08,New York Rangers,2,Metropolitan,Eastern,57,2,84,0.6785714285714286,57,0,44,13
2016-17,2017-01-14,New York Rangers,0,Metropolitan,Eastern,57,2,86,0.6627906976744186,57,0,48,9
2016-17,2017-01-15,New York Rangers,0,Metropolitan,Eastern,57,2,88,0.6477272727272727,57,0,49,8
2016-17,2017-01-18,New York Rangers,0,Metropolitan,Eastern,57,2,90,0.6333333333333333,59,-2,50,7
2016-17,2017-01-20,New York Rangers,2,Metropolitan,Eastern,59,2,92,0.6413043478260869,61,-2,50,9
2016-17,2017-01-22,New York Rangers,2,Metropolitan,Eastern,61,2,94,0.648936170212766,65,-4,52,9
2016-17,2017-01-24,New York Rangers,2,Metropolitan,Eastern,63,2,96,0.65625,65,-2,52,11
2016-17,2017-01-26,New York Rangers,0,Metropolitan,Eastern,63,2,98,0.6428571428571429,65,-2,54,9
2016-17,2017-02-01,New York Rangers,0,Metropolitan,Eastern,63,2,100,0.63,67,-4,56,7
2016-17,2017-02-03,New York Rangers,2,Metropolitan,Eastern,65,2,102,0.6372549019607843,67,-2,58,7
2016-17,2017-02-05,New York Rangers,2,Metropolitan,Eastern,67,2,104,0.6442307692307693,71,-4,58,9
2016-17,2017-02-08,New York Rangers,2,Metropolitan,Eastern,69,2,106,0.6509433962264151,72,-3,59,10
2016-17,2017-02-10,New York Rangers,2,Metropolitan,Eastern,71,2,108,0.6574074074074074,73,-2,60,11
2016-17,2017-02-12,New York Rangers,2,Metropolitan,Eastern,73,2,110,0.6636363636363637,75,-2,61,12
2016-17,2017-02-14,New York Rangers,2,Metropolitan,Eastern,75,2,112,0.6696428571428571,75,0,61,14
2016-17,2017-02-17,New York Rangers,0,Metropolitan,Eastern,75,2,114,0.6578947368421053,77,-2,63,12
2016-17,2017-02-19,New York Rangers,2,Metropolitan,Eastern,77,2,116,0.6637931034482759,79,-2,64,13
2016-17,2017-02-22,New York Rangers,1,Metropolitan,Eastern,78,2,118,0.6610169491525424,79,-1,66,12
2016-17,2017-02-24,New York Rangers,2,Metropolitan,Eastern,80,2,120,0.6666666666666666,80,0,68,12
2016-17,2017-02-25,New York Rangers,2,Metropolitan,Eastern,82,2,122,0.6721311475409836,82,0,68,14
2016-17,2017-02-26,New York Rangers,0,Metropolitan,Eastern,82,2,124,0.6612903225806451,83,-1,69,13
2016-17,2017-03-01,New York Rangers,0,Metropolitan,Eastern,82,2,126,0.6507936507936508,84,-2,69,13
2016-17,2017-03-03,New York Rangers,2,Metropolitan,Eastern,84,2,128,0.65625,84,0,70,14
2016-17,2017-03-05,New York Rangers,0,Metropolitan,Eastern,84,2,130,0.6461538461538462,86,-2,71,13
2016-17,2017-03-07,New York Rangers,2,Metropolitan,Eastern,86,2,132,0.6515151515151515,86,0,71,15
2016-17,2017-03-08,New York Rangers,2,Metropolitan,Eastern,88,2,134,0.6567164179104478,88,0,73,15
2016-17,2017-03-10,New York Rangers,0,Metropolitan,Eastern,88,2,136,0.6470588235294118,90,-2,75,13
2016-17,2017-03-12,New York Rangers,2,Metropolitan,Eastern,90,2,138,0.6521739130434783,92,-2,76,14
2016-17,2017-03-13,New York Rangers,0,Metropolitan,Eastern,90,2,140,0.6428571428571429,94,-4,76,14
2016-17,2017-03-17,New York Rangers,1,Metropolitan,Eastern,91,2,142,0.6408450704225352,96,-5,78,13
2016-17,2017-03-18,New York Rangers,2,Metropolitan,Eastern,93,2,144,0.6458333333333334,97,-4,79,14
2016-17,2017-03-21,New York Rangers,1,Metropolitan,Eastern,94,2,146,0.6438356164383562,100,-6,81,13
2016-17,2017-03-23,New York Rangers,0,Metropolitan,Eastern,94,2,148,0.6351351351351351,101,-7,82,12
2016-17,2017-03-26,New York Rangers,2,Metropolitan,Eastern,96,2,150,0.64,103,-7,84,12
2016-17,2017-03-27,New York Rangers,0,Metropolitan,Eastern,96,2,152,0.631578947368421,103,-7,84,12
2016-17,2017-03-29,New York Rangers,1,Metropolitan,Eastern,97,2,154,0.6298701298701299,103,-6,86,11
2016-17,2017-03-31,New York Rangers,1,Metropolitan,Eastern,98,2,156,0.6282051282051282,105,-7,88,10
2016-17,2017-04-02,New York Rangers,2,Metropolitan,Eastern,100,2,158,0.6329113924050633,106,-6,91,9
2016-17,2017-04-06,New York Rangers,0,Metropolitan,Eastern,100,2,160,0.625,106,-6,93,7
2016-17,2017-04-08,New York Rangers,0,Metropolitan,Eastern,100,2,162,0.6172839506172839,106,-6,95,5
2016-17,2017-04-09,New York Rangers,2,Metropolitan,Eastern,102,2,164,0.6219512195121951,108,-6,95,7
2016-17,2016-10-12,Ottawa Senators,2,Atlantic,Eastern,2,2,2,1.0,0,2,0,2
2016-17,2016-10-15,Ottawa Senators,2,Atlantic,Eastern,4,2,4,1.0,4,0,2,2
2016-17,2016-10-17,Ottawa Senators,0,Atlantic,Eastern,4,2,6,0.6666666666666666,4,0,3,1
2016-17,2016-10-18,Ottawa Senators,2,Atlantic,Eastern,6,2,8,0.75,5,1,4,2
2016-17,2016-10-22,Ottawa Senators,0,Atlantic,Eastern,6,2,10,0.6,8,-2,6,0
2016-17,2016-10-26,Ottawa Senators,2,Atlantic,Eastern,8,2,12,0.6666666666666666,10,-2,7,1
2016-17,2016-10-29,Ottawa Senators,0,Atlantic,Eastern,8,2,14,0.5714285714285714,10,-2,8,0
2016-17,2016-10-31,Ottawa Senators,2,Atlantic,Eastern,10,2,16,0.625,10,0,10,0
2016-17,2016-11-01,Ottawa Senators,2,Atlantic,Eastern,12,2,18,0.6666666666666666,12,0,10,2
2016-17,2016-11-03,Ottawa Senators,2,Atlantic,Eastern,14,2,20,0.7,13,1,13,1
2016-17,2016-11-05,Ottawa Senators,0,Atlantic,Eastern,14,2,22,0.6363636363636364,14,0,13,1
2016-17,2016-11-09,Ottawa Senators,0,Atlantic,Eastern,14,2,24,0.5833333333333334,15,-1,14,0
2016-17,2016-11-10,Ottawa Senators,2,Atlantic,Eastern,16,2,26,0.6153846153846154,15,1,15,1
2016-17,2016-11-12,Ottawa Senators,2,Atlantic,Eastern,18,2,28,0.6428571428571429,17,1,17,1
2016-17,2016-11-13,Ottawa Senators,1,Atlantic,Eastern,19,2,30,0.6333333333333333,18,1,17,2
2016-17,2016-11-16,Ottawa Senators,2,Atlantic,Eastern,21,2,32,0.65625,21,0,20,1
2016-17,2016-11-18,Ottawa Senators,0,Atlantic,Eastern,21,2,34,0.6176470588235294,21,0,20,1
2016-17,2016-11-20,Ottawa Senators,0,Atlantic,Eastern,21,2,36,0.5833333333333334,22,-1,21,0
2016-17,2016-11-23,Ottawa Senators,2,Atlantic,Eastern,23,2,38,0.6052631578947368,23,0,22,1
2016-17,2016-11-25,Ottawa Senators,2,Atlantic,Eastern,25,2,40,0.625,25,0,23,2
2016-17,2016-11-27,Ottawa Senators,2,Atlantic,Eastern,27,2,42,0.6428571428571429,27,0,25,2
2016-17,2016-11-28,Ottawa Senators,2,Atlantic,Eastern,29,2,44,0.6590909090909091,27,2,25,4
2016-17,2016-11-30,Ottawa Senators,0,Atlantic,Eastern,29,2,46,0.6304347826086957,27,2,25,4
2016-17,2016-12-02,Ottawa Senators,1,Atlantic,Eastern,30,2,48,0.625,27,3,27,3
2016-17,2016-12-04,Ottawa Senators,2,Atlantic,Eastern,32,2,50,0.64,30,2,29,3
2016-17,2016-12-06,Ottawa Senators,0,Atlantic,Eastern,32,2,52,0.6153846153846154,31,1,31,1
2016-17,2016-12-08,Ottawa Senators,2,Atlantic,Eastern,34,2,54,0.6296296296296297,32,2,32,2
2016-17,2016-12-10,Ottawa Senators,0,Atlantic,Eastern,34,2,56,0.6071428571428571,32,2,32,2
2016-17,2016-12-11,Ottawa Senators,0,Atlantic,Eastern,34,2,58,0.5862068965517241,32,2,32,2
2016-17,2016-12-15,Ottawa Senators,1,Atlantic,Eastern,35,2,60,0.5833333333333334,35,0,35,0
2016-17,2016-12-18,Ottawa Senators,2,Atlantic,Eastern,37,2,62,0.5967741935483871,37,0,37,0
2016-17,2016-12-19,Ottawa Senators,2,Atlantic,Eastern,39,2,64,0.609375,37,2,37,2
2016-17,2016-12-21,Ottawa Senators,2,Atlantic,Eastern,41,2,66,0.6212121212121212,37,4,37,4
2016-17,2016-12-23,Ottawa Senators,2,Atlantic,Eastern,43,2,68,0.6323529411764706,39,4,39,4
2016-17,2016-12-28,Ottawa Senators,0,Atlantic,Eastern,43,2,70,0.6142857142857143,40,3,40,3
2016-17,2016-12-30,Ottawa Senators,1,Atlantic,Eastern,44,2,72,0.6111111111111112,42,2,42,2
2016-17,2017-01-02,Ottawa Senators,0,Atlantic,Eastern,44,2,74,0.5945945945945946,44,0,44,0
2016-17,2017-01-08,Ottawa Senators,0,Atlantic,Eastern,44,2,76,0.5789473684210527,44,0,44,0
2016-17,2017-01-09,Ottawa Senators,2,Atlantic,Eastern,46,2,78,0.5897435897435898,46,0,46,0
2016-17,2017-01-13,Ottawa Senators,2,Atlantic,Eastern,48,2,80,0.6,48,0,48,0
2016-17,2017-01-15,Ottawa Senators,0,Atlantic,Eastern,48,2,82,0.5853658536585366,48,0,49,-1
2016-17,2017-01-18,Ottawa Senators,2,Atlantic,Eastern,50,2,84,0.5952380952380952,50,0,50,0
2016-17,2017-01-20,Ottawa Senators,2,Atlantic,Eastern,52,2,86,0.6046511627906976,52,0,50,2
2016-17,2017-01-22,Ottawa Senators,1,Atlantic,Eastern,53,2,88,0.6022727272727273,52,1,52,1
2016-17,2017-01-22,Ottawa Senators,2,Atlantic,Eastern,55,2,90,0.6111111111111112,52,3,52,3
2016-17,2017-01-25,Ottawa Senators,2,Atlantic,Eastern,57,2,92,0.6195652173913043,54,3,53,4
2016-17,2017-01-27,Ottawa Senators,1,Atlantic,Eastern,58,2,94,0.6170212765957447,56,2,56,2
2016-17,2017-02-01,Ottawa Senators,0,Atlantic,Eastern,58,2,96,0.6041666666666666,58,0,56,2
2016-17,2017-02-03,Ottawa Senators,2,Atlantic,Eastern,60,2,98,0.6122448979591837,58,2,58,2
2016-17,2017-02-05,Ottawa Senators,0,Atlantic,Eastern,60,2,100,0.6,58,2,58,2
2016-17,2017-02-08,Ottawa Senators,0,Atlantic,Eastern,60,2,102,0.5882352941176471,60,0,59,1
2016-17,2017-02-10,Ottawa Senators,2,Atlantic,Eastern,62,2,104,0.5961538461538461,61,1,60,2
2016-17,2017-02-11,Ottawa Senators,2,Atlantic,Eastern,64,2,106,0.6037735849056604,62,2,61,3
2016-17,2017-02-15,Ottawa Senators,0,Atlantic,Eastern,64,2,108,0.5925925925925926,64,0,63,1
2016-17,2017-02-17,Ottawa Senators,2,Atlantic,Eastern,66,2,110,0.6,64,2,63,3
2016-17,2017-02-19,Ottawa Senators,0,Atlantic,Eastern,66,2,112,0.5892857142857143,64,2,64,2
2016-17,2017-02-19,Ottawa Senators,2,Atlantic,Eastern,68,2,114,0.5964912280701754,64,4,64,4
2016-17,2017-02-22,Ottawa Senators,2,Atlantic,Eastern,70,2,116,0.603448275862069,67,3,66,4
2016-17,2017-02-25,Ottawa Senators,0,Atlantic,Eastern,70,2,118,0.5932203389830508,68,2,68,2
2016-17,2017-02-27,Ottawa Senators,2,Atlantic,Eastern,72,2,120,0.6,70,2,69,3
2016-17,2017-02-28,Ottawa Senators,0,Atlantic,Eastern,72,2,122,0.5901639344262295,70,2,69,3
2016-17,2017-03-03,Ottawa Senators,2,Atlantic,Eastern,74,2,124,0.5967741935483871,72,2,70,4
2016-17,2017-03-05,Ottawa Senators,2,Atlantic,Eastern,76,2,126,0.6031746031746031,74,2,71,5
2016-17,2017-03-07,Ottawa Senators,2,Atlantic,Eastern,78,2,128,0.609375,74,4,71,7
2016-17,2017-03-09,Ottawa Senators,2,Atlantic,Eastern,80,2,130,0.6153846153846154,76,4,73,7
2016-17,2017-03-10,Ottawa Senators,2,Atlantic,Eastern,82,2,132,0.6212121212121212,76,6,75,7
2016-17,2017-03-12,Ottawa Senators,2,Atlantic,Eastern,84,2,134,0.6268656716417911,78,6,76,8
2016-17,2017-03-14,Ottawa Senators,1,Atlantic,Eastern,85,2,136,0.625,80,5,77,8
2016-17,2017-03-16,Ottawa Senators,0,Atlantic,Eastern,85,2,138,0.6159420289855072,82,3,78,7
2016-17,2017-03-18,Ottawa Senators,1,Atlantic,Eastern,86,2,140,0.6142857142857143,82,4,79,7
2016-17,2017-03-19,Ottawa Senators,0,Atlantic,Eastern,86,2,142,0.6056338028169014,82,4,79,7
2016-17,2017-03-21,Ottawa Senators,2,Atlantic,Eastern,88,2,144,0.6111111111111112,82,6,81,7
2016-17,2017-03-23,Ottawa Senators,2,Atlantic,Eastern,90,2,146,0.6164383561643836,85,5,82,8
2016-17,2017-03-25,Ottawa Senators,0,Atlantic,Eastern,90,2,148,0.6081081081081081,85,5,84,6
2016-17,2017-03-28,Ottawa Senators,1,Atlantic,Eastern,91,2,150,0.6066666666666667,87,4,86,5
2016-17,2017-03-31,Ottawa Senators,0,Atlantic,Eastern,91,2,152,0.5986842105263158,89,2,88,3
2016-17,2017-04-01,Ottawa Senators,0,Atlantic,Eastern,91,2,154,0.5909090909090909,91,0,90,1
2016-17,2017-04-03,Ottawa Senators,1,Atlantic,Eastern,92,2,156,0.5897435897435898,92,0,92,0
2016-17,2017-04-04,Ottawa Senators,2,Atlantic,Eastern,94,2,158,0.5949367088607594,94,0,93,1
2016-17,2017-04-06,Ottawa Senators,2,Atlantic,Eastern,96,2,160,0.6,95,1,93,3
2016-17,2017-04-08,Ottawa Senators,2,Atlantic,Eastern,98,2,162,0.6049382716049383,95,3,95,3
2016-17,2017-04-09,Ottawa Senators,0,Atlantic,Eastern,98,2,164,0.5975609756097561,95,3,95,3
2016-17,2016-10-15,Philadelphia Flyers,2,Metropolitan,Eastern,2,2,2,1.0,2,0,2,0
2016-17,2016-10-16,Philadelphia Flyers,1,Metropolitan,Eastern,3,2,4,0.75,3,0,3,0
2016-17,2016-10-19,Philadelphia Flyers,0,Metropolitan,Eastern,3,2,6,0.5,4,-1,4,-1
2016-17,2016-10-20,Philadelphia Flyers,0,Metropolitan,Eastern,3,2,8,0.375,4,-1,4,-1
2016-17,2016-10-22,Philadelphia Flyers,2,Metropolitan,Eastern,5,2,10,0.5,6,-1,6,-1
2016-17,2016-10-24,Philadelphia Flyers,0,Metropolitan,Eastern,5,2,12,0.4166666666666667,7,-2,6,-1
2016-17,2016-10-25,Philadelphia Flyers,2,Metropolitan,Eastern,7,2,14,0.5,7,0,7,0
2016-17,2016-10-27,Philadelphia Flyers,0,Metropolitan,Eastern,7,2,16,0.4375,7,0,7,0
2016-17,2016-10-29,Philadelphia Flyers,0,Metropolitan,Eastern,7,2,18,0.3888888888888889,10,-3,8,-1
2016-17,2016-10-30,Philadelphia Flyers,2,Metropolitan,Eastern,9,2,20,0.45,10,-1,9,0
2016-17,2016-11-03,Philadelphia Flyers,2,Metropolitan,Eastern,11,2,22,0.5,15,-4,13,-2
2016-17,2016-11-03,Philadelphia Flyers,2,Metropolitan,Eastern,13,2,24,0.5416666666666666,15,-2,13,0
2016-17,2016-11-05,Philadelphia Flyers,0,Metropolitan,Eastern,13,2,26,0.5,16,-3,13,0
2016-17,2016-11-09,Philadelphia Flyers,1,Metropolitan,Eastern,14,2,28,0.5,17,-3,14,0
2016-17,2016-11-12,Philadelphia Flyers,0,Metropolitan,Eastern,14,2,30,0.4666666666666667,19,-5,17,-3
2016-17,2016-11-13,Philadelphia Flyers,2,Metropolitan,Eastern,16,2,32,0.5,19,-3,17,-1
2016-17,2016-11-16,Philadelphia Flyers,1,Metropolitan,Eastern,17,2,34,0.5,21,-4,20,-3
2016-17,2016-11-18,Philadelphia Flyers,2,Metropolitan,Eastern,19,2,36,0.5277777777777778,22,-3,20,-1
2016-17,2016-11-19,Philadelphia Flyers,0,Metropolitan,Eastern,19,2,38,0.5,24,-5,20,-1
2016-17,2016-11-23,Philadelphia Flyers,2,Metropolitan,Eastern,21,2,40,0.525,24,-3,22,-1
2016-17,2016-11-24,Philadelphia Flyers,0,Metropolitan,Eastern,21,2,42,0.5,26,-5,23,-2
2016-17,2016-11-25,Philadelphia Flyers,0,Metropolitan,Eastern,21,2,44,0.4772727272727273,27,-6,23,-2
2016-17,2016-11-28,Philadelphia Flyers,2,Metropolitan,Eastern,23,2,46,0.5,28,-5,25,-2
2016-17,2016-11-30,Philadelphia Flyers,2,Metropolitan,Eastern,25,2,48,0.5208333333333334,28,-3,25,0
2016-17,2016-12-02,Philadelphia Flyers,2,Metropolitan,Eastern,27,2,50,0.54,30,-3,27,0
2016-17,2016-12-03,Philadelphia Flyers,2,Metropolitan,Eastern,29,2,52,0.5576923076923077,30,-1,28,1
2016-17,2016-12-04,Philadelphia Flyers,2,Metropolitan,Eastern,31,2,54,0.5740740740740741,32,-1,29,2
2016-17,2016-12-07,Philadelphia Flyers,2,Metropolitan,Eastern,33,2,56,0.5892857142857143,34,-1,31,2
2016-17,2016-12-09,Philadelphia Flyers,2,Metropolitan,Eastern,35,2,58,0.603448275862069,35,0,32,3
2016-17,2016-12-10,Philadelphia Flyers,2,Metropolitan,Eastern,37,2,60,0.6166666666666667,37,0,32,5
2016-17,2016-12-11,Philadelphia Flyers,2,Metropolitan,Eastern,39,2,62,0.6290322580645161,39,0,32,7
2016-17,2016-12-15,Philadelphia Flyers,2,Metropolitan,Eastern,41,2,64,0.640625,41,0,35,6
2016-17,2016-12-17,Philadelphia Flyers,0,Metropolitan,Eastern,41,2,66,0.6212121212121212,42,-1,35,6
2016-17,2016-12-20,Philadelphia Flyers,1,Metropolitan,Eastern,42,2,68,0.6176470588235294,44,-2,37,5
2016-17,2016-12-22,Philadelphia Flyers,2,Metropolitan,Eastern,44,2,70,0.6285714285714286,46,-2,37,7
2016-17,2016-12-23,Philadelphia Flyers,0,Metropolitan,Eastern,44,2,72,0.6111111111111112,47,-3,39,5
2016-17,2016-12-29,Philadelphia Flyers,0,Metropolitan,Eastern,44,2,74,0.5945945945945946,49,-5,40,4
2016-17,2016-12-31,Philadelphia Flyers,0,Metropolitan,Eastern,44,2,76,0.5789473684210527,51,-7,44,0
2016-17,2017-01-02,Philadelphia Flyers,1,Metropolitan,Eastern,45,2,78,0.5769230769230769,53,-8,44,1
2016-17,2017-01-05,Philadelphia Flyers,0,Metropolitan,Eastern,45,2,80,0.5625,55,-10,44,1
2016-17,2017-01-07,Philadelphia Flyers,2,Metropolitan,Eastern,47,2,82,0.573170731707317,55,-8,44,3
2016-17,2017-01-08,Philadelphia Flyers,1,Metropolitan,Eastern,48,2,84,0.5714285714285714,57,-9,44,4
2016-17,2017-01-11,Philadelphia Flyers,0,Metropolitan,Eastern,48,2,86,0.5581395348837209,57,-9,46,2
2016-17,2017-01-13,Philadelphia Flyers,2,Metropolitan,Eastern,50,2,88,0.5681818181818182,57,-7,48,2
2016-17,2017-01-14,Philadelphia Flyers,0,Metropolitan,Eastern,50,2,90,0.5555555555555556,57,-7,48,2
2016-17,2017-01-15,Philadelphia Flyers,0,Metropolitan,Eastern,50,2,92,0.5434782608695652,57,-7,49,1
2016-17,2017-01-22,Philadelphia Flyers,2,Metropolitan,Eastern,52,2,94,0.5531914893617021,65,-13,52,0
2016-17,2017-01-22,Philadelphia Flyers,0,Metropolitan,Eastern,52,2,96,0.5416666666666666,65,-13,52,0
2016-17,2017-01-26,Philadelphia Flyers,2,Metropolitan,Eastern,54,2,98,0.5510204081632653,65,-11,54,0
2016-17,2017-01-27,Philadelphia Flyers,2,Metropolitan,Eastern,56,2,100,0.56,65,-9,56,0
2016-17,2017-02-01,Philadelphia Flyers,0,Metropolitan,Eastern,56,2,102,0.5490196078431373,67,-11,56,0
2016-17,2017-02-03,Philadelphia Flyers,2,Metropolitan,Eastern,58,2,104,0.5576923076923077,67,-9,58,0
2016-17,2017-02-04,Philadelphia Flyers,1,Metropolitan,Eastern,59,2,106,0.5566037735849056,69,-10,58,1
2016-17,2017-02-07,Philadelphia Flyers,0,Metropolitan,Eastern,59,2,108,0.5462962962962963,71,-12,58,1
2016-17,2017-02-10,Philadelphia Flyers,0,Metropolitan,Eastern,59,2,110,0.5363636363636364,73,-14,60,-1
2016-17,2017-02-11,Philadelphia Flyers,2,Metropolitan,Eastern,61,2,112,0.5446428571428571,74,-13,61,0
2016-17,2017-02-16,Philadelphia Flyers,0,Metropolitan,Eastern,61,2,114,0.5350877192982456,77,-16,63,-2
2016-17,2017-02-17,Philadelphia Flyers,0,Metropolitan,Eastern,61,2,116,0.5258620689655172,77,-16,63,-2
2016-17,2017-02-20,Philadelphia Flyers,2,Metropolitan,Eastern,63,2,118,0.5338983050847458,79,-16,65,-2
2016-17,2017-02-23,Philadelphia Flyers,0,Metropolitan,Eastern,63,2,120,0.525,79,-16,66,-3
2016-17,2017-02-26,Philadelphia Flyers,0,Metropolitan,Eastern,63,2,122,0.5163934426229508,83,-20,69,-6
2016-17,2017-03-01,Philadelphia Flyers,2,Metropolitan,Eastern,65,2,124,0.5241935483870968,84,-19,69,-4
2016-17,2017-03-03,Philadelphia Flyers,2,Metropolitan,Eastern,67,2,126,0.5317460317460317,84,-17,70,-3
2016-17,2017-03-05,Philadelphia Flyers,1,Metropolitan,Eastern,68,2,128,0.53125,86,-18,71,-3
2016-17,2017-03-08,Philadelphia Flyers,2,Metropolitan,Eastern,70,2,130,0.5384615384615384,88,-18,73,-3
2016-17,2017-03-10,Philadelphia Flyers,0,Metropolitan,Eastern,70,2,132,0.5303030303030303,90,-20,75,-5
2016-17,2017-03-11,Philadelphia Flyers,0,Metropolitan,Eastern,70,2,134,0.5223880597014925,92,-22,75,-5
2016-17,2017-03-13,Philadelphia Flyers,0,Metropolitan,Eastern,70,2,136,0.5147058823529411,94,-24,76,-6
2016-17,2017-03-15,Philadelphia Flyers,2,Metropolitan,Eastern,72,2,138,0.5217391304347826,94,-22,77,-5
2016-17,2017-03-16,Philadelphia Flyers,0,Metropolitan,Eastern,72,2,140,0.5142857142857142,95,-23,78,-6
2016-17,2017-03-19,Philadelphia Flyers,2,Metropolitan,Eastern,74,2,142,0.5211267605633803,99,-25,79,-5
2016-17,2017-03-22,Philadelphia Flyers,0,Metropolitan,Eastern,74,2,144,0.5138888888888888,100,-26,82,-8
2016-17,2017-03-24,Philadelphia Flyers,2,Metropolitan,Eastern,76,2,146,0.5205479452054794,101,-25,82,-6
2016-17,2017-03-25,Philadelphia Flyers,0,Metropolitan,Eastern,76,2,148,0.5135135135135135,103,-27,84,-8
2016-17,2017-03-26,Philadelphia Flyers,2,Metropolitan,Eastern,78,2,150,0.52,103,-25,84,-6
2016-17,2017-03-28,Philadelphia Flyers,2,Metropolitan,Eastern,80,2,152,0.5263157894736842,103,-23,86,-6
2016-17,2017-03-30,Philadelphia Flyers,2,Metropolitan,Eastern,82,2,154,0.5324675324675324,103,-21,87,-5
2016-17,2017-04-01,Philadelphia Flyers,2,Metropolitan,Eastern,84,2,156,0.5384615384615384,105,-21,90,-6
2016-17,2017-04-02,Philadelphia Flyers,0,Metropolitan,Eastern,84,2,158,0.5316455696202531,106,-22,91,-7
2016-17,2017-04-04,Philadelphia Flyers,1,Metropolitan,Eastern,85,2,160,0.53125,106,-21,93,-8
2016-17,2017-04-08,Philadelphia Flyers,2,Metropolitan,Eastern,87,2,162,0.5370370370370371,106,-19,95,-8
2016-17,2017-04-09,Philadelphia Flyers,1,Metropolitan,Eastern,88,2,164,0.5365853658536586,108,-20,95,-7
2016-17,2016-10-14,Pittsburgh Penguins,2,Metropolitan,Eastern,2,2,2,1.0,1,1,1,1
2016-17,2016-10-15,Pittsburgh Penguins,2,Metropolitan,Eastern,4,2,4,1.0,2,2,2,2
2016-17,2016-10-17,Pittsburgh Penguins,1,Metropolitan,Eastern,5,2,6,0.8333333333333334,3,2,3,2
2016-17,2016-10-18,Pittsburgh Penguins,0,Metropolitan,Eastern,5,2,8,0.625,4,1,4,1
2016-17,2016-10-20,Pittsburgh Penguins,2,Metropolitan,Eastern,7,2,10,0.7,4,3,4,3
2016-17,2016-10-23,Pittsburgh Penguins,0,Metropolitan,Eastern,7,2,12,0.5833333333333334,7,0,6,1
2016-17,2016-10-25,Pittsburgh Penguins,2,Metropolitan,Eastern,9,2,14,0.6428571428571429,7,2,7,2
2016-17,2016-10-27,Pittsburgh Penguins,2,Metropolitan,Eastern,11,2,16,0.6875,7,4,7,4
2016-17,2016-10-29,Pittsburgh Penguins,2,Metropolitan,Eastern,13,2,18,0.7222222222222222,10,3,8,5
2016-17,2016-11-03,Pittsburgh Penguins,2,Metropolitan,Eastern,15,2,20,0.75,15,0,13,2
2016-17,2016-11-04,Pittsburgh Penguins,1,Metropolitan,Eastern,16,2,22,0.7272727272727273,15,1,12,4
2016-17,2016-11-06,Pittsburgh Penguins,2,Metropolitan,Eastern,18,2,24,0.75,17,1,13,5
2016-17,2016-11-09,Pittsburgh Penguins,2,Metropolitan,Eastern,20,2,26,0.7692307692307693,17,3,14,6
2016-17,2016-11-11,Pittsburgh Penguins,0,Metropolitan,Eastern,20,2,28,0.7142857142857143,17,3,16,4
2016-17,2016-11-13,Pittsburgh Penguins,2,Metropolitan,Eastern,22,2,30,0.7333333333333333,19,3,17,5
2016-17,2016-11-17,Pittsburgh Penguins,0,Metropolitan,Eastern,22,2,32,0.6875,22,0,20,2
2016-17,2016-11-19,Pittsburgh Penguins,2,Metropolitan,Eastern,24,2,34,0.7058823529411765,24,0,20,4
2016-17,2016-11-20,Pittsburgh Penguins,1,Metropolitan,Eastern,25,2,36,0.6944444444444444,24,1,21,4
2016-17,2016-11-22,Pittsburgh Penguins,0,Metropolitan,Eastern,25,2,38,0.6578947368421053,24,1,21,4
2016-17,2016-11-24,Pittsburgh Penguins,2,Metropolitan,Eastern,27,2,40,0.675,26,1,23,4
2016-17,2016-11-25,Pittsburgh Penguins,0,Metropolitan,Eastern,27,2,42,0.6428571428571429,27,0,23,4
2016-17,2016-11-27,Pittsburgh Penguins,2,Metropolitan,Eastern,29,2,44,0.6590909090909091,28,1,25,4
2016-17,2016-12-01,Pittsburgh Penguins,0,Metropolitan,Eastern,29,2,46,0.6304347826086957,28,1,25,4
2016-17,2016-12-02,Pittsburgh Penguins,2,Metropolitan,Eastern,31,2,48,0.6458333333333334,30,1,27,4
2016-17,2016-12-04,Pittsburgh Penguins,2,Metropolitan,Eastern,33,2,50,0.66,32,1,29,4
2016-17,2016-12-06,Pittsburgh Penguins,2,Metropolitan,Eastern,35,2,52,0.6730769230769231,34,1,31,4
2016-17,2016-12-09,Pittsburgh Penguins,2,Metropolitan,Eastern,37,2,54,0.6851851851851852,35,2,32,5
2016-17,2016-12-11,Pittsburgh Penguins,2,Metropolitan,Eastern,39,2,56,0.6964285714285714,39,0,32,7
2016-17,2016-12-13,Pittsburgh Penguins,2,Metropolitan,Eastern,41,2,58,0.7068965517241379,39,2,34,7
2016-17,2016-12-15,Pittsburgh Penguins,2,Metropolitan,Eastern,43,2,60,0.7166666666666667,41,2,35,8
2016-17,2016-12-17,Pittsburgh Penguins,1,Metropolitan,Eastern,44,2,62,0.7096774193548387,42,2,35,9
2016-17,2016-12-18,Pittsburgh Penguins,1,Metropolitan,Eastern,45,2,64,0.703125,44,1,37,8
2016-17,2016-12-21,Pittsburgh Penguins,2,Metropolitan,Eastern,47,2,66,0.7121212121212122,46,1,37,10
2016-17,2016-12-23,Pittsburgh Penguins,0,Metropolitan,Eastern,47,2,68,0.6911764705882353,47,0,39,8
2016-17,2016-12-24,Pittsburgh Penguins,2,Metropolitan,Eastern,49,2,70,0.7,47,2,40,9
2016-17,2016-12-28,Pittsburgh Penguins,2,Metropolitan,Eastern,51,2,72,0.7083333333333334,49,2,40,11
2016-17,2016-12-29,Pittsburgh Penguins,2,Metropolitan,Eastern,53,2,74,0.7162162162162162,49,4,40,13
2016-17,2017-01-01,Pittsburgh Penguins,2,Metropolitan,Eastern,55,2,76,0.7236842105263158,53,2,44,11
2016-17,2017-01-08,Pittsburgh Penguins,2,Metropolitan,Eastern,57,2,78,0.7307692307692307,57,0,44,13
2016-17,2017-01-12,Pittsburgh Penguins,0,Metropolitan,Eastern,57,2,80,0.7125,57,0,46,11
2016-17,2017-01-13,Pittsburgh Penguins,0,Metropolitan,Eastern,57,2,82,0.6951219512195121,57,0,48,9
2016-17,2017-01-15,Pittsburgh Penguins,0,Metropolitan,Eastern,57,2,84,0.6785714285714286,57,0,49,8
2016-17,2017-01-17,Pittsburgh Penguins,2,Metropolitan,Eastern,59,2,86,0.686046511627907,59,0,49,10
2016-17,2017-01-19,Pittsburgh Penguins,2,Metropolitan,Eastern,61,2,88,0.6931818181818182,61,0,50,11
2016-17,2017-01-21,Pittsburgh Penguins,2,Metropolitan,Eastern,63,2,90,0.7,63,0,50,13
2016-17,2017-01-22,Pittsburgh Penguins,2,Metropolitan,Eastern,65,2,92,0.7065217391304348,65,0,52,13
2016-17,2017-01-25,Pittsburgh Penguins,0,Metropolitan,Eastern,65,2,94,0.6914893617021277,65,0,53,12
2016-17,2017-01-27,Pittsburgh Penguins,0,Metropolitan,Eastern,65,2,96,0.6770833333333334,65,0,56,9
2016-17,2017-02-01,Pittsburgh Penguins,2,Metropolitan,Eastern,67,2,98,0.6836734693877551,67,0,56,11
2016-17,2017-02-04,Pittsburgh Penguins,2,Metropolitan,Eastern,69,2,100,0.69,69,0,58,11
2016-17,2017-02-05,Pittsburgh Penguins,2,Metropolitan,Eastern,71,2,102,0.696078431372549,71,0,58,13
2016-17,2017-02-08,Pittsburgh Penguins,1,Metropolitan,Eastern,72,2,104,0.6923076923076923,72,0,59,13
2016-17,2017-02-10,Pittsburgh Penguins,2,Metropolitan,Eastern,74,2,106,0.6981132075471698,73,1,60,14
2016-17,2017-02-12,Pittsburgh Penguins,1,Metropolitan,Eastern,75,2,108,0.6944444444444444,75,0,61,14
2016-17,2017-02-15,Pittsburgh Penguins,2,Metropolitan,Eastern,77,2,110,0.7,75,2,63,14
2016-17,2017-02-17,Pittsburgh Penguins,2,Metropolitan,Eastern,79,2,112,0.7053571428571429,77,2,63,16
2016-17,2017-02-18,Pittsburgh Penguins,1,Metropolitan,Eastern,80,2,114,0.7017543859649122,79,1,63,17
2016-17,2017-02-19,Pittsburgh Penguins,0,Metropolitan,Eastern,80,2,116,0.6896551724137931,79,1,64,16
2016-17,2017-02-22,Pittsburgh Penguins,2,Metropolitan,Eastern,82,2,118,0.6949152542372882,79,3,66,16
2016-17,2017-02-26,Pittsburgh Penguins,2,Metropolitan,Eastern,84,2,120,0.7,83,1,69,15
2016-17,2017-03-01,Pittsburgh Penguins,0,Metropolitan,Eastern,84,2,122,0.6885245901639344,84,0,69,15
2016-17,2017-03-02,Pittsburgh Penguins,0,Metropolitan,Eastern,84,2,124,0.6774193548387096,84,0,69,15
2016-17,2017-03-04,Pittsburgh Penguins,2,Metropolitan,Eastern,86,2,126,0.6825396825396826,86,0,71,15
2016-17,2017-03-05,Pittsburgh Penguins,2,Metropolitan,Eastern,88,2,128,0.6875,86,2,71,17
2016-17,2017-03-09,Pittsburgh Penguins,2,Metropolitan,Eastern,90,2,130,0.6923076923076923,90,0,73,17
2016-17,2017-03-11,Pittsburgh Penguins,2,Metropolitan,Eastern,92,2,132,0.696969696969697,92,0,75,17
2016-17,2017-03-12,Pittsburgh Penguins,2,Metropolitan,Eastern,94,2,134,0.7014925373134329,92,2,76,18
2016-17,2017-03-14,Pittsburgh Penguins,1,Metropolitan,Eastern,95,2,136,0.6985294117647058,94,1,77,18
2016-17,2017-03-15,Pittsburgh Penguins,0,Metropolitan,Eastern,95,2,138,0.6884057971014492,94,1,77,18
2016-17,2017-03-17,Pittsburgh Penguins,2,Metropolitan,Eastern,97,2,140,0.6928571428571428,96,1,78,19
2016-17,2017-03-19,Pittsburgh Penguins,2,Metropolitan,Eastern,99,2,142,0.6971830985915493,99,0,79,20
2016-17,2017-03-21,Pittsburgh Penguins,2,Metropolitan,Eastern,101,2,144,0.7013888888888888,100,1,81,20
2016-17,2017-03-23,Pittsburgh Penguins,1,Metropolitan,Eastern,102,2,146,0.6986301369863014,101,1,82,20
2016-17,2017-03-24,Pittsburgh Penguins,1,Metropolitan,Eastern,103,2,148,0.6959459459459459,101,2,82,21
2016-17,2017-03-26,Pittsburgh Penguins,0,Metropolitan,Eastern,103,2,150,0.6866666666666666,103,0,84,19
2016-17,2017-03-30,Pittsburgh Penguins,0,Metropolitan,Eastern,103,2,152,0.6776315789473685,103,0,87,16
2016-17,2017-03-31,Pittsburgh Penguins,2,Metropolitan,Eastern,105,2,154,0.6818181818181818,105,0,88,17
2016-17,2017-04-02,Pittsburgh Penguins,2,Metropolitan,Eastern,107,2,156,0.6858974358974359,106,1,91,16
2016-17,2017-04-04,Pittsburgh Penguins,2,Metropolitan,Eastern,109,2,158,0.689873417721519,106,3,93,16
2016-17,2017-04-06,Pittsburgh Penguins,2,Metropolitan,Eastern,111,2,160,0.69375,106,5,93,18
2016-17,2017-04-08,Pittsburgh Penguins,0,Metropolitan,Eastern,111,2,162,0.6851851851851852,106,5,95,16
2016-17,2017-04-09,Pittsburgh Penguins,0,Metropolitan,Eastern,111,2,164,0.676829268292683,108,3,95,16
2016-17,2016-10-13,San Jose Sharks,2,Pacific,Western,2,2,2,1.0,0,2,0,2
2016-17,2016-10-15,San Jose Sharks,2,Pacific,Western,4,2,4,1.0,0,4,0,4
2016-17,2016-10-17,San Jose Sharks,0,Pacific,Western,4,2,6,0.6666666666666666,4,0,2,2
2016-17,2016-10-18,San Jose Sharks,2,Pacific,Western,6,2,8,0.75,4,2,2,4
2016-17,2016-10-20,San Jose Sharks,0,Pacific,Western,6,2,10,0.6,6,0,4,2
2016-17,2016-10-22,San Jose Sharks,0,Pacific,Western,6,2,12,0.5,6,0,5,1
2016-17,2016-10-26,San Jose Sharks,2,Pacific,Western,8,2,14,0.5714285714285714,8,0,7,1
2016-17,2016-10-28,San Jose Sharks,2,Pacific,Western,10,2,16,0.625,9,1,8,2
2016-17,2016-10-30,San Jose Sharks,2,Pacific,Western,12,2,18,0.6666666666666666,9,3,8,4
2016-17,2016-11-02,San Jose Sharks,0,Pacific,Western,12,2,20,0.6,10,2,9,3
2016-17,2016-11-04,San Jose Sharks,0,Pacific,Western,12,2,22,0.5454545454545454,11,1,10,2
2016-17,2016-11-06,San Jose Sharks,0,Pacific,Western,12,2,24,0.5,12,0,11,1
2016-17,2016-11-09,San Jose Sharks,2,Pacific,Western,14,2,26,0.5384615384615384,14,0,13,1
2016-17,2016-11-11,San Jose Sharks,2,Pacific,Western,16,2,28,0.5714285714285714,16,0,14,2
2016-17,2016-11-13,San Jose Sharks,2,Pacific,Western,18,2,30,0.6,17,1,16,2
2016-17,2016-11-16,San Jose Sharks,0,Pacific,Western,18,2,32,0.5625,18,0,17,1
2016-17,2016-11-18,San Jose Sharks,0,Pacific,Western,18,2,34,0.5294117647058824,18,0,18,0
2016-17,2016-11-20,San Jose Sharks,1,Pacific,Western,19,2,36,0.5277777777777778,19,0,19,0
2016-17,2016-11-22,San Jose Sharks,2,Pacific,Western,21,2,38,0.5526315789473685,21,0,20,1
2016-17,2016-11-24,San Jose Sharks,2,Pacific,Western,23,2,40,0.575,23,0,21,2
2016-17,2016-11-25,San Jose Sharks,2,Pacific,Western,25,2,42,0.5952380952380952,23,2,22,3
2016-17,2016-11-27,San Jose Sharks,0,Pacific,Western,25,2,44,0.5681818181818182,25,0,23,2
2016-17,2016-11-30,San Jose Sharks,2,Pacific,Western,27,2,46,0.5869565217391305,26,1,25,2
2016-17,2016-12-01,San Jose Sharks,2,Pacific,Western,29,2,48,0.6041666666666666,26,3,25,4
2016-17,2016-12-03,San Jose Sharks,2,Pacific,Western,31,2,50,0.62,28,3,26,5
2016-17,2016-12-08,San Jose Sharks,0,Pacific,Western,31,2,52,0.5961538461538461,31,0,29,2
2016-17,2016-12-10,San Jose Sharks,0,Pacific,Western,31,2,54,0.5740740740740741,32,-1,30,1
2016-17,2016-12-11,San Jose Sharks,2,Pacific,Western,33,2,56,0.5892857142857143,33,0,30,3
2016-17,2016-12-14,San Jose Sharks,2,Pacific,Western,35,2,58,0.603448275862069,35,0,30,5
2016-17,2016-12-15,San Jose Sharks,2,Pacific,Western,37,2,60,0.6166666666666667,35,2,30,7
2016-17,2016-12-17,San Jose Sharks,2,Pacific,Western,39,2,62,0.6290322580645161,35,4,34,5
2016-17,2016-12-19,San Jose Sharks,0,Pacific,Western,39,2,64,0.609375,37,2,34,5
2016-17,2016-12-21,San Jose Sharks,2,Pacific,Western,41,2,66,0.6212121212121212,39,2,35,6
2016-17,2016-12-24,San Jose Sharks,2,Pacific,Western,43,2,68,0.6323529411764706,40,3,38,5
2016-17,2016-12-28,San Jose Sharks,2,Pacific,Western,45,2,70,0.6428571428571429,41,4,38,7
2016-17,2016-12-31,San Jose Sharks,2,Pacific,Western,47,2,72,0.6527777777777778,44,3,39,8
2016-17,2017-01-01,San Jose Sharks,0,Pacific,Western,47,2,74,0.6351351351351351,44,3,40,7
2016-17,2017-01-04,San Jose Sharks,1,Pacific,Western,48,2,76,0.631578947368421,45,3,42,6
2016-17,2017-01-06,San Jose Sharks,0,Pacific,Western,48,2,78,0.6153846153846154,47,1,42,6
2016-17,2017-01-08,San Jose Sharks,2,Pacific,Western,50,2,80,0.625,49,1,44,6
2016-17,2017-01-11,San Jose Sharks,2,Pacific,Western,52,2,82,0.6341463414634146,49,3,44,8
2016-17,2017-01-12,San Jose Sharks,0,Pacific,Western,52,2,84,0.6190476190476191,49,3,44,8
2016-17,2017-01-15,San Jose Sharks,0,Pacific,Western,52,2,86,0.6046511627906976,52,0,48,4
2016-17,2017-01-16,San Jose Sharks,2,Pacific,Western,54,2,88,0.6136363636363636,53,1,48,6
2016-17,2017-01-19,San Jose Sharks,2,Pacific,Western,56,2,90,0.6222222222222222,56,0,48,8
2016-17,2017-01-20,San Jose Sharks,2,Pacific,Western,58,2,92,0.6304347826086957,57,1,49,9
2016-17,2017-01-22,San Jose Sharks,2,Pacific,Western,60,2,94,0.6382978723404256,60,0,51,9
2016-17,2017-01-24,San Jose Sharks,2,Pacific,Western,62,2,96,0.6458333333333334,60,2,51,11
2016-17,2017-01-25,San Jose Sharks,2,Pacific,Western,64,2,98,0.6530612244897959,60,4,51,13
2016-17,2017-01-27,San Jose Sharks,0,Pacific,Western,64,2,100,0.64,63,1,53,11
2016-17,2017-02-01,San Jose Sharks,2,Pacific,Western,66,2,102,0.6470588235294118,64,2,53,13
2016-17,2017-02-03,San Jose Sharks,2,Pacific,Western,68,2,104,0.6538461538461539,64,4,55,13
2016-17,2017-02-05,San Jose Sharks,1,Pacific,Western,69,2,106,0.6509433962264151,66,3,57,12
2016-17,2017-02-08,San Jose Sharks,1,Pacific,Western,70,2,108,0.6481481481481481,66,4,59,11
2016-17,2017-02-10,San Jose Sharks,0,Pacific,Western,70,2,110,0.6363636363636364,66,4,60,10
2016-17,2017-02-11,San Jose Sharks,1,Pacific,Western,71,2,112,0.6339285714285714,66,5,60,11
2016-17,2017-02-12,San Jose Sharks,2,Pacific,Western,73,2,114,0.6403508771929824,66,7,60,13
2016-17,2017-02-16,San Jose Sharks,1,Pacific,Western,74,2,116,0.6379310344827587,68,6,61,13
2016-17,2017-02-19,San Jose Sharks,2,Pacific,Western,76,2,118,0.6440677966101694,70,6,62,14
2016-17,2017-02-20,San Jose Sharks,1,Pacific,Western,77,2,120,0.6416666666666667,72,5,62,15
2016-17,2017-02-26,San Jose Sharks,2,Pacific,Western,79,2,122,0.6475409836065574,74,5,67,12
2016-17,2017-03-01,San Jose Sharks,2,Pacific,Western,81,2,124,0.6532258064516129,74,7,67,14
2016-17,2017-03-03,San Jose Sharks,2,Pacific,Western,83,2,126,0.6587301587301587,74,9,68,15
2016-17,2017-03-05,San Jose Sharks,0,Pacific,Western,83,2,128,0.6484375,76,7,68,15
2016-17,2017-03-07,San Jose Sharks,2,Pacific,Western,85,2,130,0.6538461538461539,76,9,69,16
2016-17,2017-03-10,San Jose Sharks,2,Pacific,Western,87,2,132,0.6590909090909091,78,9,71,16
2016-17,2017-03-11,San Jose Sharks,0,Pacific,Western,87,2,134,0.6492537313432836,79,8,73,14
2016-17,2017-03-13,San Jose Sharks,2,Pacific,Western,89,2,136,0.6544117647058824,80,9,75,14
2016-17,2017-03-15,San Jose Sharks,2,Pacific,Western,91,2,138,0.6594202898550725,82,9,77,14
2016-17,2017-03-17,San Jose Sharks,0,Pacific,Western,91,2,140,0.65,83,8,79,12
2016-17,2017-03-19,San Jose Sharks,0,Pacific,Western,91,2,142,0.6408450704225352,85,6,81,10
2016-17,2017-03-21,San Jose Sharks,0,Pacific,Western,91,2,144,0.6319444444444444,87,4,81,10
2016-17,2017-03-22,San Jose Sharks,0,Pacific,Western,91,2,146,0.6232876712328768,87,4,83,8
2016-17,2017-03-25,San Jose Sharks,0,Pacific,Western,91,2,148,0.6148648648648649,89,2,85,6
2016-17,2017-03-26,San Jose Sharks,0,Pacific,Western,91,2,150,0.6066666666666667,91,0,86,5
2016-17,2017-03-29,San Jose Sharks,2,Pacific,Western,93,2,152,0.6118421052631579,93,0,88,5
2016-17,2017-03-31,San Jose Sharks,0,Pacific,Western,93,2,154,0.6038961038961039,93,0,89,4
2016-17,2017-04-01,San Jose Sharks,0,Pacific,Western,93,2,156,0.5961538461538461,93,0,91,2
2016-17,2017-04-02,San Jose Sharks,2,Pacific,Western,95,2,158,0.6012658227848101,95,0,91,4
2016-17,2017-04-05,San Jose Sharks,2,Pacific,Western,97,2,160,0.60625,97,0,92,5
2016-17,2017-04-07,San Jose Sharks,0,Pacific,Western,97,2,162,0.5987654320987654,97,0,94,3
2016-17,2017-04-09,San Jose Sharks,2,Pacific,Western,99,2,164,0.6036585365853658,99,0,94,5
2016-17,2016-10-13,St. Louis Blues,2,Central,Western,2,2,2,1.0,0,2,0,2
2016-17,2016-10-14,St. Louis Blues,2,Central,Western,4,2,4,1.0,2,2,0,4
2016-17,2016-10-16,St. Louis Blues,2,Central,Western,6,2,6,1.0,2,4,2,4
2016-17,2016-10-19,St. Louis Blues,1,Central,Western,7,2,8,0.875,4,3,4,3
2016-17,2016-10-21,St. Louis Blues,0,Central,Western,7,2,10,0.7,6,1,4,3
2016-17,2016-10-23,St. Louis Blues,2,Central,Western,9,2,12,0.75,6,3,5,4
2016-17,2016-10-26,St. Louis Blues,0,Central,Western,9,2,14,0.6428571428571429,7,2,7,2
2016-17,2016-10-28,St. Louis Blues,1,Central,Western,10,2,16,0.625,9,1,8,2
2016-17,2016-10-30,St. Louis Blues,2,Central,Western,12,2,18,0.6666666666666666,11,1,8,4
2016-17,2016-11-01,St. Louis Blues,0,Central,Western,12,2,20,0.6,11,1,8,4
2016-17,2016-11-04,St. Louis Blues,0,Central,Western,12,2,22,0.5454545454545454,12,0,10,2
2016-17,2016-11-05,St. Louis Blues,2,Central,Western,14,2,24,0.5833333333333334,13,1,11,3
2016-17,2016-11-06,St. Louis Blues,2,Central,Western,16,2,26,0.6153846153846154,13,3,11,5
2016-17,2016-11-10,St. Louis Blues,1,Central,Western,17,2,28,0.6071428571428571,13,4,13,4
2016-17,2016-11-11,St. Louis Blues,0,Central,Western,17,2,30,0.5666666666666667,15,2,14,3
2016-17,2016-11-13,St. Louis Blues,0,Central,Western,17,2,32,0.53125,17,0,16,1
2016-17,2016-11-16,St. Louis Blues,2,Central,Western,19,2,34,0.5588235294117647,19,0,17,2
2016-17,2016-11-18,St. Louis Blues,2,Central,Western,21,2,36,0.5833333333333334,20,1,18,3
2016-17,2016-11-20,St. Louis Blues,2,Central,Western,23,2,38,0.6052631578947368,20,3,19,4
2016-17,2016-11-23,St. Louis Blues,2,Central,Western,25,2,40,0.625,21,4,20,5
2016-17,2016-11-24,St. Louis Blues,0,Central,Western,25,2,42,0.5952380952380952,22,3,21,4
2016-17,2016-11-27,St. Louis Blues,2,Central,Western,27,2,44,0.6136363636363636,25,2,23,4
2016-17,2016-11-29,St. Louis Blues,2,Central,Western,29,2,46,0.6304347826086957,25,4,24,5
2016-17,2016-12-02,St. Louis Blues,2,Central,Western,31,2,48,0.6458333333333334,25,6,25,6
2016-17,2016-12-04,St. Louis Blues,1,Central,Western,32,2,50,0.64,26,6,26,6
2016-17,2016-12-07,St. Louis Blues,2,Central,Western,34,2,52,0.6538461538461539,29,5,28,6
2016-17,2016-12-09,St. Louis Blues,0,Central,Western,34,2,54,0.6296296296296297,30,4,29,5
2016-17,2016-12-10,St. Louis Blues,2,Central,Western,36,2,56,0.6428571428571429,32,4,30,6
2016-17,2016-12-11,St. Louis Blues,0,Central,Western,36,2,58,0.6206896551724138,34,2,30,6
2016-17,2016-12-14,St. Louis Blues,0,Central,Western,36,2,60,0.6,36,0,30,6
2016-17,2016-12-16,St. Louis Blues,2,Central,Western,38,2,62,0.6129032258064516,38,0,32,6
2016-17,2016-12-18,St. Louis Blues,0,Central,Western,38,2,64,0.59375,38,0,34,4
2016-17,2016-12-20,St. Louis Blues,1,Central,Western,39,2,66,0.5909090909090909,39,0,34,5
2016-17,2016-12-21,St. Louis Blues,2,Central,Western,41,2,68,0.6029411764705882,41,0,35,6
2016-17,2016-12-23,St. Louis Blues,0,Central,Western,41,2,70,0.5857142857142857,41,0,36,5
2016-17,2016-12-29,St. Louis Blues,2,Central,Western,43,2,72,0.5972222222222222,43,0,38,5
2016-17,2016-12-31,St. Louis Blues,0,Central,Western,43,2,74,0.581081081081081,43,0,39,4
2016-17,2017-01-02,St. Louis Blues,2,Central,Western,45,2,76,0.5921052631578947,45,0,40,5
2016-17,2017-01-06,St. Louis Blues,0,Central,Western,45,2,78,0.5769230769230769,45,0,42,3
2016-17,2017-01-08,St. Louis Blues,2,Central,Western,47,2,80,0.5875,47,0,44,3
2016-17,2017-01-11,St. Louis Blues,0,Central,Western,47,2,82,0.573170731707317,47,0,44,3
2016-17,2017-01-13,St. Louis Blues,0,Central,Western,47,2,84,0.5595238095238095,47,0,46,1
2016-17,2017-01-15,St. Louis Blues,2,Central,Western,49,2,86,0.5697674418604651,49,0,48,1
2016-17,2017-01-16,St. Louis Blues,2,Central,Western,51,2,88,0.5795454545454546,51,0,48,3
2016-17,2017-01-18,St. Louis Blues,0,Central,Western,51,2,90,0.5666666666666667,51,0,48,3
2016-17,2017-01-20,St. Louis Blues,0,Central,Western,51,2,92,0.5543478260869565,51,0,49,2
2016-17,2017-01-21,St. Louis Blues,0,Central,Western,51,2,94,0.5425531914893617,51,0,51,0
2016-17,2017-01-25,St. Louis Blues,2,Central,Western,53,2,96,0.5520833333333334,54,-1,51,2
2016-17,2017-01-27,St. Louis Blues,0,Central,Western,53,2,98,0.5408163265306123,56,-3,53,0
2016-17,2017-02-01,St. Louis Blues,0,Central,Western,53,2,100,0.53,56,-3,53,0
2016-17,2017-02-03,St. Louis Blues,2,Central,Western,55,2,102,0.5392156862745098,58,-3,55,0
2016-17,2017-02-05,St. Louis Blues,0,Central,Western,55,2,104,0.5288461538461539,58,-3,57,-2
2016-17,2017-02-07,St. Louis Blues,2,Central,Western,57,2,106,0.5377358490566038,58,-1,57,0
2016-17,2017-02-08,St. Louis Blues,2,Central,Western,59,2,108,0.5462962962962963,60,-1,59,0
2016-17,2017-02-10,St. Louis Blues,2,Central,Western,61,2,110,0.5545454545454546,61,0,60,1
2016-17,2017-02-12,St. Louis Blues,2,Central,Western,63,2,112,0.5625,63,0,60,3
2016-17,2017-02-16,St. Louis Blues,2,Central,Western,65,2,114,0.5701754385964912,65,0,61,4
2016-17,2017-02-17,St. Louis Blues,2,Central,Western,67,2,116,0.5775862068965517,67,0,61,6
2016-17,2017-02-18,St. Louis Blues,0,Central,Western,67,2,118,0.5677966101694916,67,0,61,6
2016-17,2017-02-21,St. Louis Blues,0,Central,Western,67,2,120,0.5583333333333333,67,0,62,5
2016-17,2017-02-27,St. Louis Blues,0,Central,Western,67,2,122,0.5491803278688525,71,-4,67,0
2016-17,2017-03-01,St. Louis Blues,0,Central,Western,67,2,124,0.5403225806451613,73,-6,67,0
2016-17,2017-03-04,St. Louis Blues,0,Central,Western,67,2,126,0.5317460317460317,73,-6,68,-1
2016-17,2017-03-06,St. Louis Blues,2,Central,Western,69,2,128,0.5390625,73,-4,69,0
2016-17,2017-03-08,St. Louis Blues,2,Central,Western,71,2,130,0.5461538461538461,74,-3,71,0
2016-17,2017-03-11,St. Louis Blues,2,Central,Western,73,2,132,0.553030303030303,77,-4,73,0
2016-17,2017-03-12,St. Louis Blues,2,Central,Western,75,2,134,0.5597014925373134,77,-2,75,0
2016-17,2017-03-14,St. Louis Blues,2,Central,Western,77,2,136,0.5661764705882353,79,-2,77,0
2016-17,2017-03-16,St. Louis Blues,0,Central,Western,77,2,138,0.5579710144927537,81,-4,77,0
2016-17,2017-03-17,St. Louis Blues,2,Central,Western,79,2,140,0.5642857142857143,81,-2,79,0
2016-17,2017-03-19,St. Louis Blues,2,Central,Western,81,2,142,0.5704225352112676,81,0,81,0
2016-17,2017-03-22,St. Louis Blues,2,Central,Western,83,2,144,0.5763888888888888,83,0,83,0
2016-17,2017-03-24,St. Louis Blues,2,Central,Western,85,2,146,0.5821917808219178,85,0,85,0
2016-17,2017-03-25,St. Louis Blues,1,Central,Western,86,2,148,0.581081081081081,86,0,85,1
2016-17,2017-03-28,St. Louis Blues,2,Central,Western,88,2,150,0.5866666666666667,89,-1,88,0
2016-17,2017-03-30,St. Louis Blues,2,Central,Western,90,2,152,0.5921052631578947,90,0,89,1
2016-17,2017-04-01,St. Louis Blues,1,Central,Western,91,2,154,0.5909090909090909,91,0,91,0
2016-17,2017-04-02,St. Louis Blues,2,Central,Western,93,2,156,0.5961538461538461,93,0,91,2
2016-17,2017-04-05,St. Louis Blues,0,Central,Western,93,2,158,0.5886075949367089,93,0,92,1
2016-17,2017-04-06,St. Louis Blues,2,Central,Western,95,2,160,0.59375,95,0,92,3
2016-17,2017-04-08,St. Louis Blues,2,Central,Western,97,2,162,0.5987654320987654,97,0,94,3
2016-17,2017-04-09,St. Louis Blues,2,Central,Western,99,2,164,0.6036585365853658,99,0,94,5
2016-17,2016-10-13,Tampa Bay Lightning,2,Atlantic,Eastern,2,2,2,1.0,2,0,1,1
2016-17,2016-10-15,Tampa Bay Lightning,2,Atlantic,Eastern,4,2,4,1.0,4,0,2,2
2016-17,2016-10-18,Tampa Bay Lightning,2,Atlantic,Eastern,6,2,6,1.0,5,1,4,2
2016-17,2016-10-20,Tampa Bay Lightning,0,Atlantic,Eastern,6,2,8,0.75,6,0,4,2
2016-17,2016-10-22,Tampa Bay Lightning,2,Atlantic,Eastern,8,2,10,0.8,8,0,6,2
2016-17,2016-10-25,Tampa Bay Lightning,2,Atlantic,Eastern,10,2,12,0.8333333333333334,10,0,7,3
2016-17,2016-10-27,Tampa Bay Lightning,0,Atlantic,Eastern,10,2,14,0.7142857142857143,10,0,7,3
2016-17,2016-10-29,Tampa Bay Lightning,0,Atlantic,Eastern,10,2,16,0.625,10,0,8,2
2016-17,2016-10-30,Tampa Bay Lightning,0,Atlantic,Eastern,10,2,18,0.5555555555555556,10,0,9,1
2016-17,2016-11-01,Tampa Bay Lightning,2,Atlantic,Eastern,12,2,20,0.6,12,0,10,2
2016-17,2016-11-03,Tampa Bay Lightning,1,Atlantic,Eastern,13,2,22,0.5909090909090909,13,0,13,0
2016-17,2016-11-05,Tampa Bay Lightning,2,Atlantic,Eastern,15,2,24,0.625,14,1,13,2
2016-17,2016-11-08,Tampa Bay Lightning,0,Atlantic,Eastern,15,2,26,0.5769230769230769,14,1,13,2
2016-17,2016-11-11,Tampa Bay Lightning,2,Atlantic,Eastern,17,2,28,0.6071428571428571,17,0,16,1
2016-17,2016-11-13,Tampa Bay Lightning,0,Atlantic,Eastern,17,2,30,0.5666666666666667,18,-1,17,0
2016-17,2016-11-15,Tampa Bay Lightning,2,Atlantic,Eastern,19,2,32,0.59375,19,0,19,0
2016-17,2016-11-16,Tampa Bay Lightning,2,Atlantic,Eastern,21,2,34,0.6176470588235294,21,0,20,1
2016-17,2016-11-18,Tampa Bay Lightning,2,Atlantic,Eastern,23,2,36,0.6388888888888888,21,2,20,3
2016-17,2016-11-19,Tampa Bay Lightning,2,Atlantic,Eastern,25,2,38,0.6578947368421053,21,4,20,5
2016-17,2016-11-22,Tampa Bay Lightning,0,Atlantic,Eastern,25,2,40,0.625,22,3,21,4
2016-17,2016-11-24,Tampa Bay Lightning,2,Atlantic,Eastern,27,2,42,0.6428571428571429,23,4,23,4
2016-17,2016-11-26,Tampa Bay Lightning,0,Atlantic,Eastern,27,2,44,0.6136363636363636,25,2,24,3
2016-17,2016-11-27,Tampa Bay Lightning,0,Atlantic,Eastern,27,2,46,0.5869565217391305,27,0,25,2
2016-17,2016-11-30,Tampa Bay Lightning,0,Atlantic,Eastern,27,2,48,0.5625,27,0,25,2
2016-17,2016-12-02,Tampa Bay Lightning,0,Atlantic,Eastern,27,2,50,0.54,27,0,27,0
2016-17,2016-12-04,Tampa Bay Lightning,2,Atlantic,Eastern,29,2,52,0.5576923076923077,30,-1,29,0
2016-17,2016-12-04,Tampa Bay Lightning,1,Atlantic,Eastern,30,2,54,0.5555555555555556,30,0,29,1
2016-17,2016-12-09,Tampa Bay Lightning,0,Atlantic,Eastern,30,2,56,0.5357142857142857,32,-2,32,-2
2016-17,2016-12-11,Tampa Bay Lightning,0,Atlantic,Eastern,30,2,58,0.5172413793103449,32,-2,32,-2
2016-17,2016-12-15,Tampa Bay Lightning,2,Atlantic,Eastern,32,2,60,0.5333333333333333,35,-3,35,-3
2016-17,2016-12-17,Tampa Bay Lightning,0,Atlantic,Eastern,32,2,62,0.5161290322580645,35,-3,35,-3
2016-17,2016-12-18,Tampa Bay Lightning,1,Atlantic,Eastern,33,2,64,0.515625,37,-4,37,-4
2016-17,2016-12-21,Tampa Bay Lightning,2,Atlantic,Eastern,35,2,66,0.5303030303030303,37,-2,37,-2
2016-17,2016-12-23,Tampa Bay Lightning,2,Atlantic,Eastern,37,2,68,0.5441176470588235,39,-2,39,-2
2016-17,2016-12-24,Tampa Bay Lightning,0,Atlantic,Eastern,37,2,70,0.5285714285714286,40,-3,40,-3
2016-17,2016-12-29,Tampa Bay Lightning,2,Atlantic,Eastern,39,2,72,0.5416666666666666,40,-1,40,-1
2016-17,2016-12-30,Tampa Bay Lightning,1,Atlantic,Eastern,40,2,74,0.5405405405405406,42,-2,42,-2
2016-17,2017-01-01,Tampa Bay Lightning,2,Atlantic,Eastern,42,2,76,0.5526315789473685,44,-2,44,-2
2016-17,2017-01-04,Tampa Bay Lightning,0,Atlantic,Eastern,42,2,78,0.5384615384615384,44,-2,44,-2
2016-17,2017-01-06,Tampa Bay Lightning,0,Atlantic,Eastern,42,2,80,0.525,44,-2,44,-2
2016-17,2017-01-07,Tampa Bay Lightning,0,Atlantic,Eastern,42,2,82,0.5121951219512195,44,-2,44,-2
2016-17,2017-01-08,Tampa Bay Lightning,0,Atlantic,Eastern,42,2,84,0.5,44,-2,44,-2
2016-17,2017-01-13,Tampa Bay Lightning,2,Atlantic,Eastern,44,2,86,0.5116279069767442,48,-4,48,-4
2016-17,2017-01-14,Tampa Bay Lightning,0,Atlantic,Eastern,44,2,88,0.5,48,-4,48,-4
2016-17,2017-01-16,Tampa Bay Lightning,2,Atlantic,Eastern,46,2,90,0.5111111111111111,48,-2,49,-3
2016-17,2017-01-18,Tampa Bay Lightning,1,Atlantic,Eastern,47,2,92,0.5108695652173914,50,-3,50,-3
2016-17,2017-01-20,Tampa Bay Lightning,0,Atlantic,Eastern,47,2,94,0.5,52,-5,50,-3
2016-17,2017-01-22,Tampa Bay Lightning,0,Atlantic,Eastern,47,2,96,0.4895833333333333,52,-5,52,-5
2016-17,2017-01-25,Tampa Bay Lightning,2,Atlantic,Eastern,49,2,98,0.5,54,-5,53,-4
2016-17,2017-01-27,Tampa Bay Lightning,1,Atlantic,Eastern,50,2,100,0.5,56,-6,56,-6
2016-17,2017-02-01,Tampa Bay Lightning,0,Atlantic,Eastern,50,2,102,0.49019607843137253,58,-8,56,-6
2016-17,2017-02-03,Tampa Bay Lightning,0,Atlantic,Eastern,50,2,104,0.4807692307692308,58,-8,58,-8
2016-17,2017-02-05,Tampa Bay Lightning,2,Atlantic,Eastern,52,2,106,0.49056603773584906,58,-6,58,-6
2016-17,2017-02-08,Tampa Bay Lightning,2,Atlantic,Eastern,54,2,108,0.5,60,-6,59,-5
2016-17,2017-02-11,Tampa Bay Lightning,1,Atlantic,Eastern,55,2,110,0.5,62,-7,61,-6
2016-17,2017-02-12,Tampa Bay Lightning,2,Atlantic,Eastern,57,2,112,0.5089285714285714,62,-5,61,-4
2016-17,2017-02-19,Tampa Bay Lightning,1,Atlantic,Eastern,58,2,114,0.5087719298245614,64,-6,64,-6
2016-17,2017-02-20,Tampa Bay Lightning,2,Atlantic,Eastern,60,2,116,0.5172413793103449,66,-6,65,-5
2016-17,2017-02-22,Tampa Bay Lightning,2,Atlantic,Eastern,62,2,118,0.5254237288135594,67,-5,66,-4
2016-17,2017-02-24,Tampa Bay Lightning,0,Atlantic,Eastern,62,2,120,0.5166666666666667,68,-6,68,-6
2016-17,2017-02-28,Tampa Bay Lightning,2,Atlantic,Eastern,64,2,122,0.5245901639344263,70,-6,69,-5
2016-17,2017-03-02,Tampa Bay Lightning,2,Atlantic,Eastern,66,2,124,0.532258064516129,72,-6,69,-3
2016-17,2017-03-04,Tampa Bay Lightning,0,Atlantic,Eastern,66,2,126,0.5238095238095238,72,-6,71,-5
2016-17,2017-03-05,Tampa Bay Lightning,2,Atlantic,Eastern,68,2,128,0.53125,74,-6,71,-3
2016-17,2017-03-07,Tampa Bay Lightning,1,Atlantic,Eastern,69,2,130,0.5307692307692308,74,-5,71,-2
2016-17,2017-03-10,Tampa Bay Lightning,2,Atlantic,Eastern,71,2,132,0.5378787878787878,76,-5,75,-4
2016-17,2017-03-12,Tampa Bay Lightning,2,Atlantic,Eastern,73,2,134,0.5447761194029851,78,-5,76,-3
2016-17,2017-03-13,Tampa Bay Lightning,2,Atlantic,Eastern,75,2,136,0.5514705882352942,78,-3,76,-1
2016-17,2017-03-14,Tampa Bay Lightning,2,Atlantic,Eastern,77,2,138,0.5579710144927537,80,-3,77,0
2016-17,2017-03-16,Tampa Bay Lightning,0,Atlantic,Eastern,77,2,140,0.55,82,-5,78,-1
2016-17,2017-03-18,Tampa Bay Lightning,0,Atlantic,Eastern,77,2,142,0.5422535211267606,82,-5,79,-2
2016-17,2017-03-21,Tampa Bay Lightning,0,Atlantic,Eastern,77,2,144,0.5347222222222222,82,-5,81,-4
2016-17,2017-03-23,Tampa Bay Lightning,2,Atlantic,Eastern,79,2,146,0.541095890410959,85,-6,82,-3
2016-17,2017-03-24,Tampa Bay Lightning,2,Atlantic,Eastern,81,2,148,0.5472972972972973,85,-4,82,-1
2016-17,2017-03-27,Tampa Bay Lightning,2,Atlantic,Eastern,83,2,150,0.5533333333333333,85,-2,84,-1
2016-17,2017-03-30,Tampa Bay Lightning,2,Atlantic,Eastern,85,2,152,0.5592105263157895,88,-3,87,-2
2016-17,2017-04-01,Tampa Bay Lightning,1,Atlantic,Eastern,86,2,154,0.5584415584415584,91,-5,90,-4
2016-17,2017-04-02,Tampa Bay Lightning,2,Atlantic,Eastern,88,2,156,0.5641025641025641,91,-3,91,-3
2016-17,2017-04-04,Tampa Bay Lightning,0,Atlantic,Eastern,88,2,158,0.5569620253164557,94,-6,93,-5
2016-17,2017-04-06,Tampa Bay Lightning,2,Atlantic,Eastern,90,2,160,0.5625,95,-5,93,-3
2016-17,2017-04-07,Tampa Bay Lightning,2,Atlantic,Eastern,92,2,162,0.5679012345679012,95,-3,93,-1
2016-17,2017-04-09,Tampa Bay Lightning,2,Atlantic,Eastern,94,2,164,0.573170731707317,95,-1,95,-1
2016-17,2016-10-12,Toronto Maple Leafs,1,Atlantic,Eastern,1,2,2,0.5,0,1,0,1
2016-17,2016-10-15,Toronto Maple Leafs,2,Atlantic,Eastern,3,2,4,0.75,4,-1,2,1
2016-17,2016-10-20,Toronto Maple Leafs,1,Atlantic,Eastern,4,2,6,0.6666666666666666,6,-2,4,0
2016-17,2016-10-21,Toronto Maple Leafs,0,Atlantic,Eastern,4,2,8,0.5,6,-2,5,-1
2016-17,2016-10-22,Toronto Maple Leafs,1,Atlantic,Eastern,5,2,10,0.5,8,-3,6,-1
2016-17,2016-10-25,Toronto Maple Leafs,0,Atlantic,Eastern,5,2,12,0.4166666666666667,10,-5,7,-2
2016-17,2016-10-27,Toronto Maple Leafs,2,Atlantic,Eastern,7,2,14,0.5,10,-3,7,0
2016-17,2016-10-29,Toronto Maple Leafs,0,Atlantic,Eastern,7,2,16,0.4375,10,-3,8,-1
2016-17,2016-10-30,Toronto Maple Leafs,0,Atlantic,Eastern,7,2,18,0.3888888888888889,10,-3,9,-2
2016-17,2016-11-01,Toronto Maple Leafs,2,Atlantic,Eastern,9,2,20,0.45,12,-3,10,-1
2016-17,2016-11-03,Toronto Maple Leafs,2,Atlantic,Eastern,11,2,22,0.5,13,-2,13,-2
2016-17,2016-11-05,Toronto Maple Leafs,2,Atlantic,Eastern,13,2,24,0.5416666666666666,14,-1,13,0
2016-17,2016-11-09,Toronto Maple Leafs,0,Atlantic,Eastern,13,2,26,0.5,15,-2,14,-1
2016-17,2016-11-12,Toronto Maple Leafs,2,Atlantic,Eastern,15,2,28,0.5357142857142857,17,-2,17,-2
2016-17,2016-11-13,Toronto Maple Leafs,0,Atlantic,Eastern,15,2,30,0.5,18,-3,17,-2
2016-17,2016-11-16,Toronto Maple Leafs,2,Atlantic,Eastern,17,2,32,0.53125,21,-4,20,-3
2016-17,2016-11-18,Toronto Maple Leafs,2,Atlantic,Eastern,19,2,34,0.5588235294117647,21,-2,20,-1
2016-17,2016-11-20,Toronto Maple Leafs,0,Atlantic,Eastern,19,2,36,0.5277777777777778,22,-3,21,-2
2016-17,2016-11-23,Toronto Maple Leafs,0,Atlantic,Eastern,19,2,38,0.5,23,-4,22,-3
2016-17,2016-11-24,Toronto Maple Leafs,1,Atlantic,Eastern,20,2,40,0.5,23,-3,23,-3
2016-17,2016-11-27,Toronto Maple Leafs,2,Atlantic,Eastern,22,2,42,0.5238095238095238,27,-5,25,-3
2016-17,2016-11-30,Toronto Maple Leafs,2,Atlantic,Eastern,24,2,44,0.5454545454545454,27,-3,25,-1
2016-17,2016-12-01,Toronto Maple Leafs,0,Atlantic,Eastern,24,2,46,0.5217391304347826,27,-3,25,-1
2016-17,2016-12-04,Toronto Maple Leafs,1,Atlantic,Eastern,25,2,48,0.5208333333333334,30,-5,29,-4
2016-17,2016-12-08,Toronto Maple Leafs,0,Atlantic,Eastern,25,2,50,0.5,32,-7,32,-7
2016-17,2016-12-11,Toronto Maple Leafs,2,Atlantic,Eastern,27,2,52,0.5192307692307693,32,-5,32,-5
2016-17,2016-12-12,Toronto Maple Leafs,0,Atlantic,Eastern,27,2,54,0.5,32,-5,32,-5
2016-17,2016-12-14,Toronto Maple Leafs,1,Atlantic,Eastern,28,2,56,0.5,34,-6,34,-6
2016-17,2016-12-16,Toronto Maple Leafs,1,Atlantic,Eastern,29,2,58,0.5,35,-6,35,-6
2016-17,2016-12-18,Toronto Maple Leafs,2,Atlantic,Eastern,31,2,60,0.5166666666666667,37,-6,37,-6
2016-17,2016-12-20,Toronto Maple Leafs,0,Atlantic,Eastern,31,2,62,0.5,37,-6,37,-6
2016-17,2016-12-23,Toronto Maple Leafs,2,Atlantic,Eastern,33,2,64,0.515625,39,-6,39,-6
2016-17,2016-12-24,Toronto Maple Leafs,2,Atlantic,Eastern,35,2,66,0.5303030303030303,40,-5,40,-5
2016-17,2016-12-29,Toronto Maple Leafs,2,Atlantic,Eastern,37,2,68,0.5441176470588235,40,-3,40,-3
2016-17,2016-12-30,Toronto Maple Leafs,2,Atlantic,Eastern,39,2,70,0.5571428571428572,42,-3,42,-3
2016-17,2017-01-01,Toronto Maple Leafs,2,Atlantic,Eastern,41,2,72,0.5694444444444444,44,-3,44,-3
2016-17,2017-01-04,Toronto Maple Leafs,1,Atlantic,Eastern,42,2,74,0.5675675675675675,44,-2,44,-2
2016-17,2017-01-07,Toronto Maple Leafs,2,Atlantic,Eastern,44,2,76,0.5789473684210527,44,0,44,0
2016-17,2017-01-08,Toronto Maple Leafs,0,Atlantic,Eastern,44,2,78,0.5641025641025641,44,0,44,0
2016-17,2017-01-14,Toronto Maple Leafs,2,Atlantic,Eastern,46,2,80,0.575,48,-2,48,-2
2016-17,2017-01-15,Toronto Maple Leafs,2,Atlantic,Eastern,48,2,82,0.5853658536585366,48,0,49,-1
2016-17,2017-01-18,Toronto Maple Leafs,2,Atlantic,Eastern,50,2,84,0.5952380952380952,50,0,50,0
2016-17,2017-01-20,Toronto Maple Leafs,0,Atlantic,Eastern,50,2,86,0.5813953488372093,52,-2,50,0
2016-17,2017-01-22,Toronto Maple Leafs,1,Atlantic,Eastern,51,2,88,0.5795454545454546,52,-1,52,-1
2016-17,2017-01-24,Toronto Maple Leafs,2,Atlantic,Eastern,53,2,90,0.5888888888888889,53,0,52,1
2016-17,2017-01-26,Toronto Maple Leafs,2,Atlantic,Eastern,55,2,92,0.5978260869565217,55,0,54,1
2016-17,2017-01-27,Toronto Maple Leafs,0,Atlantic,Eastern,55,2,94,0.5851063829787234,56,-1,56,-1
2016-17,2017-02-01,Toronto Maple Leafs,0,Atlantic,Eastern,55,2,96,0.5729166666666666,58,-3,56,-1
2016-17,2017-02-03,Toronto Maple Leafs,0,Atlantic,Eastern,55,2,98,0.5612244897959183,58,-3,58,-3
2016-17,2017-02-05,Toronto Maple Leafs,2,Atlantic,Eastern,57,2,100,0.57,58,-1,58,-1
2016-17,2017-02-07,Toronto Maple Leafs,1,Atlantic,Eastern,58,2,102,0.5686274509803921,58,0,58,0
2016-17,2017-02-08,Toronto Maple Leafs,2,Atlantic,Eastern,60,2,104,0.5769230769230769,60,0,59,1
2016-17,2017-02-10,Toronto Maple Leafs,1,Atlantic,Eastern,61,2,106,0.5754716981132075,61,0,60,1
2016-17,2017-02-12,Toronto Maple Leafs,0,Atlantic,Eastern,61,2,108,0.5648148148148148,62,-1,61,0
2016-17,2017-02-15,Toronto Maple Leafs,2,Atlantic,Eastern,63,2,110,0.5727272727272728,64,-1,63,0
2016-17,2017-02-16,Toronto Maple Leafs,0,Atlantic,Eastern,63,2,112,0.5625,64,-1,63,0
2016-17,2017-02-19,Toronto Maple Leafs,0,Atlantic,Eastern,63,2,114,0.5526315789473685,64,-1,64,-1
2016-17,2017-02-20,Toronto Maple Leafs,2,Atlantic,Eastern,65,2,116,0.5603448275862069,66,-1,65,0
2016-17,2017-02-22,Toronto Maple Leafs,2,Atlantic,Eastern,67,2,118,0.5677966101694916,67,0,66,1
2016-17,2017-02-24,Toronto Maple Leafs,1,Atlantic,Eastern,68,2,120,0.5666666666666667,68,0,68,0
2016-17,2017-02-26,Toronto Maple Leafs,1,Atlantic,Eastern,69,2,122,0.5655737704918032,70,-1,69,0
2016-17,2017-03-01,Toronto Maple Leafs,0,Atlantic,Eastern,69,2,124,0.5564516129032258,72,-3,69,0
2016-17,2017-03-03,Toronto Maple Leafs,1,Atlantic,Eastern,70,2,126,0.5555555555555556,72,-2,70,0
2016-17,2017-03-04,Toronto Maple Leafs,0,Atlantic,Eastern,70,2,128,0.546875,72,-2,71,-1
2016-17,2017-03-08,Toronto Maple Leafs,2,Atlantic,Eastern,72,2,130,0.5538461538461539,74,-2,73,-1
2016-17,2017-03-10,Toronto Maple Leafs,2,Atlantic,Eastern,74,2,132,0.5606060606060606,76,-2,75,-1
2016-17,2017-03-12,Toronto Maple Leafs,2,Atlantic,Eastern,76,2,134,0.5671641791044776,78,-2,76,0
2016-17,2017-03-14,Toronto Maple Leafs,0,Atlantic,Eastern,76,2,136,0.5588235294117647,80,-4,77,-1
2016-17,2017-03-16,Toronto Maple Leafs,2,Atlantic,Eastern,78,2,138,0.5652173913043478,82,-4,78,0
2016-17,2017-03-18,Toronto Maple Leafs,1,Atlantic,Eastern,79,2,140,0.5642857142857143,82,-3,79,0
2016-17,2017-03-20,Toronto Maple Leafs,2,Atlantic,Eastern,81,2,142,0.5704225352112676,82,-1,81,0
2016-17,2017-03-22,Toronto Maple Leafs,2,Atlantic,Eastern,83,2,144,0.5763888888888888,83,0,82,1
2016-17,2017-03-23,Toronto Maple Leafs,2,Atlantic,Eastern,85,2,146,0.5821917808219178,85,0,82,3
2016-17,2017-03-25,Toronto Maple Leafs,0,Atlantic,Eastern,85,2,148,0.5743243243243243,85,0,84,1
2016-17,2017-03-28,Toronto Maple Leafs,2,Atlantic,Eastern,87,2,150,0.58,87,0,86,1
2016-17,2017-03-31,Toronto Maple Leafs,2,Atlantic,Eastern,89,2,152,0.5855263157894737,89,0,88,1
2016-17,2017-04-01,Toronto Maple Leafs,2,Atlantic,Eastern,91,2,154,0.5909090909090909,91,0,90,1
2016-17,2017-04-03,Toronto Maple Leafs,2,Atlantic,Eastern,93,2,156,0.5961538461538461,92,1,92,1
2016-17,2017-04-04,Toronto Maple Leafs,0,Atlantic,Eastern,93,2,158,0.5886075949367089,94,-1,93,0
2016-17,2017-04-06,Toronto Maple Leafs,0,Atlantic,Eastern,93,2,160,0.58125,95,-2,93,0
2016-17,2017-04-08,Toronto Maple Leafs,2,Atlantic,Eastern,95,2,162,0.5864197530864198,95,0,95,0
2016-17,2017-04-09,Toronto Maple Leafs,0,Atlantic,Eastern,95,2,164,0.5792682926829268,95,0,95,0
2016-17,2016-10-16,Vancouver Canucks,2,Pacific,Western,2,2,2,1.0,2,0,2,0
2016-17,2016-10-17,Vancouver Canucks,2,Pacific,Western,4,2,4,1.0,4,0,2,2
2016-17,2016-10-19,Vancouver Canucks,2,Pacific,Western,6,2,6,1.0,6,0,4,2
2016-17,2016-10-21,Vancouver Canucks,2,Pacific,Western,8,2,8,1.0,6,2,4,4
2016-17,2016-10-23,Vancouver Canucks,1,Pacific,Western,9,2,10,0.9,6,3,5,4
2016-17,2016-10-24,Vancouver Canucks,0,Pacific,Western,9,2,12,0.75,6,3,5,4
2016-17,2016-10-26,Vancouver Canucks,0,Pacific,Western,9,2,14,0.6428571428571429,8,1,7,2
2016-17,2016-10-29,Vancouver Canucks,0,Pacific,Western,9,2,16,0.5625,9,0,8,1
2016-17,2016-10-30,Vancouver Canucks,0,Pacific,Western,9,2,18,0.5,9,0,8,1
2016-17,2016-11-02,Vancouver Canucks,0,Pacific,Western,9,2,20,0.45,10,-1,9,0
2016-17,2016-11-03,Vancouver Canucks,0,Pacific,Western,9,2,22,0.4090909090909091,10,-1,9,0
2016-17,2016-11-05,Vancouver Canucks,0,Pacific,Western,9,2,24,0.375,12,-3,11,-2
2016-17,2016-11-08,Vancouver Canucks,0,Pacific,Western,9,2,26,0.34615384615384615,12,-3,11,-2
2016-17,2016-11-09,Vancouver Canucks,2,Pacific,Western,11,2,28,0.39285714285714285,14,-3,13,-2
2016-17,2016-11-11,Vancouver Canucks,0,Pacific,Western,11,2,30,0.36666666666666664,16,-5,14,-3
2016-17,2016-11-13,Vancouver Canucks,2,Pacific,Western,13,2,32,0.40625,17,-4,16,-3
2016-17,2016-11-16,Vancouver Canucks,0,Pacific,Western,13,2,34,0.38235294117647056,18,-5,17,-4
2016-17,2016-11-18,Vancouver Canucks,2,Pacific,Western,15,2,36,0.4166666666666667,18,-3,18,-3
2016-17,2016-11-20,Vancouver Canucks,1,Pacific,Western,16,2,38,0.42105263157894735,19,-3,19,-3
2016-17,2016-11-24,Vancouver Canucks,2,Pacific,Western,18,2,40,0.45,23,-5,21,-3
2016-17,2016-11-26,Vancouver Canucks,0,Pacific,Western,18,2,42,0.42857142857142855,23,-5,23,-5
2016-17,2016-11-27,Vancouver Canucks,2,Pacific,Western,20,2,44,0.45454545454545453,25,-5,23,-3
2016-17,2016-11-30,Vancouver Canucks,2,Pacific,Western,22,2,46,0.4782608695652174,26,-4,25,-3
2016-17,2016-12-02,Vancouver Canucks,0,Pacific,Western,22,2,48,0.4583333333333333,28,-6,25,-3
2016-17,2016-12-04,Vancouver Canucks,2,Pacific,Western,24,2,50,0.48,29,-5,26,-2
2016-17,2016-12-07,Vancouver Canucks,0,Pacific,Western,24,2,52,0.46153846153846156,30,-6,28,-4
2016-17,2016-12-09,Vancouver Canucks,2,Pacific,Western,26,2,54,0.48148148148148145,31,-5,29,-3
2016-17,2016-12-11,Vancouver Canucks,0,Pacific,Western,26,2,56,0.4642857142857143,33,-7,30,-4
2016-17,2016-12-11,Vancouver Canucks,0,Pacific,Western,26,2,58,0.4482758620689655,33,-7,30,-4
2016-17,2016-12-14,Vancouver Canucks,0,Pacific,Western,26,2,60,0.43333333333333335,35,-9,30,-4
2016-17,2016-12-17,Vancouver Canucks,2,Pacific,Western,28,2,62,0.45161290322580644,35,-7,34,-6
2016-17,2016-12-18,Vancouver Canucks,1,Pacific,Western,29,2,64,0.453125,37,-8,34,-5
2016-17,2016-12-21,Vancouver Canucks,2,Pacific,Western,31,2,66,0.4696969696969697,39,-8,35,-4
2016-17,2016-12-23,Vancouver Canucks,0,Pacific,Western,31,2,68,0.45588235294117646,40,-9,36,-5
2016-17,2016-12-24,Vancouver Canucks,0,Pacific,Western,31,2,70,0.44285714285714284,40,-9,38,-7
2016-17,2016-12-29,Vancouver Canucks,2,Pacific,Western,33,2,72,0.4583333333333333,41,-8,38,-5
2016-17,2016-12-31,Vancouver Canucks,2,Pacific,Western,35,2,74,0.47297297297297297,44,-9,39,-4
2016-17,2017-01-01,Vancouver Canucks,2,Pacific,Western,37,2,76,0.4868421052631579,44,-7,40,-3
2016-17,2017-01-03,Vancouver Canucks,2,Pacific,Western,39,2,78,0.5,45,-6,40,-1
2016-17,2017-01-05,Vancouver Canucks,2,Pacific,Western,41,2,80,0.5125,45,-4,42,-1
2016-17,2017-01-07,Vancouver Canucks,2,Pacific,Western,43,2,82,0.524390243902439,47,-4,44,-1
2016-17,2017-01-08,Vancouver Canucks,0,Pacific,Western,43,2,84,0.5119047619047619,49,-6,44,-1
2016-17,2017-01-11,Vancouver Canucks,1,Pacific,Western,44,2,86,0.5116279069767442,49,-5,44,0
2016-17,2017-01-13,Vancouver Canucks,1,Pacific,Western,45,2,88,0.5113636363636364,51,-6,46,-1
2016-17,2017-01-16,Vancouver Canucks,1,Pacific,Western,46,2,90,0.5111111111111111,53,-7,48,-2
2016-17,2017-01-18,Vancouver Canucks,2,Pacific,Western,48,2,92,0.5217391304347826,54,-6,48,0
2016-17,2017-01-21,Vancouver Canucks,2,Pacific,Western,50,2,94,0.5319148936170213,58,-8,51,-1
2016-17,2017-01-23,Vancouver Canucks,0,Pacific,Western,50,2,96,0.5208333333333334,60,-10,51,-1
2016-17,2017-01-26,Vancouver Canucks,2,Pacific,Western,52,2,98,0.5306122448979592,62,-10,52,0
2016-17,2017-01-27,Vancouver Canucks,0,Pacific,Western,52,2,100,0.52,63,-11,53,-1
2016-17,2017-02-03,Vancouver Canucks,0,Pacific,Western,52,2,102,0.5098039215686274,64,-12,55,-3
2016-17,2017-02-05,Vancouver Canucks,0,Pacific,Western,52,2,104,0.5,66,-14,57,-5
2016-17,2017-02-08,Vancouver Canucks,0,Pacific,Western,52,2,106,0.49056603773584906,66,-14,59,-7
2016-17,2017-02-10,Vancouver Canucks,2,Pacific,Western,54,2,108,0.5,66,-12,60,-6
2016-17,2017-02-11,Vancouver Canucks,0,Pacific,Western,54,2,110,0.4909090909090909,66,-12,60,-6
2016-17,2017-02-13,Vancouver Canucks,2,Pacific,Western,56,2,112,0.5,66,-10,60,-4
2016-17,2017-02-15,Vancouver Canucks,0,Pacific,Western,56,2,114,0.49122807017543857,68,-12,60,-4
2016-17,2017-02-17,Vancouver Canucks,0,Pacific,Western,56,2,116,0.4827586206896552,70,-14,61,-5
2016-17,2017-02-19,Vancouver Canucks,2,Pacific,Western,58,2,118,0.4915254237288136,70,-12,62,-4
2016-17,2017-02-20,Vancouver Canucks,0,Pacific,Western,58,2,120,0.48333333333333334,72,-14,62,-4
2016-17,2017-02-26,Vancouver Canucks,0,Pacific,Western,58,2,122,0.47540983606557374,74,-16,67,-9
2016-17,2017-03-01,Vancouver Canucks,1,Pacific,Western,59,2,124,0.47580645161290325,74,-15,67,-8
2016-17,2017-03-03,Vancouver Canucks,0,Pacific,Western,59,2,126,0.46825396825396826,74,-15,68,-9
2016-17,2017-03-05,Vancouver Canucks,2,Pacific,Western,61,2,128,0.4765625,76,-15,68,-7
2016-17,2017-03-06,Vancouver Canucks,2,Pacific,Western,63,2,130,0.4846153846153846,76,-13,69,-6
2016-17,2017-03-08,Vancouver Canucks,1,Pacific,Western,64,2,132,0.48484848484848486,78,-14,71,-7
2016-17,2017-03-10,Vancouver Canucks,1,Pacific,Western,65,2,134,0.48507462686567165,78,-13,71,-6
2016-17,2017-03-12,Vancouver Canucks,0,Pacific,Western,65,2,136,0.47794117647058826,80,-15,75,-10
2016-17,2017-03-14,Vancouver Canucks,0,Pacific,Western,65,2,138,0.47101449275362317,82,-17,77,-12
2016-17,2017-03-17,Vancouver Canucks,0,Pacific,Western,65,2,140,0.4642857142857143,83,-18,79,-14
2016-17,2017-03-19,Vancouver Canucks,0,Pacific,Western,65,2,142,0.45774647887323944,85,-20,81,-16
2016-17,2017-03-22,Vancouver Canucks,2,Pacific,Western,67,2,144,0.4652777777777778,87,-20,83,-16
2016-17,2017-03-24,Vancouver Canucks,0,Pacific,Western,67,2,146,0.4589041095890411,89,-22,85,-18
2016-17,2017-03-25,Vancouver Canucks,2,Pacific,Western,69,2,148,0.46621621621621623,89,-20,85,-16
2016-17,2017-03-27,Vancouver Canucks,0,Pacific,Western,69,2,150,0.46,91,-22,86,-17
2016-17,2017-03-29,Vancouver Canucks,0,Pacific,Western,69,2,152,0.45394736842105265,93,-24,88,-19
2016-17,2017-04-01,Vancouver Canucks,0,Pacific,Western,69,2,154,0.44805194805194803,93,-24,91,-22
2016-17,2017-04-02,Vancouver Canucks,0,Pacific,Western,69,2,156,0.4423076923076923,95,-26,91,-22
2016-17,2017-04-05,Vancouver Canucks,0,Pacific,Western,69,2,158,0.43670886075949367,97,-28,92,-23
2016-17,2017-04-07,Vancouver Canucks,0,Pacific,Western,69,2,160,0.43125,97,-28,94,-25
2016-17,2017-04-09,Vancouver Canucks,0,Pacific,Western,69,2,162,0.42592592592592593,99,-30,94,-25
2016-17,2017-04-10,Vancouver Canucks,0,Pacific,Western,69,2,164,0.42073170731707316,99,-30,94,-25
2016-17,2016-10-14,Washington Capitals,1,Metropolitan,Eastern,1,2,2,0.5,1,0,1,0
2016-17,2016-10-15,Washington Capitals,2,Metropolitan,Eastern,3,2,4,0.75,2,1,2,1
2016-17,2016-10-18,Washington Capitals,2,Metropolitan,Eastern,5,2,6,0.8333333333333334,4,1,4,1
2016-17,2016-10-20,Washington Capitals,2,Metropolitan,Eastern,7,2,8,0.875,4,3,4,3
2016-17,2016-10-22,Washington Capitals,0,Metropolitan,Eastern,7,2,10,0.7,6,1,6,1
2016-17,2016-10-27,Washington Capitals,0,Metropolitan,Eastern,7,2,12,0.5833333333333334,7,0,7,0
2016-17,2016-10-30,Washington Capitals,2,Metropolitan,Eastern,9,2,14,0.6428571428571429,10,-1,9,0
2016-17,2016-10-31,Washington Capitals,2,Metropolitan,Eastern,11,2,16,0.6875,11,0,10,1
2016-17,2016-11-02,Washington Capitals,2,Metropolitan,Eastern,13,2,18,0.7222222222222222,13,0,10,3
2016-17,2016-11-03,Washington Capitals,2,Metropolitan,Eastern,15,2,20,0.75,15,0,13,2
2016-17,2016-11-05,Washington Capitals,2,Metropolitan,Eastern,17,2,22,0.7727272727272727,16,1,13,4
2016-17,2016-11-09,Washington Capitals,0,Metropolitan,Eastern,17,2,24,0.7083333333333334,17,0,14,3
2016-17,2016-11-12,Washington Capitals,2,Metropolitan,Eastern,19,2,26,0.7307692307692307,19,0,17,2
2016-17,2016-11-13,Washington Capitals,0,Metropolitan,Eastern,19,2,28,0.6785714285714286,19,0,17,2
2016-17,2016-11-16,Washington Capitals,1,Metropolitan,Eastern,20,2,30,0.6666666666666666,21,-1,20,0
2016-17,2016-11-17,Washington Capitals,2,Metropolitan,Eastern,22,2,32,0.6875,22,0,20,2
2016-17,2016-11-19,Washington Capitals,2,Metropolitan,Eastern,24,2,34,0.7058823529411765,24,0,20,4
2016-17,2016-11-20,Washington Capitals,0,Metropolitan,Eastern,24,2,36,0.6666666666666666,24,0,21,3
2016-17,2016-11-24,Washington Capitals,2,Metropolitan,Eastern,26,2,38,0.6842105263157895,26,0,23,3
2016-17,2016-11-25,Washington Capitals,2,Metropolitan,Eastern,28,2,40,0.7,27,1,23,5
2016-17,2016-11-27,Washington Capitals,0,Metropolitan,Eastern,28,2,42,0.6666666666666666,28,0,25,3
2016-17,2016-12-02,Washington Capitals,0,Metropolitan,Eastern,28,2,44,0.6363636363636364,30,-2,27,1
2016-17,2016-12-04,Washington Capitals,1,Metropolitan,Eastern,29,2,46,0.6304347826086957,32,-3,29,0
2016-17,2016-12-06,Washington Capitals,2,Metropolitan,Eastern,31,2,48,0.6458333333333334,34,-3,31,0
2016-17,2016-12-08,Washington Capitals,2,Metropolitan,Eastern,33,2,50,0.66,34,-1,32,1
2016-17,2016-12-10,Washington Capitals,2,Metropolitan,Eastern,35,2,52,0.6730769230769231,37,-2,32,3
2016-17,2016-12-11,Washington Capitals,2,Metropolitan,Eastern,37,2,54,0.6851851851851852,39,-2,32,5
2016-17,2016-12-14,Washington Capitals,2,Metropolitan,Eastern,39,2,56,0.6964285714285714,40,-1,34,5
2016-17,2016-12-17,Washington Capitals,2,Metropolitan,Eastern,41,2,58,0.7068965517241379,42,-1,35,6
2016-17,2016-12-18,Washington Capitals,0,Metropolitan,Eastern,41,2,60,0.6833333333333333,44,-3,37,4
2016-17,2016-12-22,Washington Capitals,1,Metropolitan,Eastern,42,2,62,0.6774193548387096,46,-4,37,5
2016-17,2016-12-24,Washington Capitals,2,Metropolitan,Eastern,44,2,64,0.6875,47,-3,40,4
2016-17,2016-12-28,Washington Capitals,0,Metropolitan,Eastern,44,2,66,0.6666666666666666,49,-5,40,4
2016-17,2016-12-30,Washington Capitals,1,Metropolitan,Eastern,45,2,68,0.6617647058823529,51,-6,42,3
2016-17,2016-12-31,Washington Capitals,2,Metropolitan,Eastern,47,2,70,0.6714285714285714,51,-4,44,3
2016-17,2017-01-02,Washington Capitals,2,Metropolitan,Eastern,49,2,72,0.6805555555555556,53,-4,44,5
2016-17,2017-01-04,Washington Capitals,2,Metropolitan,Eastern,51,2,74,0.6891891891891891,53,-2,44,7
2016-17,2017-01-06,Washington Capitals,2,Metropolitan,Eastern,53,2,76,0.6973684210526315,55,-2,44,9
2016-17,2017-01-08,Washington Capitals,2,Metropolitan,Eastern,55,2,78,0.7051282051282052,57,-2,44,11
2016-17,2017-01-10,Washington Capitals,2,Metropolitan,Eastern,57,2,80,0.7125,57,0,46,11
2016-17,2017-01-12,Washington Capitals,2,Metropolitan,Eastern,59,2,82,0.7195121951219512,57,2,46,13
2016-17,2017-01-14,Washington Capitals,2,Metropolitan,Eastern,61,2,84,0.7261904761904762,57,4,48,13
2016-17,2017-01-15,Washington Capitals,2,Metropolitan,Eastern,63,2,86,0.7325581395348837,57,6,49,14
2016-17,2017-01-17,Washington Capitals,1,Metropolitan,Eastern,64,2,88,0.7272727272727273,59,5,49,15
2016-17,2017-01-20,Washington Capitals,2,Metropolitan,Eastern,66,2,90,0.7333333333333333,61,5,50,16
2016-17,2017-01-22,Washington Capitals,2,Metropolitan,Eastern,68,2,92,0.7391304347826086,65,3,52,16
2016-17,2017-01-24,Washington Capitals,2,Metropolitan,Eastern,70,2,94,0.7446808510638298,65,5,52,18
2016-17,2017-01-25,Washington Capitals,0,Metropolitan,Eastern,70,2,96,0.7291666666666666,65,5,53,17
2016-17,2017-01-27,Washington Capitals,2,Metropolitan,Eastern,72,2,98,0.7346938775510204,65,7,56,16
2016-17,2017-02-01,Washington Capitals,0,Metropolitan,Eastern,72,2,100,0.72,67,5,56,16
2016-17,2017-02-02,Washington Capitals,2,Metropolitan,Eastern,74,2,102,0.7254901960784313,67,7,56,18
2016-17,2017-02-04,Washington Capitals,2,Metropolitan,Eastern,76,2,104,0.7307692307692307,69,7,58,18
2016-17,2017-02-05,Washington Capitals,2,Metropolitan,Eastern,78,2,106,0.7358490566037735,71,7,58,20
2016-17,2017-02-08,Washington Capitals,2,Metropolitan,Eastern,80,2,108,0.7407407407407407,72,8,59,21
2016-17,2017-02-10,Washington Capitals,2,Metropolitan,Eastern,82,2,110,0.7454545454545455,73,9,60,22
2016-17,2017-02-12,Washington Capitals,2,Metropolitan,Eastern,84,2,112,0.75,75,9,61,23
2016-17,2017-02-18,Washington Capitals,1,Metropolitan,Eastern,85,2,114,0.7456140350877193,79,6,63,22
2016-17,2017-02-19,Washington Capitals,0,Metropolitan,Eastern,85,2,116,0.7327586206896551,79,6,64,21
2016-17,2017-02-23,Washington Capitals,2,Metropolitan,Eastern,87,2,118,0.7372881355932204,79,8,66,21
2016-17,2017-02-25,Washington Capitals,2,Metropolitan,Eastern,89,2,120,0.7416666666666667,82,7,68,21
2016-17,2017-02-25,Washington Capitals,0,Metropolitan,Eastern,89,2,122,0.7295081967213115,82,7,68,21
2016-17,2017-03-01,Washington Capitals,2,Metropolitan,Eastern,91,2,124,0.7338709677419355,84,7,69,22
2016-17,2017-03-03,Washington Capitals,2,Metropolitan,Eastern,93,2,126,0.7380952380952381,84,9,70,23
2016-17,2017-03-05,Washington Capitals,2,Metropolitan,Eastern,95,2,128,0.7421875,86,9,71,24
2016-17,2017-03-07,Washington Capitals,0,Metropolitan,Eastern,95,2,130,0.7307692307692307,86,9,71,24
2016-17,2017-03-10,Washington Capitals,0,Metropolitan,Eastern,95,2,132,0.7196969696969697,90,5,75,20
2016-17,2017-03-12,Washington Capitals,0,Metropolitan,Eastern,95,2,134,0.7089552238805971,92,3,76,19
2016-17,2017-03-13,Washington Capitals,0,Metropolitan,Eastern,95,2,136,0.6985294117647058,94,1,76,19
2016-17,2017-03-14,Washington Capitals,2,Metropolitan,Eastern,97,2,138,0.7028985507246377,94,3,77,20
2016-17,2017-03-16,Washington Capitals,1,Metropolitan,Eastern,98,2,140,0.7,95,3,78,20
2016-17,2017-03-18,Washington Capitals,2,Metropolitan,Eastern,100,2,142,0.704225352112676,97,3,79,21
2016-17,2017-03-21,Washington Capitals,2,Metropolitan,Eastern,102,2,144,0.7083333333333334,100,2,81,21
2016-17,2017-03-23,Washington Capitals,2,Metropolitan,Eastern,104,2,146,0.7123287671232876,101,3,82,22
2016-17,2017-03-25,Washington Capitals,2,Metropolitan,Eastern,106,2,148,0.7162162162162162,103,3,84,22
2016-17,2017-03-29,Washington Capitals,2,Metropolitan,Eastern,108,2,150,0.72,103,5,86,22
2016-17,2017-03-30,Washington Capitals,2,Metropolitan,Eastern,110,2,152,0.7236842105263158,103,7,87,23
2016-17,2017-04-01,Washington Capitals,0,Metropolitan,Eastern,110,2,154,0.7142857142857143,105,5,90,20
2016-17,2017-04-02,Washington Capitals,2,Metropolitan,Eastern,112,2,156,0.717948717948718,106,6,91,21
2016-17,2017-04-04,Washington Capitals,2,Metropolitan,Eastern,114,2,158,0.7215189873417721,106,8,93,21
2016-17,2017-04-06,Washington Capitals,2,Metropolitan,Eastern,116,2,160,0.725,106,10,93,23
2016-17,2017-04-08,Washington Capitals,2,Metropolitan,Eastern,118,2,162,0.7283950617283951,106,12,95,23
2016-17,2017-04-09,Washington Capitals,0,Metropolitan,Eastern,118,2,164,0.7195121951219512,108,10,95,23
2016-17,2016-10-14,Winnipeg Jets,2,Central,Western,2,2,2,1.0,2,0,0,2
2016-17,2016-10-15,Winnipeg Jets,0,Central,Western,2,2,4,0.5,2,0,0,2
2016-17,2016-10-18,Winnipeg Jets,0,Central,Western,2,2,6,0.3333333333333333,2,0,2,0
2016-17,2016-10-20,Winnipeg Jets,2,Central,Western,4,2,8,0.5,4,0,4,0
2016-17,2016-10-23,Winnipeg Jets,0,Central,Western,4,2,10,0.4,6,-2,5,-1
2016-17,2016-10-26,Winnipeg Jets,0,Central,Western,4,2,12,0.3333333333333333,7,-3,7,-3
2016-17,2016-10-28,Winnipeg Jets,2,Central,Western,6,2,14,0.42857142857142855,9,-3,8,-2
2016-17,2016-10-29,Winnipeg Jets,2,Central,Western,8,2,16,0.5,9,-1,8,0
2016-17,2016-10-30,Winnipeg Jets,0,Central,Western,8,2,18,0.4444444444444444,11,-3,8,0
2016-17,2016-11-02,Winnipeg Jets,0,Central,Western,8,2,20,0.4,12,-4,9,-1
2016-17,2016-11-03,Winnipeg Jets,1,Central,Western,9,2,22,0.4090909090909091,12,-3,9,0
2016-17,2016-11-04,Winnipeg Jets,2,Central,Western,11,2,24,0.4583333333333333,12,-1,10,1
2016-17,2016-11-07,Winnipeg Jets,0,Central,Western,11,2,26,0.4230769230769231,13,-2,11,0
2016-17,2016-11-09,Winnipeg Jets,2,Central,Western,13,2,28,0.4642857142857143,13,0,13,0
2016-17,2016-11-11,Winnipeg Jets,2,Central,Western,15,2,30,0.5,15,0,14,1
2016-17,2016-11-12,Winnipeg Jets,1,Central,Western,16,2,32,0.5,16,0,15,1
2016-17,2016-11-13,Winnipeg Jets,2,Central,Western,18,2,34,0.5294117647058824,17,1,16,2
2016-17,2016-11-16,Winnipeg Jets,2,Central,Western,20,2,36,0.5555555555555556,19,1,17,3
2016-17,2016-11-18,Winnipeg Jets,0,Central,Western,20,2,38,0.5263157894736842,20,0,18,2
2016-17,2016-11-20,Winnipeg Jets,0,Central,Western,20,2,40,0.5,20,0,19,1
2016-17,2016-11-20,Winnipeg Jets,0,Central,Western,20,2,42,0.47619047619047616,20,0,19,1
2016-17,2016-11-24,Winnipeg Jets,0,Central,Western,20,2,44,0.45454545454545453,22,-2,21,-1
2016-17,2016-11-25,Winnipeg Jets,0,Central,Western,20,2,46,0.43478260869565216,24,-4,22,-2
2016-17,2016-11-27,Winnipeg Jets,2,Central,Western,22,2,48,0.4583333333333333,25,-3,23,-1
2016-17,2016-11-30,Winnipeg Jets,2,Central,Western,24,2,50,0.48,25,-1,25,-1
2016-17,2016-12-02,Winnipeg Jets,0,Central,Western,24,2,52,0.46153846153846156,25,-1,25,-1
2016-17,2016-12-04,Winnipeg Jets,2,Central,Western,26,2,54,0.48148148148148145,26,0,26,0
2016-17,2016-12-05,Winnipeg Jets,2,Central,Western,28,2,56,0.5,28,0,28,0
2016-17,2016-12-07,Winnipeg Jets,1,Central,Western,29,2,58,0.5,29,0,28,1
2016-17,2016-12-09,Winnipeg Jets,0,Central,Western,29,2,60,0.48333333333333334,30,-1,29,0
2016-17,2016-12-11,Winnipeg Jets,0,Central,Western,29,2,62,0.46774193548387094,34,-5,30,-1
2016-17,2016-12-12,Winnipeg Jets,0,Central,Western,29,2,64,0.453125,34,-5,30,-1
2016-17,2016-12-16,Winnipeg Jets,2,Central,Western,31,2,66,0.4696969696969697,38,-7,32,-1
2016-17,2016-12-18,Winnipeg Jets,2,Central,Western,33,2,68,0.4852941176470588,38,-5,34,-1
2016-17,2016-12-21,Winnipeg Jets,0,Central,Western,33,2,70,0.4714285714285714,41,-8,35,-2
2016-17,2016-12-23,Winnipeg Jets,2,Central,Western,35,2,72,0.4861111111111111,41,-6,36,-1
2016-17,2016-12-28,Winnipeg Jets,2,Central,Western,37,2,74,0.5,41,-4,38,-1
2016-17,2016-12-30,Winnipeg Jets,0,Central,Western,37,2,76,0.4868421052631579,43,-6,39,-2
2016-17,2017-01-01,Winnipeg Jets,0,Central,Western,37,2,78,0.47435897435897434,43,-6,40,-3
2016-17,2017-01-04,Winnipeg Jets,2,Central,Western,39,2,80,0.4875,45,-6,42,-3
2016-17,2017-01-05,Winnipeg Jets,2,Central,Western,41,2,82,0.5,45,-4,42,-1
2016-17,2017-01-07,Winnipeg Jets,0,Central,Western,41,2,84,0.4880952380952381,45,-4,44,-3
2016-17,2017-01-10,Winnipeg Jets,2,Central,Western,43,2,86,0.5,47,-4,44,-1
2016-17,2017-01-12,Winnipeg Jets,0,Central,Western,43,2,88,0.48863636363636365,47,-4,44,-1
2016-17,2017-01-14,Winnipeg Jets,0,Central,Western,43,2,90,0.4777777777777778,47,-4,47,-4
2016-17,2017-01-15,Winnipeg Jets,1,Central,Western,44,2,92,0.4782608695652174,49,-5,48,-4
2016-17,2017-01-16,Winnipeg Jets,0,Central,Western,44,2,94,0.46808510638297873,51,-7,48,-4
2016-17,2017-01-19,Winnipeg Jets,2,Central,Western,46,2,96,0.4791666666666667,51,-5,48,-2
2016-17,2017-01-21,Winnipeg Jets,2,Central,Western,48,2,98,0.4897959183673469,51,-3,51,-3
2016-17,2017-01-24,Winnipeg Jets,0,Central,Western,48,2,100,0.48,53,-5,51,-3
2016-17,2017-01-25,Winnipeg Jets,0,Central,Western,48,2,102,0.47058823529411764,54,-6,51,-3
2016-17,2017-01-27,Winnipeg Jets,2,Central,Western,50,2,104,0.4807692307692308,56,-6,53,-3
2016-17,2017-02-01,Winnipeg Jets,2,Central,Western,52,2,106,0.49056603773584906,56,-4,53,-1
2016-17,2017-02-03,Winnipeg Jets,2,Central,Western,54,2,108,0.5,58,-4,55,-1
2016-17,2017-02-04,Winnipeg Jets,0,Central,Western,54,2,110,0.4909090909090909,58,-4,57,-3
2016-17,2017-02-08,Winnipeg Jets,0,Central,Western,54,2,112,0.48214285714285715,60,-6,59,-5
2016-17,2017-02-11,Winnipeg Jets,0,Central,Western,54,2,114,0.47368421052631576,61,-7,60,-6
2016-17,2017-02-12,Winnipeg Jets,0,Central,Western,54,2,116,0.46551724137931033,63,-9,60,-6
2016-17,2017-02-15,Winnipeg Jets,2,Central,Western,56,2,118,0.4745762711864407,63,-7,60,-4
2016-17,2017-02-17,Winnipeg Jets,1,Central,Western,57,2,120,0.475,67,-10,61,-4
2016-17,2017-02-18,Winnipeg Jets,2,Central,Western,59,2,122,0.48360655737704916,67,-8,61,-2
2016-17,2017-02-19,Winnipeg Jets,2,Central,Western,61,2,124,0.49193548387096775,67,-6,62,-1
2016-17,2017-02-22,Winnipeg Jets,1,Central,Western,62,2,126,0.49206349206349204,67,-5,64,-2
2016-17,2017-03-01,Winnipeg Jets,0,Central,Western,62,2,128,0.484375,73,-11,67,-5
2016-17,2017-03-04,Winnipeg Jets,2,Central,Western,64,2,130,0.49230769230769234,73,-9,68,-4
2016-17,2017-03-05,Winnipeg Jets,2,Central,Western,66,2,132,0.5,73,-7,68,-2
2016-17,2017-03-07,Winnipeg Jets,0,Central,Western,66,2,134,0.4925373134328358,73,-7,69,-3
2016-17,2017-03-09,Winnipeg Jets,0,Central,Western,66,2,136,0.4852941176470588,74,-8,71,-5
2016-17,2017-03-12,Winnipeg Jets,0,Central,Western,66,2,138,0.4782608695652174,77,-11,75,-9
2016-17,2017-03-14,Winnipeg Jets,1,Central,Western,67,2,140,0.4785714285714286,79,-12,77,-10
2016-17,2017-03-16,Winnipeg Jets,2,Central,Western,69,2,142,0.4859154929577465,81,-12,77,-8
2016-17,2017-03-19,Winnipeg Jets,2,Central,Western,71,2,144,0.4930555555555556,81,-10,81,-10
2016-17,2017-03-22,Winnipeg Jets,2,Central,Western,73,2,146,0.5,83,-10,83,-10
2016-17,2017-03-24,Winnipeg Jets,0,Central,Western,73,2,148,0.49324324324324326,85,-12,85,-12
2016-17,2017-03-25,Winnipeg Jets,0,Central,Western,73,2,150,0.4866666666666667,86,-13,85,-12
2016-17,2017-03-27,Winnipeg Jets,2,Central,Western,75,2,152,0.4934210526315789,89,-14,86,-11
2016-17,2017-03-28,Winnipeg Jets,2,Central,Western,77,2,154,0.5,89,-12,88,-11
2016-17,2017-03-31,Winnipeg Jets,2,Central,Western,79,2,156,0.5064102564102564,90,-11,89,-10
2016-17,2017-04-01,Winnipeg Jets,2,Central,Western,81,2,158,0.5126582278481012,91,-10,91,-10
2016-17,2017-04-05,Winnipeg Jets,2,Central,Western,83,2,160,0.51875,93,-10,92,-9
2016-17,2017-04-06,Winnipeg Jets,2,Central,Western,85,2,162,0.5246913580246914,95,-10,92,-7
2016-17,2017-04-08,Winnipeg Jets,2,Central,Western,87,2,164,0.5304878048780488,97,-10,94,-7
2017-18,2017-10-06,Anaheim Ducks,2,Pacific,Western,2,2,2,1.0,2,0,0,2
2017-18,2017-10-08,Anaheim Ducks,1,Pacific,Western,3,2,4,0.75,3,0,2,1
2017-18,2017-10-10,Anaheim Ducks,0,Pacific,Western,3,2,6,0.5,4,-1,2,1
2017-18,2017-10-12,Anaheim Ducks,2,Pacific,Western,5,2,8,0.625,5,0,3,2
2017-18,2017-10-14,Anaheim Ducks,0,Pacific,Western,5,2,10,0.5,5,0,5,0
2017-18,2017-10-16,Anaheim Ducks,0,Pacific,Western,5,2,12,0.4166666666666667,8,-3,5,0
2017-18,2017-10-21,Anaheim Ducks,2,Pacific,Western,7,2,14,0.5,8,-1,8,-1
2017-18,2017-10-24,Anaheim Ducks,2,Pacific,Western,9,2,16,0.5625,9,0,9,0
2017-18,2017-10-26,Anaheim Ducks,0,Pacific,Western,9,2,18,0.5,11,-2,10,-1
2017-18,2017-10-28,Anaheim Ducks,2,Pacific,Western,11,2,20,0.55,13,-2,11,0
2017-18,2017-10-29,Anaheim Ducks,2,Pacific,Western,13,2,22,0.5909090909090909,13,0,12,1
2017-18,2017-11-02,Anaheim Ducks,0,Pacific,Western,13,2,24,0.5416666666666666,14,-1,14,-1
2017-18,2017-11-04,Anaheim Ducks,0,Pacific,Western,13,2,26,0.5,14,-1,14,-1
2017-18,2017-11-05,Anaheim Ducks,1,Pacific,Western,14,2,28,0.5,16,-2,16,-2
2017-18,2017-11-08,Anaheim Ducks,1,Pacific,Western,15,2,30,0.5,18,-3,16,-1
2017-18,2017-11-10,Anaheim Ducks,2,Pacific,Western,17,2,32,0.53125,18,-1,17,0
2017-18,2017-11-13,Anaheim Ducks,0,Pacific,Western,17,2,34,0.5,20,-3,18,-1
2017-18,2017-11-16,Anaheim Ducks,2,Pacific,Western,19,2,36,0.5277777777777778,20,-1,20,-1
2017-18,2017-11-20,Anaheim Ducks,2,Pacific,Western,21,2,38,0.5526315789473685,22,-1,21,0
2017-18,2017-11-21,Anaheim Ducks,2,Pacific,Western,23,2,40,0.575,24,-1,22,1
2017-18,2017-11-23,Anaheim Ducks,0,Pacific,Western,23,2,42,0.5476190476190477,25,-2,23,0
2017-18,2017-11-24,Anaheim Ducks,0,Pacific,Western,23,2,44,0.5227272727272727,25,-2,25,-2
2017-18,2017-11-26,Anaheim Ducks,1,Pacific,Western,24,2,46,0.5217391304347826,27,-3,26,-2
2017-18,2017-11-28,Anaheim Ducks,0,Pacific,Western,24,2,48,0.5,27,-3,26,-2
2017-18,2017-11-30,Anaheim Ducks,2,Pacific,Western,26,2,50,0.52,28,-2,27,-1
2017-18,2017-12-02,Anaheim Ducks,0,Pacific,Western,26,2,52,0.5,30,-4,29,-3
2017-18,2017-12-03,Anaheim Ducks,1,Pacific,Western,27,2,54,0.5,30,-3,30,-3
2017-18,2017-12-06,Anaheim Ducks,1,Pacific,Western,28,2,56,0.5,32,-4,30,-2
2017-18,2017-12-07,Anaheim Ducks,2,Pacific,Western,30,2,58,0.5172413793103449,32,-2,30,0
2017-18,2017-12-09,Anaheim Ducks,1,Pacific,Western,31,2,60,0.5166666666666667,32,-1,32,-1
2017-18,2017-12-12,Anaheim Ducks,2,Pacific,Western,33,2,62,0.532258064516129,35,-2,34,-1
2017-18,2017-12-15,Anaheim Ducks,2,Pacific,Western,35,2,64,0.546875,37,-2,37,-2
2017-18,2017-12-17,Anaheim Ducks,1,Pacific,Western,36,2,66,0.5454545454545454,38,-2,37,-1
2017-18,2017-12-19,Anaheim Ducks,0,Pacific,Western,36,2,68,0.5294117647058824,38,-2,38,-2
2017-18,2017-12-20,Anaheim Ducks,0,Pacific,Western,36,2,70,0.5142857142857142,38,-2,39,-3
2017-18,2017-12-22,Anaheim Ducks,2,Pacific,Western,38,2,72,0.5277777777777778,40,-2,39,-1
2017-18,2017-12-24,Anaheim Ducks,2,Pacific,Western,40,2,74,0.5405405405405406,42,-2,40,0
2017-18,2017-12-28,Anaheim Ducks,0,Pacific,Western,40,2,76,0.5263157894736842,42,-2,41,-1
2017-18,2017-12-30,Anaheim Ducks,2,Pacific,Western,42,2,78,0.5384615384615384,44,-2,43,-1
2017-18,2017-12-31,Anaheim Ducks,2,Pacific,Western,44,2,80,0.55,44,0,44,0
2017-18,2018-01-03,Anaheim Ducks,2,Pacific,Western,46,2,82,0.5609756097560976,46,0,46,0
2017-18,2018-01-05,Anaheim Ducks,1,Pacific,Western,47,2,84,0.5595238095238095,47,0,47,0
2017-18,2018-01-07,Anaheim Ducks,0,Pacific,Western,47,2,86,0.5465116279069767,48,-1,47,0
2017-18,2018-01-14,Anaheim Ducks,2,Pacific,Western,49,2,88,0.5568181818181818,53,-4,51,-2
2017-18,2018-01-15,Anaheim Ducks,0,Pacific,Western,49,2,90,0.5444444444444444,53,-4,53,-4
2017-18,2018-01-18,Anaheim Ducks,2,Pacific,Western,51,2,92,0.5543478260869565,54,-3,53,-2
2017-18,2018-01-20,Anaheim Ducks,2,Pacific,Western,53,2,94,0.5638297872340425,54,-1,54,-1
2017-18,2018-01-22,Anaheim Ducks,0,Pacific,Western,53,2,96,0.5520833333333334,55,-2,55,-2
2017-18,2018-01-24,Anaheim Ducks,2,Pacific,Western,55,2,98,0.5612244897959183,56,-1,57,-2
2017-18,2018-01-26,Anaheim Ducks,2,Pacific,Western,57,2,100,0.57,58,-1,57,0
2017-18,2018-01-31,Anaheim Ducks,2,Pacific,Western,59,2,102,0.5784313725490197,59,0,59,0
2017-18,2018-02-02,Anaheim Ducks,1,Pacific,Western,60,2,104,0.5769230769230769,60,0,60,0
2017-18,2018-02-03,Anaheim Ducks,0,Pacific,Western,60,2,106,0.5660377358490566,60,0,60,0
2017-18,2018-02-06,Anaheim Ducks,0,Pacific,Western,60,2,108,0.5555555555555556,61,-1,61,-1
2017-18,2018-02-07,Anaheim Ducks,2,Pacific,Western,62,2,110,0.5636363636363636,62,0,62,0
2017-18,2018-02-10,Anaheim Ducks,2,Pacific,Western,64,2,112,0.5714285714285714,64,0,64,0
2017-18,2018-02-12,Anaheim Ducks,1,Pacific,Western,65,2,114,0.5701754385964912,66,-1,66,-1
2017-18,2018-02-14,Anaheim Ducks,0,Pacific,Western,65,2,116,0.5603448275862069,66,-1,66,-1
2017-18,2018-02-16,Anaheim Ducks,2,Pacific,Western,67,2,118,0.5677966101694916,68,-1,68,-1
2017-18,2018-02-17,Anaheim Ducks,2,Pacific,Western,69,2,120,0.575,69,0,69,0
2017-18,2018-02-20,Anaheim Ducks,2,Pacific,Western,71,2,122,0.5819672131147541,71,0,71,0
2017-18,2018-02-22,Anaheim Ducks,2,Pacific,Western,73,2,124,0.5887096774193549,73,0,71,2
2017-18,2018-02-25,Anaheim Ducks,0,Pacific,Western,73,2,126,0.5793650793650794,73,0,73,0
2017-18,2018-02-26,Anaheim Ducks,1,Pacific,Western,74,2,128,0.578125,74,0,73,1
2017-18,2018-03-03,Anaheim Ducks,2,Pacific,Western,76,2,130,0.5846153846153846,77,-1,76,0
2017-18,2018-03-04,Anaheim Ducks,2,Pacific,Western,78,2,132,0.5909090909090909,78,0,77,1
2017-18,2018-03-07,Anaheim Ducks,2,Pacific,Western,80,2,134,0.5970149253731343,79,1,77,3
2017-18,2018-03-09,Anaheim Ducks,0,Pacific,Western,80,2,136,0.5882352941176471,80,0,79,1
2017-18,2018-03-10,Anaheim Ducks,0,Pacific,Western,80,2,138,0.5797101449275363,80,0,80,0
2017-18,2018-03-13,Anaheim Ducks,0,Pacific,Western,80,2,140,0.5714285714285714,81,-1,80,0
2017-18,2018-03-15,Anaheim Ducks,2,Pacific,Western,82,2,142,0.5774647887323944,82,0,82,0
2017-18,2018-03-17,Anaheim Ducks,2,Pacific,Western,84,2,144,0.5833333333333334,84,0,84,0
2017-18,2018-03-19,Anaheim Ducks,2,Pacific,Western,86,2,146,0.589041095890411,86,0,84,2
2017-18,2018-03-22,Anaheim Ducks,2,Pacific,Western,88,2,148,0.5945945945945946,88,0,87,1
2017-18,2018-03-24,Anaheim Ducks,1,Pacific,Western,89,2,150,0.5933333333333334,89,0,89,0
2017-18,2018-03-26,Anaheim Ducks,2,Pacific,Western,91,2,152,0.5986842105263158,91,0,89,2
2017-18,2018-03-28,Anaheim Ducks,0,Pacific,Western,91,2,154,0.5909090909090909,91,0,91,0
2017-18,2018-03-31,Anaheim Ducks,2,Pacific,Western,93,2,156,0.5961538461538461,94,-1,92,1
2017-18,2018-04-02,Anaheim Ducks,2,Pacific,Western,95,2,158,0.6012658227848101,95,0,93,2
2017-18,2018-04-05,Anaheim Ducks,2,Pacific,Western,97,2,160,0.60625,97,0,93,4
2017-18,2018-04-07,Anaheim Ducks,2,Pacific,Western,99,2,162,0.6111111111111112,99,0,94,5
2017-18,2018-04-08,Anaheim Ducks,2,Pacific,Western,101,2,164,0.6158536585365854,100,1,95,6
2017-18,2017-10-06,Arizona Coyotes,0,Pacific,Western,0,2,2,0.0,2,-2,0,0
2017-18,2017-10-08,Arizona Coyotes,1,Pacific,Western,1,2,4,0.25,3,-2,2,-1
2017-18,2017-10-11,Arizona Coyotes,0,Pacific,Western,1,2,6,0.16666666666666666,4,-3,3,-2
2017-18,2017-10-13,Arizona Coyotes,0,Pacific,Western,1,2,8,0.125,5,-4,4,-3
2017-18,2017-10-15,Arizona Coyotes,0,Pacific,Western,1,2,10,0.1,7,-6,5,-4
2017-18,2017-10-18,Arizona Coyotes,0,Pacific,Western,1,2,12,0.08333333333333333,8,-7,6,-5
2017-18,2017-10-20,Arizona Coyotes,0,Pacific,Western,1,2,14,0.07142857142857142,8,-7,8,-7
2017-18,2017-10-22,Arizona Coyotes,0,Pacific,Western,1,2,16,0.0625,9,-8,8,-7
2017-18,2017-10-24,Arizona Coyotes,0,Pacific,Western,1,2,18,0.05555555555555555,9,-8,9,-8
2017-18,2017-10-26,Arizona Coyotes,0,Pacific,Western,1,2,20,0.05,11,-10,10,-9
2017-18,2017-10-28,Arizona Coyotes,0,Pacific,Western,1,2,22,0.045454545454545456,13,-12,11,-10
2017-18,2017-10-30,Arizona Coyotes,2,Pacific,Western,3,2,24,0.125,13,-10,12,-9
2017-18,2017-10-31,Arizona Coyotes,0,Pacific,Western,3,2,26,0.11538461538461539,14,-11,12,-9
2017-18,2017-11-03,Arizona Coyotes,0,Pacific,Western,3,2,28,0.10714285714285714,14,-11,14,-11
2017-18,2017-11-05,Arizona Coyotes,2,Pacific,Western,5,2,30,0.16666666666666666,16,-11,16,-11
2017-18,2017-11-07,Arizona Coyotes,1,Pacific,Western,6,2,32,0.1875,16,-10,16,-10
2017-18,2017-11-08,Arizona Coyotes,0,Pacific,Western,6,2,34,0.17647058823529413,18,-12,16,-10
2017-18,2017-11-10,Arizona Coyotes,1,Pacific,Western,7,2,36,0.19444444444444445,18,-11,17,-10
2017-18,2017-11-12,Arizona Coyotes,0,Pacific,Western,7,2,38,0.18421052631578946,18,-11,18,-11
2017-18,2017-11-15,Arizona Coyotes,0,Pacific,Western,7,2,40,0.175,20,-13,20,-13
2017-18,2017-11-17,Arizona Coyotes,2,Pacific,Western,9,2,42,0.21428571428571427,20,-11,20,-11
2017-18,2017-11-18,Arizona Coyotes,2,Pacific,Western,11,2,44,0.25,22,-11,20,-9
2017-18,2017-11-21,Arizona Coyotes,2,Pacific,Western,13,2,46,0.2826086956521739,24,-11,22,-9
2017-18,2017-11-23,Arizona Coyotes,0,Pacific,Western,13,2,48,0.2708333333333333,25,-12,23,-10
2017-18,2017-11-25,Arizona Coyotes,2,Pacific,Western,15,2,50,0.3,25,-10,25,-10
2017-18,2017-11-26,Arizona Coyotes,0,Pacific,Western,15,2,52,0.28846153846153844,27,-12,26,-11
2017-18,2017-11-29,Arizona Coyotes,1,Pacific,Western,16,2,54,0.2962962962962963,28,-12,27,-11
2017-18,2017-12-01,Arizona Coyotes,0,Pacific,Western,16,2,56,0.2857142857142857,29,-13,28,-12
2017-18,2017-12-03,Arizona Coyotes,2,Pacific,Western,18,2,58,0.3103448275862069,30,-12,30,-12
2017-18,2017-12-04,Arizona Coyotes,1,Pacific,Western,19,2,60,0.31666666666666665,30,-11,30,-11
2017-18,2017-12-08,Arizona Coyotes,0,Pacific,Western,19,2,62,0.3064516129032258,32,-13,32,-13
2017-18,2017-12-10,Arizona Coyotes,0,Pacific,Western,19,2,64,0.296875,34,-15,33,-14
2017-18,2017-12-11,Arizona Coyotes,0,Pacific,Western,19,2,66,0.2878787878787879,35,-16,33,-14
2017-18,2017-12-15,Arizona Coyotes,0,Pacific,Western,19,2,68,0.27941176470588236,37,-18,37,-18
2017-18,2017-12-17,Arizona Coyotes,0,Pacific,Western,19,2,70,0.2714285714285714,38,-19,37,-18
2017-18,2017-12-20,Arizona Coyotes,0,Pacific,Western,19,2,72,0.2638888888888889,38,-19,39,-20
2017-18,2017-12-23,Arizona Coyotes,2,Pacific,Western,21,2,74,0.28378378378378377,40,-19,39,-18
2017-18,2017-12-24,Arizona Coyotes,0,Pacific,Western,21,2,76,0.27631578947368424,42,-21,40,-19
2017-18,2017-12-28,Arizona Coyotes,2,Pacific,Western,23,2,78,0.2948717948717949,42,-19,41,-18
2017-18,2017-12-29,Arizona Coyotes,0,Pacific,Western,23,2,80,0.2875,44,-21,41,-18
2017-18,2017-12-31,Arizona Coyotes,0,Pacific,Western,23,2,82,0.2804878048780488,44,-21,44,-21
2017-18,2018-01-05,Arizona Coyotes,2,Pacific,Western,25,2,84,0.2976190476190476,47,-22,47,-22
2017-18,2018-01-07,Arizona Coyotes,1,Pacific,Western,26,2,86,0.3023255813953488,48,-22,47,-21
2017-18,2018-01-13,Arizona Coyotes,0,Pacific,Western,26,2,88,0.29545454545454547,52,-26,50,-24
2017-18,2018-01-14,Arizona Coyotes,1,Pacific,Western,27,2,90,0.3,53,-26,51,-24
2017-18,2018-01-17,Arizona Coyotes,1,Pacific,Western,28,2,92,0.30434782608695654,54,-26,53,-25
2017-18,2018-01-19,Arizona Coyotes,1,Pacific,Western,29,2,94,0.30851063829787234,54,-25,53,-24
2017-18,2018-01-21,Arizona Coyotes,2,Pacific,Western,31,2,96,0.3229166666666667,55,-24,55,-24
2017-18,2018-01-23,Arizona Coyotes,2,Pacific,Western,33,2,98,0.336734693877551,56,-23,57,-24
2017-18,2018-01-26,Arizona Coyotes,0,Pacific,Western,33,2,100,0.33,58,-25,57,-24
2017-18,2018-02-02,Arizona Coyotes,0,Pacific,Western,33,2,102,0.3235294117647059,60,-27,60,-27
2017-18,2018-02-04,Arizona Coyotes,0,Pacific,Western,33,2,104,0.3173076923076923,61,-28,61,-28
2017-18,2018-02-07,Arizona Coyotes,0,Pacific,Western,33,2,106,0.3113207547169811,62,-29,62,-29
2017-18,2018-02-09,Arizona Coyotes,2,Pacific,Western,35,2,108,0.32407407407407407,64,-29,64,-29
2017-18,2018-02-11,Arizona Coyotes,1,Pacific,Western,36,2,110,0.32727272727272727,65,-29,65,-29
2017-18,2018-02-13,Arizona Coyotes,2,Pacific,Western,38,2,112,0.3392857142857143,66,-28,66,-28
2017-18,2018-02-14,Arizona Coyotes,2,Pacific,Western,40,2,114,0.3508771929824561,66,-26,66,-26
2017-18,2018-02-16,Arizona Coyotes,2,Pacific,Western,42,2,116,0.3620689655172414,68,-26,68,-26
2017-18,2018-02-17,Arizona Coyotes,2,Pacific,Western,44,2,118,0.3728813559322034,69,-25,69,-25
2017-18,2018-02-23,Arizona Coyotes,0,Pacific,Western,44,2,120,0.36666666666666664,73,-29,72,-28
2017-18,2018-02-25,Arizona Coyotes,2,Pacific,Western,46,2,122,0.3770491803278688,73,-27,73,-27
2017-18,2018-02-26,Arizona Coyotes,0,Pacific,Western,46,2,124,0.3709677419354839,74,-28,73,-27
2017-18,2018-03-02,Arizona Coyotes,2,Pacific,Western,48,2,126,0.38095238095238093,77,-29,74,-26
2017-18,2018-03-04,Arizona Coyotes,2,Pacific,Western,50,2,128,0.390625,78,-28,77,-27
2017-18,2018-03-06,Arizona Coyotes,1,Pacific,Western,51,2,130,0.3923076923076923,78,-27,77,-26
2017-18,2018-03-08,Arizona Coyotes,2,Pacific,Western,53,2,132,0.4015151515151515,79,-26,77,-24
2017-18,2018-03-10,Arizona Coyotes,0,Pacific,Western,53,2,134,0.39552238805970147,80,-27,80,-27
2017-18,2018-03-12,Arizona Coyotes,2,Pacific,Western,55,2,136,0.40441176470588236,80,-25,80,-25
2017-18,2018-03-14,Arizona Coyotes,2,Pacific,Western,57,2,138,0.41304347826086957,82,-25,82,-25
2017-18,2018-03-16,Arizona Coyotes,0,Pacific,Western,57,2,140,0.40714285714285714,84,-27,84,-27
2017-18,2018-03-18,Arizona Coyotes,0,Pacific,Western,57,2,142,0.4014084507042254,84,-27,84,-27
2017-18,2018-03-20,Arizona Coyotes,2,Pacific,Western,59,2,144,0.4097222222222222,86,-27,86,-27
2017-18,2018-03-21,Arizona Coyotes,2,Pacific,Western,61,2,146,0.4178082191780822,87,-26,86,-25
2017-18,2018-03-22,Arizona Coyotes,0,Pacific,Western,61,2,148,0.41216216216216217,88,-27,87,-26
2017-18,2018-03-24,Arizona Coyotes,0,Pacific,Western,61,2,150,0.4066666666666667,89,-28,89,-28
2017-18,2018-03-26,Arizona Coyotes,2,Pacific,Western,63,2,152,0.4144736842105263,91,-28,89,-26
2017-18,2018-03-29,Arizona Coyotes,2,Pacific,Western,65,2,154,0.42207792207792205,91,-26,91,-26
2017-18,2018-03-30,Arizona Coyotes,0,Pacific,Western,65,2,156,0.4166666666666667,93,-28,91,-26
2017-18,2018-04-01,Arizona Coyotes,2,Pacific,Western,67,2,158,0.4240506329113924,94,-27,92,-25
2017-18,2018-04-04,Arizona Coyotes,2,Pacific,Western,69,2,160,0.43125,96,-27,93,-24
2017-18,2018-04-06,Arizona Coyotes,1,Pacific,Western,70,2,162,0.43209876543209874,98,-28,93,-23
2017-18,2018-04-08,Arizona Coyotes,0,Pacific,Western,70,2,164,0.4268292682926829,100,-30,95,-25
2017-18,2017-10-05,Boston Bruins,2,Atlantic,Eastern,2,2,2,1.0,2,0,1,1
2017-18,2017-10-09,Boston Bruins,0,Atlantic,Eastern,2,2,4,0.5,4,-2,3,-1
2017-18,2017-10-12,Boston Bruins,0,Atlantic,Eastern,2,2,6,0.3333333333333333,4,-2,4,-2
2017-18,2017-10-15,Boston Bruins,2,Atlantic,Eastern,4,2,8,0.5,8,-4,7,-3
2017-18,2017-10-15,Boston Bruins,0,Atlantic,Eastern,4,2,10,0.4,8,-4,7,-3
2017-18,2017-10-19,Boston Bruins,2,Atlantic,Eastern,6,2,12,0.5,9,-3,8,-2
2017-18,2017-10-21,Boston Bruins,1,Atlantic,Eastern,7,2,14,0.5,11,-4,9,-2
2017-18,2017-10-26,Boston Bruins,2,Atlantic,Eastern,9,2,16,0.5625,14,-5,10,-1
2017-18,2017-10-28,Boston Bruins,1,Atlantic,Eastern,10,2,18,0.5555555555555556,14,-4,11,-1
2017-18,2017-10-30,Boston Bruins,1,Atlantic,Eastern,11,2,20,0.55,14,-3,13,-2
2017-18,2017-11-02,Boston Bruins,2,Atlantic,Eastern,13,2,22,0.5909090909090909,16,-3,13,0
2017-18,2017-11-04,Boston Bruins,0,Atlantic,Eastern,13,2,24,0.5416666666666666,16,-3,15,-2
2017-18,2017-11-07,Boston Bruins,2,Atlantic,Eastern,15,2,26,0.5769230769230769,17,-2,17,-2
2017-18,2017-11-09,Boston Bruins,0,Atlantic,Eastern,15,2,28,0.5357142857142857,17,-2,17,-2
2017-18,2017-11-11,Boston Bruins,1,Atlantic,Eastern,16,2,30,0.5333333333333333,19,-3,19,-3
2017-18,2017-11-12,Boston Bruins,0,Atlantic,Eastern,16,2,32,0.5,21,-5,20,-4
2017-18,2017-11-16,Boston Bruins,0,Atlantic,Eastern,16,2,34,0.47058823529411764,21,-5,20,-4
2017-18,2017-11-17,Boston Bruins,2,Atlantic,Eastern,18,2,36,0.5,21,-3,21,-3
2017-18,2017-11-19,Boston Bruins,2,Atlantic,Eastern,20,2,38,0.5263157894736842,23,-3,23,-3
2017-18,2017-11-23,Boston Bruins,2,Atlantic,Eastern,22,2,40,0.55,23,-1,24,-2
2017-18,2017-11-24,Boston Bruins,2,Atlantic,Eastern,24,2,42,0.5714285714285714,24,0,24,0
2017-18,2017-11-26,Boston Bruins,0,Atlantic,Eastern,24,2,44,0.5454545454545454,25,-1,27,-3
2017-18,2017-11-30,Boston Bruins,2,Atlantic,Eastern,26,2,46,0.5652173913043478,26,0,28,-2
2017-18,2017-12-02,Boston Bruins,2,Atlantic,Eastern,28,2,48,0.5833333333333334,28,0,29,-1
2017-18,2017-12-05,Boston Bruins,0,Atlantic,Eastern,28,2,50,0.56,29,-1,30,-2
2017-18,2017-12-08,Boston Bruins,2,Atlantic,Eastern,30,2,52,0.5769230769230769,30,0,32,-2
2017-18,2017-12-10,Boston Bruins,2,Atlantic,Eastern,32,2,54,0.5925925925925926,32,0,34,-2
2017-18,2017-12-14,Boston Bruins,2,Atlantic,Eastern,34,2,56,0.6071428571428571,34,0,35,-1
2017-18,2017-12-15,Boston Bruins,0,Atlantic,Eastern,34,2,58,0.5862068965517241,34,0,35,-1
2017-18,2017-12-16,Boston Bruins,1,Atlantic,Eastern,35,2,60,0.5833333333333334,35,0,35,0
2017-18,2017-12-19,Boston Bruins,2,Atlantic,Eastern,37,2,62,0.5967741935483871,37,0,37,0
2017-18,2017-12-20,Boston Bruins,2,Atlantic,Eastern,39,2,64,0.609375,39,0,39,0
2017-18,2017-12-22,Boston Bruins,2,Atlantic,Eastern,41,2,66,0.6212121212121212,41,0,40,1
2017-18,2017-12-23,Boston Bruins,2,Atlantic,Eastern,43,2,68,0.6323529411764706,43,0,42,1
2017-18,2017-12-28,Boston Bruins,2,Atlantic,Eastern,45,2,70,0.6428571428571429,45,0,44,1
2017-18,2017-12-29,Boston Bruins,1,Atlantic,Eastern,46,2,72,0.6388888888888888,46,0,44,2
2017-18,2017-12-31,Boston Bruins,2,Atlantic,Eastern,48,2,74,0.6486486486486487,48,0,44,4
2017-18,2018-01-03,Boston Bruins,2,Atlantic,Eastern,50,2,76,0.6578947368421053,48,2,44,6
2017-18,2018-01-07,Boston Bruins,2,Atlantic,Eastern,52,2,78,0.6666666666666666,52,0,46,6
2017-18,2018-01-08,Boston Bruins,1,Atlantic,Eastern,53,2,80,0.6625,52,1,47,6
2017-18,2018-01-14,Boston Bruins,2,Atlantic,Eastern,55,2,82,0.6707317073170732,53,2,49,6
2017-18,2018-01-15,Boston Bruins,1,Atlantic,Eastern,56,2,84,0.6666666666666666,53,3,49,7
2017-18,2018-01-18,Boston Bruins,2,Atlantic,Eastern,58,2,86,0.6744186046511628,54,4,51,7
2017-18,2018-01-19,Boston Bruins,2,Atlantic,Eastern,60,2,88,0.6818181818181818,55,5,53,7
2017-18,2018-01-21,Boston Bruins,2,Atlantic,Eastern,62,2,90,0.6888888888888889,57,5,53,9
2017-18,2018-01-24,Boston Bruins,2,Atlantic,Eastern,64,2,92,0.6956521739130435,57,7,55,9
2017-18,2018-01-26,Boston Bruins,2,Atlantic,Eastern,66,2,94,0.7021276595744681,61,5,56,10
2017-18,2018-01-31,Boston Bruins,0,Atlantic,Eastern,66,2,96,0.6875,61,5,56,10
2017-18,2018-02-02,Boston Bruins,2,Atlantic,Eastern,68,2,98,0.6938775510204082,65,3,56,12
2017-18,2018-02-04,Boston Bruins,2,Atlantic,Eastern,70,2,100,0.7,65,5,57,13
2017-18,2018-02-07,Boston Bruins,2,Atlantic,Eastern,72,2,102,0.7058823529411765,67,5,58,14
2017-18,2018-02-08,Boston Bruins,2,Atlantic,Eastern,74,2,104,0.7115384615384616,69,5,58,16
2017-18,2018-02-11,Boston Bruins,0,Atlantic,Eastern,74,2,106,0.6981132075471698,71,3,61,13
2017-18,2018-02-12,Boston Bruins,2,Atlantic,Eastern,76,2,108,0.7037037037037037,71,5,61,15
2017-18,2018-02-14,Boston Bruins,2,Atlantic,Eastern,78,2,110,0.7090909090909091,73,5,63,15
2017-18,2018-02-18,Boston Bruins,0,Atlantic,Eastern,78,2,112,0.6964285714285714,75,3,64,14
2017-18,2018-02-19,Boston Bruins,2,Atlantic,Eastern,80,2,114,0.7017543859649122,77,3,64,16
2017-18,2018-02-21,Boston Bruins,2,Atlantic,Eastern,82,2,116,0.7068965517241379,79,3,65,17
2017-18,2018-02-25,Boston Bruins,0,Atlantic,Eastern,82,2,118,0.6949152542372882,82,0,67,15
2017-18,2018-02-25,Boston Bruins,0,Atlantic,Eastern,82,2,120,0.6833333333333333,82,0,67,15
2017-18,2018-02-28,Boston Bruins,2,Atlantic,Eastern,84,2,122,0.6885245901639344,84,0,69,15
2017-18,2018-03-02,Boston Bruins,2,Atlantic,Eastern,86,2,124,0.6935483870967742,85,1,69,17
2017-18,2018-03-03,Boston Bruins,2,Atlantic,Eastern,88,2,126,0.6984126984126984,85,3,69,19
2017-18,2018-03-07,Boston Bruins,2,Atlantic,Eastern,90,2,128,0.703125,85,5,73,17
2017-18,2018-03-09,Boston Bruins,2,Atlantic,Eastern,92,2,130,0.7076923076923077,85,7,75,17
2017-18,2018-03-10,Boston Bruins,2,Atlantic,Eastern,94,2,132,0.7121212121212122,85,9,76,18
2017-18,2018-03-11,Boston Bruins,0,Atlantic,Eastern,94,2,134,0.7014925373134329,87,7,77,17
2017-18,2018-03-13,Boston Bruins,2,Atlantic,Eastern,96,2,136,0.7058823529411765,87,9,78,18
2017-18,2018-03-15,Boston Bruins,0,Atlantic,Eastern,96,2,138,0.6956521739130435,91,5,80,16
2017-18,2018-03-17,Boston Bruins,2,Atlantic,Eastern,98,2,140,0.7,93,5,82,16
2017-18,2018-03-19,Boston Bruins,1,Atlantic,Eastern,99,2,142,0.6971830985915493,93,6,82,17
2017-18,2018-03-22,Boston Bruins,1,Atlantic,Eastern,100,2,144,0.6944444444444444,93,7,82,18
2017-18,2018-03-24,Boston Bruins,2,Atlantic,Eastern,102,2,146,0.6986301369863014,97,5,86,16
2017-18,2018-03-25,Boston Bruins,2,Atlantic,Eastern,104,2,148,0.7027027027027027,97,7,86,18
2017-18,2018-03-28,Boston Bruins,1,Atlantic,Eastern,105,2,150,0.7,99,6,88,17
2017-18,2018-03-29,Boston Bruins,2,Atlantic,Eastern,107,2,152,0.7039473684210527,99,8,89,18
2017-18,2018-03-31,Boston Bruins,2,Atlantic,Eastern,109,2,154,0.7077922077922078,101,8,91,18
2017-18,2018-04-01,Boston Bruins,1,Atlantic,Eastern,110,2,156,0.7051282051282052,101,9,93,17
2017-18,2018-04-03,Boston Bruins,0,Atlantic,Eastern,110,2,158,0.6962025316455697,103,7,94,16
2017-18,2018-04-05,Boston Bruins,0,Atlantic,Eastern,110,2,160,0.6875,103,7,96,14
2017-18,2018-04-07,Boston Bruins,2,Atlantic,Eastern,112,2,162,0.691358024691358,105,7,97,15
2017-18,2018-04-08,Boston Bruins,0,Atlantic,Eastern,112,2,164,0.6829268292682927,105,7,97,15
2017-18,2017-10-05,Buffalo Sabres,1,Atlantic,Eastern,1,2,2,0.5,2,-1,1,0
2017-18,2017-10-07,Buffalo Sabres,0,Atlantic,Eastern,1,2,4,0.25,2,-1,2,-1
2017-18,2017-10-09,Buffalo Sabres,0,Atlantic,Eastern,1,2,6,0.16666666666666666,4,-3,3,-2
2017-18,2017-10-13,Buffalo Sabres,0,Atlantic,Eastern,1,2,8,0.125,6,-5,4,-3
2017-18,2017-10-15,Buffalo Sabres,0,Atlantic,Eastern,1,2,10,0.1,8,-7,7,-6
2017-18,2017-10-16,Buffalo Sabres,2,Atlantic,Eastern,3,2,12,0.25,8,-5,7,-4
2017-18,2017-10-18,Buffalo Sabres,1,Atlantic,Eastern,4,2,14,0.2857142857142857,8,-4,8,-4
2017-18,2017-10-20,Buffalo Sabres,0,Atlantic,Eastern,4,2,16,0.25,9,-5,9,-5
2017-18,2017-10-21,Buffalo Sabres,2,Atlantic,Eastern,6,2,18,0.3333333333333333,11,-5,9,-3
2017-18,2017-10-24,Buffalo Sabres,2,Atlantic,Eastern,8,2,20,0.4,12,-4,10,-2
2017-18,2017-10-26,Buffalo Sabres,0,Atlantic,Eastern,8,2,22,0.36363636363636365,14,-6,10,-2
2017-18,2017-10-28,Buffalo Sabres,0,Atlantic,Eastern,8,2,24,0.3333333333333333,14,-6,11,-3
2017-18,2017-11-03,Buffalo Sabres,2,Atlantic,Eastern,10,2,26,0.38461538461538464,16,-6,15,-5
2017-18,2017-11-05,Buffalo Sabres,0,Atlantic,Eastern,10,2,28,0.35714285714285715,16,-6,16,-6
2017-18,2017-11-08,Buffalo Sabres,2,Atlantic,Eastern,12,2,30,0.4,17,-5,17,-5
2017-18,2017-11-11,Buffalo Sabres,0,Atlantic,Eastern,12,2,32,0.375,19,-7,19,-7
2017-18,2017-11-12,Buffalo Sabres,1,Atlantic,Eastern,13,2,34,0.38235294117647056,21,-8,20,-7
2017-18,2017-11-15,Buffalo Sabres,1,Atlantic,Eastern,14,2,36,0.3888888888888889,21,-7,20,-6
2017-18,2017-11-18,Buffalo Sabres,0,Atlantic,Eastern,14,2,38,0.3684210526315789,22,-8,22,-8
2017-18,2017-11-19,Buffalo Sabres,0,Atlantic,Eastern,14,2,40,0.35,23,-9,23,-9
2017-18,2017-11-21,Buffalo Sabres,0,Atlantic,Eastern,14,2,42,0.3333333333333333,23,-9,23,-9
2017-18,2017-11-23,Buffalo Sabres,0,Atlantic,Eastern,14,2,44,0.3181818181818182,23,-9,24,-10
2017-18,2017-11-25,Buffalo Sabres,2,Atlantic,Eastern,16,2,46,0.34782608695652173,24,-8,25,-9
2017-18,2017-11-26,Buffalo Sabres,0,Atlantic,Eastern,16,2,48,0.3333333333333333,25,-9,27,-11
2017-18,2017-11-29,Buffalo Sabres,0,Atlantic,Eastern,16,2,50,0.32,25,-9,28,-12
2017-18,2017-12-02,Buffalo Sabres,0,Atlantic,Eastern,16,2,52,0.3076923076923077,28,-12,29,-13
2017-18,2017-12-03,Buffalo Sabres,0,Atlantic,Eastern,16,2,54,0.2962962962962963,29,-13,30,-14
2017-18,2017-12-06,Buffalo Sabres,2,Atlantic,Eastern,18,2,56,0.32142857142857145,29,-11,32,-14
2017-18,2017-12-09,Buffalo Sabres,1,Atlantic,Eastern,19,2,58,0.3275862068965517,30,-11,32,-13
2017-18,2017-12-11,Buffalo Sabres,1,Atlantic,Eastern,20,2,60,0.3333333333333333,32,-12,34,-14
2017-18,2017-12-13,Buffalo Sabres,2,Atlantic,Eastern,22,2,62,0.3548387096774194,32,-10,35,-13
2017-18,2017-12-15,Buffalo Sabres,0,Atlantic,Eastern,22,2,64,0.34375,34,-12,35,-13
2017-18,2017-12-16,Buffalo Sabres,1,Atlantic,Eastern,23,2,66,0.3484848484848485,35,-12,35,-12
2017-18,2017-12-20,Buffalo Sabres,0,Atlantic,Eastern,23,2,68,0.3382352941176471,39,-16,39,-16
2017-18,2017-12-23,Buffalo Sabres,2,Atlantic,Eastern,25,2,70,0.35714285714285715,43,-18,42,-17
2017-18,2017-12-24,Buffalo Sabres,0,Atlantic,Eastern,25,2,72,0.3472222222222222,43,-18,42,-17
2017-18,2017-12-28,Buffalo Sabres,1,Atlantic,Eastern,26,2,74,0.35135135135135137,45,-19,44,-18
2017-18,2017-12-30,Buffalo Sabres,2,Atlantic,Eastern,28,2,76,0.3684210526315789,46,-18,44,-16
2017-18,2018-01-01,Buffalo Sabres,1,Atlantic,Eastern,29,2,78,0.3717948717948718,48,-19,44,-15
2017-18,2018-01-05,Buffalo Sabres,0,Atlantic,Eastern,29,2,80,0.3625,50,-21,46,-17
2017-18,2018-01-06,Buffalo Sabres,0,Atlantic,Eastern,29,2,82,0.35365853658536583,50,-21,46,-17
2017-18,2018-01-07,Buffalo Sabres,0,Atlantic,Eastern,29,2,84,0.34523809523809523,52,-23,46,-17
2017-18,2018-01-10,Buffalo Sabres,0,Atlantic,Eastern,29,2,86,0.3372093023255814,53,-24,47,-18
2017-18,2018-01-12,Buffalo Sabres,2,Atlantic,Eastern,31,2,88,0.3522727272727273,53,-22,48,-17
2017-18,2018-01-19,Buffalo Sabres,0,Atlantic,Eastern,31,2,90,0.34444444444444444,55,-24,53,-22
2017-18,2018-01-20,Buffalo Sabres,0,Atlantic,Eastern,31,2,92,0.33695652173913043,55,-24,53,-22
2017-18,2018-01-23,Buffalo Sabres,2,Atlantic,Eastern,33,2,94,0.35106382978723405,57,-24,53,-20
2017-18,2018-01-24,Buffalo Sabres,2,Atlantic,Eastern,35,2,96,0.3645833333333333,57,-22,55,-20
2017-18,2018-01-26,Buffalo Sabres,2,Atlantic,Eastern,37,2,98,0.37755102040816324,61,-24,56,-19
2017-18,2018-01-31,Buffalo Sabres,0,Atlantic,Eastern,37,2,100,0.37,61,-24,56,-19
2017-18,2018-02-02,Buffalo Sabres,0,Atlantic,Eastern,37,2,102,0.3627450980392157,65,-28,56,-19
2017-18,2018-02-04,Buffalo Sabres,0,Atlantic,Eastern,37,2,104,0.3557692307692308,65,-28,57,-20
2017-18,2018-02-07,Buffalo Sabres,1,Atlantic,Eastern,38,2,106,0.3584905660377358,67,-29,58,-20
2017-18,2018-02-09,Buffalo Sabres,2,Atlantic,Eastern,40,2,108,0.37037037037037035,69,-29,58,-18
2017-18,2018-02-11,Buffalo Sabres,2,Atlantic,Eastern,42,2,110,0.38181818181818183,71,-29,61,-19
2017-18,2018-02-12,Buffalo Sabres,0,Atlantic,Eastern,42,2,112,0.375,71,-29,61,-19
2017-18,2018-02-14,Buffalo Sabres,2,Atlantic,Eastern,44,2,114,0.38596491228070173,73,-29,63,-19
2017-18,2018-02-16,Buffalo Sabres,1,Atlantic,Eastern,45,2,116,0.3879310344827586,75,-30,63,-18
2017-18,2018-02-17,Buffalo Sabres,0,Atlantic,Eastern,45,2,118,0.3813559322033898,75,-30,64,-19
2017-18,2018-02-19,Buffalo Sabres,0,Atlantic,Eastern,45,2,120,0.375,77,-32,64,-19
2017-18,2018-02-23,Buffalo Sabres,2,Atlantic,Eastern,47,2,122,0.38524590163934425,81,-34,65,-18
2017-18,2018-02-25,Buffalo Sabres,2,Atlantic,Eastern,49,2,124,0.3951612903225806,82,-33,67,-18
2017-18,2018-02-25,Buffalo Sabres,0,Atlantic,Eastern,49,2,126,0.3888888888888889,82,-33,67,-18
2017-18,2018-03-01,Buffalo Sabres,2,Atlantic,Eastern,51,2,128,0.3984375,84,-33,69,-18
2017-18,2018-03-03,Buffalo Sabres,0,Atlantic,Eastern,51,2,130,0.3923076923076923,85,-34,69,-18
2017-18,2018-03-06,Buffalo Sabres,2,Atlantic,Eastern,53,2,132,0.4015151515151515,85,-32,71,-18
2017-18,2018-03-08,Buffalo Sabres,0,Atlantic,Eastern,53,2,134,0.39552238805970147,85,-32,73,-20
2017-18,2018-03-09,Buffalo Sabres,2,Atlantic,Eastern,55,2,136,0.40441176470588236,85,-30,75,-20
2017-18,2018-03-10,Buffalo Sabres,1,Atlantic,Eastern,56,2,138,0.4057971014492754,85,-29,76,-20
2017-18,2018-03-15,Buffalo Sabres,0,Atlantic,Eastern,56,2,140,0.4,91,-35,80,-24
2017-18,2018-03-17,Buffalo Sabres,2,Atlantic,Eastern,58,2,142,0.4084507042253521,93,-35,82,-24
2017-18,2018-03-19,Buffalo Sabres,0,Atlantic,Eastern,58,2,144,0.4027777777777778,93,-35,82,-24
2017-18,2018-03-21,Buffalo Sabres,0,Atlantic,Eastern,58,2,146,0.3972602739726027,93,-35,82,-24
2017-18,2018-03-23,Buffalo Sabres,0,Atlantic,Eastern,58,2,148,0.3918918918918919,95,-37,84,-26
2017-18,2018-03-24,Buffalo Sabres,0,Atlantic,Eastern,58,2,150,0.38666666666666666,97,-39,86,-28
2017-18,2018-03-26,Buffalo Sabres,2,Atlantic,Eastern,60,2,152,0.39473684210526316,97,-37,86,-26
2017-18,2018-03-29,Buffalo Sabres,0,Atlantic,Eastern,60,2,154,0.38961038961038963,99,-39,89,-29
2017-18,2018-04-01,Buffalo Sabres,2,Atlantic,Eastern,62,2,156,0.3974358974358974,101,-39,93,-31
2017-18,2018-04-02,Buffalo Sabres,0,Atlantic,Eastern,62,2,158,0.3924050632911392,103,-41,93,-31
2017-18,2018-04-04,Buffalo Sabres,0,Atlantic,Eastern,62,2,160,0.3875,103,-41,94,-32
2017-18,2018-04-06,Buffalo Sabres,0,Atlantic,Eastern,62,2,162,0.38271604938271603,103,-41,96,-34
2017-18,2018-04-07,Buffalo Sabres,0,Atlantic,Eastern,62,2,164,0.3780487804878049,105,-43,97,-35
2017-18,2017-10-05,Calgary Flames,0,Pacific,Western,0,2,2,0.0,0,0,0,0
2017-18,2017-10-08,Calgary Flames,2,Pacific,Western,2,2,4,0.5,3,-1,2,0
2017-18,2017-10-10,Calgary Flames,2,Pacific,Western,4,2,6,0.6666666666666666,4,0,2,2
2017-18,2017-10-12,Calgary Flames,2,Pacific,Western,6,2,8,0.75,5,1,3,3
2017-18,2017-10-14,Calgary Flames,0,Pacific,Western,6,2,10,0.6,5,1,5,1
2017-18,2017-10-15,Calgary Flames,2,Pacific,Western,8,2,12,0.6666666666666666,7,1,5,3
2017-18,2017-10-20,Calgary Flames,0,Pacific,Western,8,2,14,0.5714285714285714,8,0,8,0
2017-18,2017-10-22,Calgary Flames,0,Pacific,Western,8,2,16,0.5,9,-1,8,0
2017-18,2017-10-25,Calgary Flames,2,Pacific,Western,10,2,18,0.5555555555555556,11,-1,10,0
2017-18,2017-10-26,Calgary Flames,0,Pacific,Western,10,2,20,0.5,11,-1,10,0
2017-18,2017-10-28,Calgary Flames,0,Pacific,Western,10,2,22,0.45454545454545453,13,-3,11,-1
2017-18,2017-10-30,Calgary Flames,2,Pacific,Western,12,2,24,0.5,13,-1,12,0
2017-18,2017-11-03,Calgary Flames,2,Pacific,Western,14,2,26,0.5384615384615384,14,0,14,0
2017-18,2017-11-06,Calgary Flames,2,Pacific,Western,16,2,28,0.5714285714285714,16,0,16,0
2017-18,2017-11-08,Calgary Flames,0,Pacific,Western,16,2,30,0.5333333333333333,18,-2,16,0
2017-18,2017-11-10,Calgary Flames,2,Pacific,Western,18,2,32,0.5625,18,0,17,1
2017-18,2017-11-14,Calgary Flames,2,Pacific,Western,20,2,34,0.5882352941176471,20,0,18,2
2017-18,2017-11-16,Calgary Flames,0,Pacific,Western,20,2,36,0.5555555555555556,20,0,20,0
2017-18,2017-11-18,Calgary Flames,2,Pacific,Western,22,2,38,0.5789473684210527,22,0,20,2
2017-18,2017-11-21,Calgary Flames,2,Pacific,Western,24,2,40,0.6,24,0,22,2
2017-18,2017-11-23,Calgary Flames,1,Pacific,Western,25,2,42,0.5952380952380952,25,0,23,2
2017-18,2017-11-25,Calgary Flames,0,Pacific,Western,25,2,44,0.5681818181818182,25,0,25,0
2017-18,2017-11-26,Calgary Flames,2,Pacific,Western,27,2,46,0.5869565217391305,27,0,26,1
2017-18,2017-11-29,Calgary Flames,0,Pacific,Western,27,2,48,0.5625,28,-1,27,0
2017-18,2017-12-01,Calgary Flames,2,Pacific,Western,29,2,50,0.58,29,0,28,1
2017-18,2017-12-03,Calgary Flames,0,Pacific,Western,29,2,52,0.5576923076923077,30,-1,30,-1
2017-18,2017-12-05,Calgary Flames,0,Pacific,Western,29,2,54,0.5370370370370371,30,-1,30,-1
2017-18,2017-12-07,Calgary Flames,1,Pacific,Western,30,2,56,0.5357142857142857,32,-2,30,0
2017-18,2017-12-08,Calgary Flames,2,Pacific,Western,32,2,58,0.5517241379310345,32,0,32,0
2017-18,2017-12-10,Calgary Flames,2,Pacific,Western,34,2,60,0.5666666666666667,34,0,33,1
2017-18,2017-12-13,Calgary Flames,1,Pacific,Western,35,2,62,0.5645161290322581,35,0,35,0
2017-18,2017-12-15,Calgary Flames,0,Pacific,Western,35,2,64,0.546875,37,-2,37,-2
2017-18,2017-12-17,Calgary Flames,0,Pacific,Western,35,2,66,0.5303030303030303,38,-3,37,-2
2017-18,2017-12-18,Calgary Flames,2,Pacific,Western,37,2,68,0.5441176470588235,38,-1,38,-1
2017-18,2017-12-21,Calgary Flames,2,Pacific,Western,39,2,70,0.5571428571428572,39,0,39,0
2017-18,2017-12-23,Calgary Flames,0,Pacific,Western,39,2,72,0.5416666666666666,40,-1,39,0
2017-18,2017-12-29,Calgary Flames,1,Pacific,Western,40,2,74,0.5405405405405406,44,-4,41,-1
2017-18,2017-12-30,Calgary Flames,0,Pacific,Western,40,2,76,0.5263157894736842,44,-4,43,-3
2017-18,2018-01-01,Calgary Flames,2,Pacific,Western,42,2,78,0.5384615384615384,44,-2,44,-2
2017-18,2018-01-05,Calgary Flames,2,Pacific,Western,44,2,80,0.55,47,-3,47,-3
2017-18,2018-01-07,Calgary Flames,2,Pacific,Western,46,2,82,0.5609756097560976,48,-2,47,-1
2017-18,2018-01-10,Calgary Flames,2,Pacific,Western,48,2,84,0.5714285714285714,48,0,48,0
2017-18,2018-01-12,Calgary Flames,2,Pacific,Western,50,2,86,0.5813953488372093,50,0,50,0
2017-18,2018-01-13,Calgary Flames,2,Pacific,Western,52,2,88,0.5909090909090909,52,0,50,2
2017-18,2018-01-14,Calgary Flames,2,Pacific,Western,54,2,90,0.6,53,1,51,3
2017-18,2018-01-20,Calgary Flames,1,Pacific,Western,55,2,92,0.5978260869565217,54,1,54,1
2017-18,2018-01-23,Calgary Flames,1,Pacific,Western,56,2,94,0.5957446808510638,56,0,57,-1
2017-18,2018-01-25,Calgary Flames,1,Pacific,Western,57,2,96,0.59375,57,0,57,0
2017-18,2018-01-26,Calgary Flames,1,Pacific,Western,58,2,98,0.5918367346938775,58,0,57,1
2017-18,2018-01-31,Calgary Flames,0,Pacific,Western,58,2,100,0.58,59,-1,59,-1
2017-18,2018-02-02,Calgary Flames,0,Pacific,Western,58,2,102,0.5686274509803921,60,-2,60,-2
2017-18,2018-02-04,Calgary Flames,2,Pacific,Western,60,2,104,0.5769230769230769,61,-1,61,-1
2017-18,2018-02-07,Calgary Flames,2,Pacific,Western,62,2,106,0.5849056603773585,62,0,62,0
2017-18,2018-02-09,Calgary Flames,2,Pacific,Western,64,2,108,0.5925925925925926,64,0,64,0
2017-18,2018-02-10,Calgary Flames,0,Pacific,Western,64,2,110,0.5818181818181818,64,0,64,0
2017-18,2018-02-12,Calgary Flames,2,Pacific,Western,66,2,112,0.5892857142857143,66,0,66,0
2017-18,2018-02-14,Calgary Flames,0,Pacific,Western,66,2,114,0.5789473684210527,66,0,66,0
2017-18,2018-02-16,Calgary Flames,2,Pacific,Western,68,2,116,0.5862068965517241,68,0,68,0
2017-18,2018-02-18,Calgary Flames,0,Pacific,Western,68,2,118,0.576271186440678,69,-1,69,-1
2017-18,2018-02-19,Calgary Flames,1,Pacific,Western,69,2,120,0.575,69,0,69,0
2017-18,2018-02-22,Calgary Flames,0,Pacific,Western,69,2,122,0.5655737704918032,73,-4,71,-2
2017-18,2018-02-23,Calgary Flames,2,Pacific,Western,71,2,124,0.5725806451612904,73,-2,72,-1
2017-18,2018-02-24,Calgary Flames,2,Pacific,Western,73,2,126,0.5793650793650794,73,0,73,0
2017-18,2018-02-28,Calgary Flames,0,Pacific,Western,73,2,128,0.5703125,75,-2,74,-1
2017-18,2018-03-01,Calgary Flames,0,Pacific,Western,73,2,130,0.5615384615384615,75,-2,74,-1
2017-18,2018-03-03,Calgary Flames,0,Pacific,Western,73,2,132,0.553030303030303,77,-4,76,-3
2017-18,2018-03-06,Calgary Flames,1,Pacific,Western,74,2,134,0.5522388059701493,78,-4,77,-3
2017-18,2018-03-08,Calgary Flames,2,Pacific,Western,76,2,136,0.5588235294117647,79,-3,77,-1
2017-18,2018-03-10,Calgary Flames,2,Pacific,Western,78,2,138,0.5652173913043478,80,-2,80,-2
2017-18,2018-03-11,Calgary Flames,0,Pacific,Western,78,2,140,0.5571428571428572,80,-2,80,-2
2017-18,2018-03-14,Calgary Flames,2,Pacific,Western,80,2,142,0.5633802816901409,82,-2,82,-2
2017-18,2018-03-17,Calgary Flames,0,Pacific,Western,80,2,144,0.5555555555555556,84,-4,84,-4
2017-18,2018-03-18,Calgary Flames,0,Pacific,Western,80,2,146,0.547945205479452,84,-4,84,-4
2017-18,2018-03-20,Calgary Flames,0,Pacific,Western,80,2,148,0.5405405405405406,86,-6,86,-6
2017-18,2018-03-22,Calgary Flames,0,Pacific,Western,80,2,150,0.5333333333333333,88,-8,87,-7
2017-18,2018-03-24,Calgary Flames,0,Pacific,Western,80,2,152,0.5263157894736842,89,-9,89,-9
2017-18,2018-03-27,Calgary Flames,0,Pacific,Western,80,2,154,0.5194805194805194,91,-11,90,-10
2017-18,2018-03-30,Calgary Flames,0,Pacific,Western,80,2,156,0.5128205128205128,93,-13,91,-11
2017-18,2018-04-01,Calgary Flames,2,Pacific,Western,82,2,158,0.5189873417721519,94,-12,92,-10
2017-18,2018-04-04,Calgary Flames,0,Pacific,Western,82,2,160,0.5125,96,-14,93,-11
2017-18,2018-04-06,Calgary Flames,0,Pacific,Western,82,2,162,0.5061728395061729,98,-16,93,-11
2017-18,2018-04-08,Calgary Flames,2,Pacific,Western,84,2,164,0.5121951219512195,100,-16,95,-11
2017-18,2017-10-07,Carolina Hurricanes,2,Metropolitan,Eastern,2,2,2,1.0,2,0,2,0
2017-18,2017-10-10,Carolina Hurricanes,1,Metropolitan,Eastern,3,2,4,0.75,4,-1,3,0
2017-18,2017-10-14,Carolina Hurricanes,0,Metropolitan,Eastern,3,2,6,0.5,7,-4,6,-3
2017-18,2017-10-18,Carolina Hurricanes,2,Metropolitan,Eastern,5,2,8,0.625,9,-4,8,-3
2017-18,2017-10-20,Carolina Hurricanes,2,Metropolitan,Eastern,7,2,10,0.7,10,-3,9,-2
2017-18,2017-10-22,Carolina Hurricanes,0,Metropolitan,Eastern,7,2,12,0.5833333333333334,10,-3,9,-2
2017-18,2017-10-24,Carolina Hurricanes,0,Metropolitan,Eastern,7,2,14,0.5,11,-4,10,-3
2017-18,2017-10-26,Carolina Hurricanes,2,Metropolitan,Eastern,9,2,16,0.5625,12,-3,10,-1
2017-18,2017-10-27,Carolina Hurricanes,0,Metropolitan,Eastern,9,2,18,0.5,14,-5,10,-1
2017-18,2017-10-29,Carolina Hurricanes,1,Metropolitan,Eastern,10,2,20,0.5,14,-4,12,-2
2017-18,2017-11-03,Carolina Hurricanes,0,Metropolitan,Eastern,10,2,22,0.45454545454545453,18,-8,15,-5
2017-18,2017-11-05,Carolina Hurricanes,1,Metropolitan,Eastern,11,2,24,0.4583333333333333,18,-7,16,-5
2017-18,2017-11-08,Carolina Hurricanes,2,Metropolitan,Eastern,13,2,26,0.5,19,-6,17,-4
2017-18,2017-11-11,Carolina Hurricanes,2,Metropolitan,Eastern,15,2,28,0.5357142857142857,20,-5,19,-4
2017-18,2017-11-12,Carolina Hurricanes,1,Metropolitan,Eastern,16,2,30,0.5333333333333333,21,-5,20,-4
2017-18,2017-11-14,Carolina Hurricanes,2,Metropolitan,Eastern,18,2,32,0.5625,21,-3,20,-2
2017-18,2017-11-17,Carolina Hurricanes,0,Metropolitan,Eastern,18,2,34,0.5294117647058824,23,-5,21,-3
2017-18,2017-11-19,Carolina Hurricanes,2,Metropolitan,Eastern,20,2,36,0.5555555555555556,25,-5,23,-3
2017-18,2017-11-19,Carolina Hurricanes,2,Metropolitan,Eastern,22,2,38,0.5789473684210527,25,-3,23,-1
2017-18,2017-11-23,Carolina Hurricanes,0,Metropolitan,Eastern,22,2,40,0.55,26,-4,24,-2
2017-18,2017-11-25,Carolina Hurricanes,0,Metropolitan,Eastern,22,2,42,0.5238095238095238,28,-6,25,-3
2017-18,2017-11-26,Carolina Hurricanes,2,Metropolitan,Eastern,24,2,44,0.5454545454545454,30,-6,27,-3
2017-18,2017-11-29,Carolina Hurricanes,1,Metropolitan,Eastern,25,2,46,0.5434782608695652,32,-7,28,-3
2017-18,2017-12-02,Carolina Hurricanes,0,Metropolitan,Eastern,25,2,48,0.5208333333333334,32,-7,29,-4
2017-18,2017-12-03,Carolina Hurricanes,2,Metropolitan,Eastern,27,2,50,0.54,33,-6,30,-3
2017-18,2017-12-06,Carolina Hurricanes,0,Metropolitan,Eastern,27,2,52,0.5192307692307693,34,-7,32,-5
2017-18,2017-12-08,Carolina Hurricanes,1,Metropolitan,Eastern,28,2,54,0.5185185185185185,35,-7,32,-4
2017-18,2017-12-10,Carolina Hurricanes,1,Metropolitan,Eastern,29,2,56,0.5178571428571429,36,-7,34,-5
2017-18,2017-12-12,Carolina Hurricanes,0,Metropolitan,Eastern,29,2,58,0.5,37,-8,35,-6
2017-18,2017-12-13,Carolina Hurricanes,2,Metropolitan,Eastern,31,2,60,0.5166666666666667,38,-7,35,-4
2017-18,2017-12-16,Carolina Hurricanes,2,Metropolitan,Eastern,33,2,62,0.532258064516129,41,-8,35,-2
2017-18,2017-12-17,Carolina Hurricanes,2,Metropolitan,Eastern,35,2,64,0.546875,41,-6,37,-2
2017-18,2017-12-19,Carolina Hurricanes,0,Metropolitan,Eastern,35,2,66,0.5303030303030303,41,-6,37,-2
2017-18,2017-12-22,Carolina Hurricanes,2,Metropolitan,Eastern,37,2,68,0.5441176470588235,44,-7,40,-3
2017-18,2017-12-24,Carolina Hurricanes,2,Metropolitan,Eastern,39,2,70,0.5571428571428572,46,-7,42,-3
2017-18,2017-12-28,Carolina Hurricanes,2,Metropolitan,Eastern,41,2,72,0.5694444444444444,47,-6,44,-3
2017-18,2017-12-30,Carolina Hurricanes,2,Metropolitan,Eastern,43,2,74,0.581081081081081,47,-4,44,-1
2017-18,2017-12-31,Carolina Hurricanes,0,Metropolitan,Eastern,43,2,76,0.5657894736842105,47,-4,44,-1
2017-18,2018-01-03,Carolina Hurricanes,1,Metropolitan,Eastern,44,2,78,0.5641025641025641,49,-5,44,0
2017-18,2018-01-05,Carolina Hurricanes,2,Metropolitan,Eastern,46,2,80,0.575,49,-3,46,0
2017-18,2018-01-07,Carolina Hurricanes,0,Metropolitan,Eastern,46,2,82,0.5609756097560976,51,-5,46,0
2017-18,2018-01-10,Carolina Hurricanes,0,Metropolitan,Eastern,46,2,84,0.5476190476190477,52,-6,47,-1
2017-18,2018-01-12,Carolina Hurricanes,2,Metropolitan,Eastern,48,2,86,0.5581395348837209,52,-4,48,0
2017-18,2018-01-13,Carolina Hurricanes,0,Metropolitan,Eastern,48,2,88,0.5454545454545454,52,-4,49,-1
2017-18,2018-01-14,Carolina Hurricanes,0,Metropolitan,Eastern,48,2,90,0.5333333333333333,52,-4,49,-1
2017-18,2018-01-21,Carolina Hurricanes,2,Metropolitan,Eastern,50,2,92,0.5434782608695652,55,-5,53,-3
2017-18,2018-01-21,Carolina Hurricanes,0,Metropolitan,Eastern,50,2,94,0.5319148936170213,55,-5,53,-3
2017-18,2018-01-24,Carolina Hurricanes,0,Metropolitan,Eastern,50,2,96,0.5208333333333334,56,-6,55,-5
2017-18,2018-01-26,Carolina Hurricanes,2,Metropolitan,Eastern,52,2,98,0.5306122448979592,57,-5,56,-4
2017-18,2018-01-31,Carolina Hurricanes,2,Metropolitan,Eastern,54,2,100,0.54,58,-4,56,-2
2017-18,2018-02-02,Carolina Hurricanes,2,Metropolitan,Eastern,56,2,102,0.5490196078431373,59,-3,56,0
2017-18,2018-02-03,Carolina Hurricanes,0,Metropolitan,Eastern,56,2,104,0.5384615384615384,60,-4,57,-1
2017-18,2018-02-04,Carolina Hurricanes,0,Metropolitan,Eastern,56,2,106,0.5283018867924528,61,-5,57,-1
2017-18,2018-02-07,Carolina Hurricanes,1,Metropolitan,Eastern,57,2,108,0.5277777777777778,62,-5,58,-1
2017-18,2018-02-10,Carolina Hurricanes,2,Metropolitan,Eastern,59,2,110,0.5363636363636364,62,-3,60,-1
2017-18,2018-02-11,Carolina Hurricanes,2,Metropolitan,Eastern,61,2,112,0.5446428571428571,63,-2,61,0
2017-18,2018-02-14,Carolina Hurricanes,2,Metropolitan,Eastern,63,2,114,0.5526315789473685,66,-3,63,0
2017-18,2018-02-16,Carolina Hurricanes,0,Metropolitan,Eastern,63,2,116,0.5431034482758621,66,-3,63,0
2017-18,2018-02-17,Carolina Hurricanes,0,Metropolitan,Eastern,63,2,118,0.5338983050847458,68,-5,64,-1
2017-18,2018-02-18,Carolina Hurricanes,1,Metropolitan,Eastern,64,2,120,0.5333333333333333,70,-6,64,0
2017-18,2018-02-24,Carolina Hurricanes,0,Metropolitan,Eastern,64,2,122,0.5245901639344263,75,-11,65,-1
2017-18,2018-02-25,Carolina Hurricanes,0,Metropolitan,Eastern,64,2,124,0.5161290322580645,76,-12,67,-3
2017-18,2018-02-28,Carolina Hurricanes,1,Metropolitan,Eastern,65,2,126,0.5158730158730159,76,-11,69,-4
2017-18,2018-03-02,Carolina Hurricanes,2,Metropolitan,Eastern,67,2,128,0.5234375,76,-9,69,-2
2017-18,2018-03-03,Carolina Hurricanes,2,Metropolitan,Eastern,69,2,130,0.5307692307692308,78,-9,69,0
2017-18,2018-03-05,Carolina Hurricanes,0,Metropolitan,Eastern,69,2,132,0.5227272727272727,78,-9,71,-2
2017-18,2018-03-07,Carolina Hurricanes,0,Metropolitan,Eastern,69,2,134,0.5149253731343284,79,-10,73,-4
2017-18,2018-03-09,Carolina Hurricanes,2,Metropolitan,Eastern,71,2,136,0.5220588235294118,79,-8,75,-4
2017-18,2018-03-12,Carolina Hurricanes,0,Metropolitan,Eastern,71,2,138,0.5144927536231884,81,-10,78,-7
2017-18,2018-03-13,Carolina Hurricanes,0,Metropolitan,Eastern,71,2,140,0.5071428571428571,81,-10,78,-7
2017-18,2018-03-17,Carolina Hurricanes,0,Metropolitan,Eastern,71,2,142,0.5,83,-12,82,-11
2017-18,2018-03-18,Carolina Hurricanes,2,Metropolitan,Eastern,73,2,144,0.5069444444444444,85,-12,82,-9
2017-18,2018-03-20,Carolina Hurricanes,0,Metropolitan,Eastern,73,2,146,0.5,87,-14,82,-9
2017-18,2018-03-22,Carolina Hurricanes,2,Metropolitan,Eastern,75,2,148,0.5067567567567568,89,-14,82,-7
2017-18,2018-03-24,Carolina Hurricanes,2,Metropolitan,Eastern,77,2,150,0.5133333333333333,89,-12,86,-9
2017-18,2018-03-26,Carolina Hurricanes,2,Metropolitan,Eastern,79,2,152,0.5197368421052632,89,-10,86,-7
2017-18,2018-03-27,Carolina Hurricanes,0,Metropolitan,Eastern,79,2,154,0.512987012987013,89,-10,88,-9
2017-18,2018-03-30,Carolina Hurricanes,2,Metropolitan,Eastern,81,2,156,0.5192307692307693,93,-12,89,-8
2017-18,2018-03-31,Carolina Hurricanes,0,Metropolitan,Eastern,81,2,158,0.5126582278481012,94,-13,91,-10
2017-18,2018-04-02,Carolina Hurricanes,0,Metropolitan,Eastern,81,2,160,0.50625,94,-13,93,-12
2017-18,2018-04-05,Carolina Hurricanes,0,Metropolitan,Eastern,81,2,162,0.5,97,-16,96,-15
2017-18,2018-04-07,Carolina Hurricanes,2,Metropolitan,Eastern,83,2,164,0.5060975609756098,98,-15,97,-14
2017-18,2017-10-06,Chicago Blackhawks,2,Central,Western,2,2,2,1.0,2,0,0,2
2017-18,2017-10-08,Chicago Blackhawks,2,Central,Western,4,2,4,1.0,2,2,2,2
2017-18,2017-10-09,Chicago Blackhawks,1,Central,Western,5,2,6,0.8333333333333334,4,1,2,3
2017-18,2017-10-10,Chicago Blackhawks,2,Central,Western,7,2,8,0.875,4,3,2,5
2017-18,2017-10-13,Chicago Blackhawks,0,Central,Western,7,2,10,0.7,6,1,4,3
2017-18,2017-10-15,Chicago Blackhawks,2,Central,Western,9,2,12,0.75,8,1,5,4
2017-18,2017-10-19,Chicago Blackhawks,0,Central,Western,9,2,14,0.6428571428571429,9,0,6,3
2017-18,2017-10-20,Chicago Blackhawks,1,Central,Western,10,2,16,0.625,9,1,8,2
2017-18,2017-10-22,Chicago Blackhawks,2,Central,Western,12,2,18,0.6666666666666666,10,2,8,4
2017-18,2017-10-25,Chicago Blackhawks,0,Central,Western,12,2,20,0.6,10,2,10,2
2017-18,2017-10-28,Chicago Blackhawks,0,Central,Western,12,2,22,0.5454545454545454,12,0,11,1
2017-18,2017-10-29,Chicago Blackhawks,0,Central,Western,12,2,24,0.5,12,0,12,0
2017-18,2017-11-02,Chicago Blackhawks,2,Central,Western,14,2,26,0.5384615384615384,14,0,14,0
2017-18,2017-11-05,Chicago Blackhawks,2,Central,Western,16,2,28,0.5714285714285714,16,0,16,0
2017-18,2017-11-06,Chicago Blackhawks,0,Central,Western,16,2,30,0.5333333333333333,16,0,16,0
2017-18,2017-11-10,Chicago Blackhawks,0,Central,Western,16,2,32,0.5,18,-2,17,-1
2017-18,2017-11-12,Chicago Blackhawks,2,Central,Western,18,2,34,0.5294117647058824,20,-2,18,0
2017-18,2017-11-13,Chicago Blackhawks,0,Central,Western,18,2,36,0.5,20,-2,18,0
2017-18,2017-11-16,Chicago Blackhawks,2,Central,Western,20,2,38,0.5263157894736842,22,-2,20,0
2017-18,2017-11-19,Chicago Blackhawks,2,Central,Western,22,2,40,0.55,24,-2,21,1
2017-18,2017-11-23,Chicago Blackhawks,1,Central,Western,23,2,42,0.5476190476190477,28,-5,23,0
2017-18,2017-11-26,Chicago Blackhawks,2,Central,Western,25,2,44,0.5681818181818182,31,-6,26,-1
2017-18,2017-11-28,Chicago Blackhawks,2,Central,Western,27,2,46,0.5869565217391305,31,-4,26,1
2017-18,2017-11-29,Chicago Blackhawks,0,Central,Western,27,2,48,0.5625,33,-6,27,0
2017-18,2017-12-01,Chicago Blackhawks,1,Central,Western,28,2,50,0.56,33,-5,28,0
2017-18,2017-12-03,Chicago Blackhawks,1,Central,Western,29,2,52,0.5576923076923077,35,-6,30,-1
2017-18,2017-12-04,Chicago Blackhawks,0,Central,Western,29,2,54,0.5370370370370371,35,-6,30,-1
2017-18,2017-12-07,Chicago Blackhawks,0,Central,Western,29,2,56,0.5178571428571429,38,-9,30,-1
2017-18,2017-12-09,Chicago Blackhawks,2,Central,Western,31,2,58,0.5344827586206896,38,-7,32,-1
2017-18,2017-12-11,Chicago Blackhawks,2,Central,Western,33,2,60,0.55,39,-6,33,0
2017-18,2017-12-13,Chicago Blackhawks,2,Central,Western,35,2,62,0.5645161290322581,40,-5,35,0
2017-18,2017-12-15,Chicago Blackhawks,2,Central,Western,37,2,64,0.578125,41,-4,37,0
2017-18,2017-12-18,Chicago Blackhawks,2,Central,Western,39,2,66,0.5909090909090909,43,-4,38,1
2017-18,2017-12-22,Chicago Blackhawks,0,Central,Western,39,2,68,0.5735294117647058,46,-7,39,0
2017-18,2017-12-24,Chicago Blackhawks,0,Central,Western,39,2,70,0.5571428571428572,46,-7,40,-1
2017-18,2017-12-29,Chicago Blackhawks,0,Central,Western,39,2,72,0.5416666666666666,48,-9,41,-2
2017-18,2017-12-30,Chicago Blackhawks,2,Central,Western,41,2,74,0.5540540540540541,48,-7,43,-2
2017-18,2018-01-01,Chicago Blackhawks,1,Central,Western,42,2,76,0.5526315789473685,50,-8,44,-2
2017-18,2018-01-04,Chicago Blackhawks,2,Central,Western,44,2,78,0.5641025641025641,51,-7,46,-2
2017-18,2018-01-06,Chicago Blackhawks,0,Central,Western,44,2,80,0.55,52,-8,47,-3
2017-18,2018-01-07,Chicago Blackhawks,2,Central,Western,46,2,82,0.5609756097560976,54,-8,47,-1
2017-18,2018-01-10,Chicago Blackhawks,2,Central,Western,48,2,84,0.5714285714285714,55,-7,48,0
2017-18,2018-01-11,Chicago Blackhawks,0,Central,Western,48,2,86,0.5581395348837209,55,-7,48,0
2017-18,2018-01-13,Chicago Blackhawks,2,Central,Western,50,2,88,0.5681818181818182,55,-5,50,0
2017-18,2018-01-14,Chicago Blackhawks,0,Central,Western,50,2,90,0.5555555555555556,55,-5,51,-1
2017-18,2018-01-21,Chicago Blackhawks,0,Central,Western,50,2,92,0.5434782608695652,59,-9,55,-5
2017-18,2018-01-23,Chicago Blackhawks,0,Central,Western,50,2,94,0.5319148936170213,59,-9,57,-7
2017-18,2018-01-25,Chicago Blackhawks,1,Central,Western,51,2,96,0.53125,61,-10,57,-6
2017-18,2018-01-26,Chicago Blackhawks,2,Central,Western,53,2,98,0.5408163265306123,63,-10,57,-4
2017-18,2018-01-31,Chicago Blackhawks,2,Central,Western,55,2,100,0.55,65,-10,59,-4
2017-18,2018-02-02,Chicago Blackhawks,0,Central,Western,55,2,102,0.5392156862745098,65,-10,60,-5
2017-18,2018-02-04,Chicago Blackhawks,1,Central,Western,56,2,104,0.5384615384615384,67,-11,61,-5
2017-18,2018-02-07,Chicago Blackhawks,0,Central,Western,56,2,106,0.5283018867924528,67,-11,62,-6
2017-18,2018-02-09,Chicago Blackhawks,0,Central,Western,56,2,108,0.5185185185185185,69,-13,64,-8
2017-18,2018-02-11,Chicago Blackhawks,0,Central,Western,56,2,110,0.509090909090909,71,-15,65,-9
2017-18,2018-02-13,Chicago Blackhawks,0,Central,Western,56,2,112,0.5,71,-15,66,-10
2017-18,2018-02-14,Chicago Blackhawks,0,Central,Western,56,2,114,0.49122807017543857,72,-16,66,-10
2017-18,2018-02-16,Chicago Blackhawks,0,Central,Western,56,2,116,0.4827586206896552,72,-16,68,-12
2017-18,2018-02-18,Chicago Blackhawks,2,Central,Western,58,2,118,0.4915254237288136,72,-14,69,-11
2017-18,2018-02-20,Chicago Blackhawks,0,Central,Western,58,2,120,0.48333333333333334,72,-14,71,-13
2017-18,2018-02-22,Chicago Blackhawks,2,Central,Western,60,2,122,0.4918032786885246,72,-12,71,-11
2017-18,2018-02-24,Chicago Blackhawks,2,Central,Western,62,2,124,0.5,75,-13,73,-11
2017-18,2018-02-25,Chicago Blackhawks,0,Central,Western,62,2,126,0.49206349206349204,75,-13,73,-11
2017-18,2018-03-02,Chicago Blackhawks,0,Central,Western,62,2,128,0.484375,79,-17,74,-12
2017-18,2018-03-03,Chicago Blackhawks,2,Central,Western,64,2,130,0.49230769230769234,79,-15,76,-12
2017-18,2018-03-04,Chicago Blackhawks,0,Central,Western,64,2,132,0.48484848484848486,79,-15,77,-13
2017-18,2018-03-07,Chicago Blackhawks,2,Central,Western,66,2,134,0.4925373134328358,83,-17,77,-11
2017-18,2018-03-09,Chicago Blackhawks,0,Central,Western,66,2,136,0.4852941176470588,83,-17,79,-13
2017-18,2018-03-10,Chicago Blackhawks,0,Central,Western,66,2,138,0.4782608695652174,85,-19,80,-14
2017-18,2018-03-11,Chicago Blackhawks,2,Central,Western,68,2,140,0.4857142857142857,85,-17,80,-12
2017-18,2018-03-16,Chicago Blackhawks,0,Central,Western,68,2,142,0.4788732394366197,85,-17,84,-16
2017-18,2018-03-17,Chicago Blackhawks,0,Central,Western,68,2,144,0.4722222222222222,87,-19,84,-16
2017-18,2018-03-18,Chicago Blackhawks,1,Central,Western,69,2,146,0.4726027397260274,89,-20,84,-15
2017-18,2018-03-21,Chicago Blackhawks,0,Central,Western,69,2,148,0.46621621621621623,90,-21,86,-17
2017-18,2018-03-23,Chicago Blackhawks,0,Central,Western,69,2,150,0.46,90,-21,88,-19
2017-18,2018-03-24,Chicago Blackhawks,2,Central,Western,71,2,152,0.46710526315789475,90,-19,89,-18
2017-18,2018-03-27,Chicago Blackhawks,1,Central,Western,72,2,154,0.4675324675324675,93,-21,90,-18
2017-18,2018-03-30,Chicago Blackhawks,2,Central,Western,74,2,156,0.47435897435897434,96,-22,91,-17
2017-18,2018-03-31,Chicago Blackhawks,0,Central,Western,74,2,158,0.46835443037974683,96,-22,92,-18
2017-18,2018-04-05,Chicago Blackhawks,2,Central,Western,76,2,160,0.475,98,-22,93,-17
2017-18,2018-04-07,Chicago Blackhawks,0,Central,Western,76,2,162,0.4691358024691358,99,-23,94,-18
2017-18,2018-04-07,Chicago Blackhawks,0,Central,Western,76,2,164,0.4634146341463415,99,-23,94,-18
2017-18,2017-10-05,Colorado Avalanche,2,Central,Western,2,2,2,1.0,0,2,0,2
2017-18,2017-10-07,Colorado Avalanche,0,Central,Western,2,2,4,0.5,2,0,1,1
2017-18,2017-10-09,Colorado Avalanche,2,Central,Western,4,2,6,0.6666666666666666,4,0,2,2
2017-18,2017-10-12,Colorado Avalanche,2,Central,Western,6,2,8,0.75,6,0,3,3
2017-18,2017-10-14,Colorado Avalanche,2,Central,Western,8,2,10,0.8,7,1,5,3
2017-18,2017-10-15,Colorado Avalanche,0,Central,Western,8,2,12,0.6666666666666666,8,0,5,3
2017-18,2017-10-18,Colorado Avalanche,0,Central,Western,8,2,14,0.5714285714285714,8,0,6,2
2017-18,2017-10-20,Colorado Avalanche,0,Central,Western,8,2,16,0.5,9,-1,8,0
2017-18,2017-10-25,Colorado Avalanche,2,Central,Western,10,2,18,0.5555555555555556,10,0,10,0
2017-18,2017-10-27,Colorado Avalanche,0,Central,Western,10,2,20,0.5,10,0,10,0
2017-18,2017-10-29,Colorado Avalanche,2,Central,Western,12,2,22,0.5454545454545454,12,0,12,0
2017-18,2017-11-03,Colorado Avalanche,2,Central,Western,14,2,24,0.5833333333333334,14,0,14,0
2017-18,2017-11-04,Colorado Avalanche,2,Central,Western,16,2,26,0.6153846153846154,16,0,14,2
2017-18,2017-11-05,Colorado Avalanche,0,Central,Western,16,2,28,0.5714285714285714,16,0,16,0
2017-18,2017-11-11,Colorado Avalanche,1,Central,Western,17,2,30,0.5666666666666667,18,-1,18,-1
2017-18,2017-11-12,Colorado Avalanche,0,Central,Western,17,2,32,0.53125,20,-3,18,-1
2017-18,2017-11-17,Colorado Avalanche,2,Central,Western,19,2,34,0.5588235294117647,22,-3,20,-1
2017-18,2017-11-19,Colorado Avalanche,0,Central,Western,19,2,36,0.5277777777777778,24,-5,21,-2
2017-18,2017-11-19,Colorado Avalanche,2,Central,Western,21,2,38,0.5526315789473685,24,-3,21,0
2017-18,2017-11-23,Colorado Avalanche,2,Central,Western,23,2,40,0.575,28,-5,23,0
2017-18,2017-11-24,Colorado Avalanche,1,Central,Western,24,2,42,0.5714285714285714,28,-4,25,-1
2017-18,2017-11-26,Colorado Avalanche,0,Central,Western,24,2,44,0.5454545454545454,31,-7,26,-2
2017-18,2017-11-30,Colorado Avalanche,2,Central,Western,26,2,46,0.5652173913043478,33,-7,27,-1
2017-18,2017-12-02,Colorado Avalanche,0,Central,Western,26,2,48,0.5416666666666666,33,-7,29,-3
2017-18,2017-12-04,Colorado Avalanche,0,Central,Western,26,2,50,0.52,35,-9,30,-4
2017-18,2017-12-06,Colorado Avalanche,0,Central,Western,26,2,52,0.5,38,-12,30,-4
2017-18,2017-12-08,Colorado Avalanche,0,Central,Western,26,2,54,0.48148148148148145,38,-12,32,-6
2017-18,2017-12-10,Colorado Avalanche,2,Central,Western,28,2,56,0.5,39,-11,33,-5
2017-18,2017-12-12,Colorado Avalanche,2,Central,Western,30,2,58,0.5172413793103449,40,-10,34,-4
2017-18,2017-12-13,Colorado Avalanche,0,Central,Western,30,2,60,0.5,40,-10,35,-5
2017-18,2017-12-15,Colorado Avalanche,2,Central,Western,32,2,62,0.5161290322580645,41,-9,37,-5
2017-18,2017-12-17,Colorado Avalanche,0,Central,Western,32,2,64,0.5,43,-11,37,-5
2017-18,2017-12-19,Colorado Avalanche,2,Central,Western,34,2,66,0.5151515151515151,43,-9,38,-4
2017-18,2017-12-22,Colorado Avalanche,1,Central,Western,35,2,68,0.5147058823529411,46,-11,39,-4
2017-18,2017-12-24,Colorado Avalanche,2,Central,Western,37,2,70,0.5285714285714286,46,-9,40,-3
2017-18,2017-12-28,Colorado Avalanche,0,Central,Western,37,2,72,0.5138888888888888,48,-11,41,-4
2017-18,2017-12-30,Colorado Avalanche,2,Central,Western,39,2,74,0.527027027027027,48,-9,43,-4
2017-18,2018-01-01,Colorado Avalanche,2,Central,Western,41,2,76,0.5394736842105263,50,-9,44,-3
2017-18,2018-01-03,Colorado Avalanche,2,Central,Western,43,2,78,0.5512820512820513,51,-8,46,-3
2017-18,2018-01-05,Colorado Avalanche,2,Central,Western,45,2,80,0.5625,52,-7,47,-2
2017-18,2018-01-07,Colorado Avalanche,2,Central,Western,47,2,82,0.573170731707317,54,-7,47,0
2017-18,2018-01-14,Colorado Avalanche,2,Central,Western,49,2,84,0.5833333333333334,55,-6,51,-2
2017-18,2018-01-15,Colorado Avalanche,2,Central,Western,51,2,86,0.5930232558139535,55,-4,53,-2
2017-18,2018-01-19,Colorado Avalanche,2,Central,Western,53,2,88,0.6022727272727273,59,-6,53,0
2017-18,2018-01-20,Colorado Avalanche,2,Central,Western,55,2,90,0.6111111111111112,59,-4,54,1
2017-18,2018-01-23,Colorado Avalanche,2,Central,Western,57,2,92,0.6195652173913043,59,-2,57,0
2017-18,2018-01-24,Colorado Avalanche,0,Central,Western,57,2,94,0.6063829787234043,61,-4,57,0
2017-18,2018-01-26,Colorado Avalanche,0,Central,Western,57,2,96,0.59375,63,-6,57,0
2017-18,2018-01-31,Colorado Avalanche,1,Central,Western,58,2,98,0.5918367346938775,65,-7,59,-1
2017-18,2018-02-02,Colorado Avalanche,2,Central,Western,60,2,100,0.6,65,-5,60,0
2017-18,2018-02-04,Colorado Avalanche,0,Central,Western,60,2,102,0.5882352941176471,67,-7,61,-1
2017-18,2018-02-07,Colorado Avalanche,2,Central,Western,62,2,104,0.5961538461538461,67,-5,62,0
2017-18,2018-02-09,Colorado Avalanche,0,Central,Western,62,2,106,0.5849056603773585,69,-7,64,-2
2017-18,2018-02-11,Colorado Avalanche,0,Central,Western,62,2,108,0.5740740740740741,71,-9,65,-3
2017-18,2018-02-12,Colorado Avalanche,2,Central,Western,64,2,110,0.5818181818181818,71,-7,66,-2
2017-18,2018-02-15,Colorado Avalanche,2,Central,Western,66,2,112,0.5892857142857143,72,-6,66,0
2017-18,2018-02-17,Colorado Avalanche,0,Central,Western,66,2,114,0.5789473684210527,72,-6,69,-3
2017-18,2018-02-18,Colorado Avalanche,0,Central,Western,66,2,116,0.5689655172413793,72,-6,69,-3
2017-18,2018-02-21,Colorado Avalanche,2,Central,Western,68,2,118,0.576271186440678,72,-4,71,-3
2017-18,2018-02-23,Colorado Avalanche,1,Central,Western,69,2,120,0.575,74,-5,72,-3
2017-18,2018-02-24,Colorado Avalanche,0,Central,Western,69,2,122,0.5655737704918032,75,-6,73,-4
2017-18,2018-02-27,Colorado Avalanche,2,Central,Western,71,2,124,0.5725806451612904,77,-6,73,-2
2017-18,2018-03-01,Colorado Avalanche,2,Central,Western,73,2,126,0.5793650793650794,79,-6,74,-1
2017-18,2018-03-03,Colorado Avalanche,2,Central,Western,75,2,128,0.5859375,79,-4,76,-1
2017-18,2018-03-04,Colorado Avalanche,1,Central,Western,76,2,130,0.5846153846153846,79,-3,77,-1
2017-18,2018-03-07,Colorado Avalanche,1,Central,Western,77,2,132,0.5833333333333334,83,-6,77,0
2017-18,2018-03-09,Colorado Avalanche,1,Central,Western,78,2,134,0.582089552238806,83,-5,79,-1
2017-18,2018-03-10,Colorado Avalanche,2,Central,Western,80,2,136,0.5882352941176471,85,-5,80,0
2017-18,2018-03-14,Colorado Avalanche,2,Central,Western,82,2,138,0.5942028985507246,85,-3,82,0
2017-18,2018-03-16,Colorado Avalanche,2,Central,Western,84,2,140,0.6,85,-1,84,0
2017-18,2018-03-17,Colorado Avalanche,0,Central,Western,84,2,142,0.5915492957746479,87,-3,84,0
2017-18,2018-03-18,Colorado Avalanche,2,Central,Western,86,2,144,0.5972222222222222,89,-3,84,2
2017-18,2018-03-21,Colorado Avalanche,2,Central,Western,88,2,146,0.6027397260273972,90,-2,86,2
2017-18,2018-03-23,Colorado Avalanche,0,Central,Western,88,2,148,0.5945945945945946,90,-2,88,0
2017-18,2018-03-24,Colorado Avalanche,2,Central,Western,90,2,150,0.6,90,0,89,1
2017-18,2018-03-27,Colorado Avalanche,0,Central,Western,90,2,152,0.5921052631578947,93,-3,90,0
2017-18,2018-03-29,Colorado Avalanche,0,Central,Western,90,2,154,0.5844155844155844,94,-4,91,-1
2017-18,2018-03-31,Colorado Avalanche,2,Central,Western,92,2,156,0.5897435897435898,96,-4,92,0
2017-18,2018-04-02,Colorado Avalanche,1,Central,Western,93,2,158,0.5886075949367089,96,-3,93,0
2017-18,2018-04-03,Colorado Avalanche,0,Central,Western,93,2,160,0.58125,98,-5,93,0
2017-18,2018-04-06,Colorado Avalanche,0,Central,Western,93,2,162,0.5740740740740741,99,-6,93,0
2017-18,2018-04-08,Colorado Avalanche,2,Central,Western,95,2,164,0.5792682926829268,101,-6,95,0
2017-18,2017-10-06,Columbus Blue Jackets,2,Metropolitan,Eastern,2,2,2,1.0,2,0,2,0
2017-18,2017-10-08,Columbus Blue Jackets,0,Metropolitan,Eastern,2,2,4,0.5,3,-1,2,0
2017-18,2017-10-10,Columbus Blue Jackets,2,Metropolitan,Eastern,4,2,6,0.6666666666666666,4,0,3,1
2017-18,2017-10-13,Columbus Blue Jackets,2,Metropolitan,Eastern,6,2,8,0.75,6,0,4,2
2017-18,2017-10-15,Columbus Blue Jackets,2,Metropolitan,Eastern,8,2,10,0.8,7,1,7,1
2017-18,2017-10-18,Columbus Blue Jackets,2,Metropolitan,Eastern,10,2,12,0.8333333333333334,9,1,8,2
2017-18,2017-10-19,Columbus Blue Jackets,0,Metropolitan,Eastern,10,2,14,0.7142857142857143,9,1,8,2
2017-18,2017-10-21,Columbus Blue Jackets,0,Metropolitan,Eastern,10,2,16,0.625,10,0,9,1
2017-18,2017-10-26,Columbus Blue Jackets,2,Metropolitan,Eastern,12,2,18,0.6666666666666666,12,0,10,2
2017-18,2017-10-27,Columbus Blue Jackets,2,Metropolitan,Eastern,14,2,20,0.7,14,0,10,4
2017-18,2017-10-29,Columbus Blue Jackets,0,Metropolitan,Eastern,14,2,22,0.6363636363636364,14,0,12,2
2017-18,2017-10-30,Columbus Blue Jackets,2,Metropolitan,Eastern,16,2,24,0.6666666666666666,15,1,13,3
2017-18,2017-11-02,Columbus Blue Jackets,2,Metropolitan,Eastern,18,2,26,0.6923076923076923,17,1,13,5
2017-18,2017-11-04,Columbus Blue Jackets,1,Metropolitan,Eastern,19,2,28,0.6785714285714286,18,1,15,4
2017-18,2017-11-07,Columbus Blue Jackets,0,Metropolitan,Eastern,19,2,30,0.6333333333333333,18,1,17,2
2017-18,2017-11-08,Columbus Blue Jackets,0,Metropolitan,Eastern,19,2,32,0.59375,19,0,17,2
2017-18,2017-11-11,Columbus Blue Jackets,0,Metropolitan,Eastern,19,2,34,0.5588235294117647,20,-1,19,0
2017-18,2017-11-12,Columbus Blue Jackets,2,Metropolitan,Eastern,21,2,36,0.5833333333333334,21,0,20,1
2017-18,2017-11-15,Columbus Blue Jackets,2,Metropolitan,Eastern,23,2,38,0.6052631578947368,23,0,20,3
2017-18,2017-11-18,Columbus Blue Jackets,2,Metropolitan,Eastern,25,2,40,0.625,25,0,22,3
2017-18,2017-11-21,Columbus Blue Jackets,2,Metropolitan,Eastern,27,2,42,0.6428571428571429,25,2,23,4
2017-18,2017-11-23,Columbus Blue Jackets,2,Metropolitan,Eastern,29,2,44,0.6590909090909091,26,3,24,5
2017-18,2017-11-25,Columbus Blue Jackets,2,Metropolitan,Eastern,31,2,46,0.6739130434782609,28,3,25,6
2017-18,2017-11-28,Columbus Blue Jackets,0,Metropolitan,Eastern,31,2,48,0.6458333333333334,30,1,28,3
2017-18,2017-11-29,Columbus Blue Jackets,2,Metropolitan,Eastern,33,2,50,0.66,32,1,28,5
2017-18,2017-12-02,Columbus Blue Jackets,2,Metropolitan,Eastern,35,2,52,0.6730769230769231,32,3,29,6
2017-18,2017-12-03,Columbus Blue Jackets,0,Metropolitan,Eastern,35,2,54,0.6481481481481481,33,2,30,5
2017-18,2017-12-06,Columbus Blue Jackets,0,Metropolitan,Eastern,35,2,56,0.625,34,1,32,3
2017-18,2017-12-09,Columbus Blue Jackets,2,Metropolitan,Eastern,37,2,58,0.6379310344827587,36,1,32,5
2017-18,2017-12-10,Columbus Blue Jackets,2,Metropolitan,Eastern,39,2,60,0.65,36,3,34,5
2017-18,2017-12-13,Columbus Blue Jackets,0,Metropolitan,Eastern,39,2,62,0.6290322580645161,38,1,35,4
2017-18,2017-12-15,Columbus Blue Jackets,2,Metropolitan,Eastern,41,2,64,0.640625,39,2,35,6
2017-18,2017-12-17,Columbus Blue Jackets,0,Metropolitan,Eastern,41,2,66,0.6212121212121212,41,0,37,4
2017-18,2017-12-19,Columbus Blue Jackets,0,Metropolitan,Eastern,41,2,68,0.6029411764705882,41,0,37,4
2017-18,2017-12-21,Columbus Blue Jackets,2,Metropolitan,Eastern,43,2,70,0.6142857142857143,43,0,39,4
2017-18,2017-12-22,Columbus Blue Jackets,1,Metropolitan,Eastern,44,2,72,0.6111111111111112,44,0,40,4
2017-18,2017-12-24,Columbus Blue Jackets,2,Metropolitan,Eastern,46,2,74,0.6216216216216216,46,0,42,4
2017-18,2017-12-28,Columbus Blue Jackets,1,Metropolitan,Eastern,47,2,76,0.618421052631579,47,0,44,3
2017-18,2017-12-30,Columbus Blue Jackets,0,Metropolitan,Eastern,47,2,78,0.6025641025641025,47,0,44,3
2017-18,2017-12-31,Columbus Blue Jackets,0,Metropolitan,Eastern,47,2,80,0.5875,47,0,44,3
2017-18,2018-01-03,Columbus Blue Jackets,2,Metropolitan,Eastern,49,2,82,0.5975609756097561,49,0,44,5
2017-18,2018-01-05,Columbus Blue Jackets,0,Metropolitan,Eastern,49,2,84,0.5833333333333334,49,0,46,3
2017-18,2018-01-07,Columbus Blue Jackets,2,Metropolitan,Eastern,51,2,86,0.5930232558139535,51,0,46,5
2017-18,2018-01-09,Columbus Blue Jackets,2,Metropolitan,Eastern,53,2,88,0.6022727272727273,52,1,47,6
2017-18,2018-01-12,Columbus Blue Jackets,0,Metropolitan,Eastern,53,2,90,0.5888888888888889,52,1,48,5
2017-18,2018-01-13,Columbus Blue Jackets,0,Metropolitan,Eastern,53,2,92,0.5760869565217391,52,1,49,4
2017-18,2018-01-19,Columbus Blue Jackets,2,Metropolitan,Eastern,55,2,94,0.5851063829787234,55,0,53,2
2017-18,2018-01-24,Columbus Blue Jackets,0,Metropolitan,Eastern,55,2,96,0.5729166666666666,56,-1,55,0
2017-18,2018-01-26,Columbus Blue Jackets,2,Metropolitan,Eastern,57,2,98,0.5816326530612245,57,0,56,1
2017-18,2018-01-31,Columbus Blue Jackets,1,Metropolitan,Eastern,58,2,100,0.58,58,0,56,2
2017-18,2018-02-03,Columbus Blue Jackets,0,Metropolitan,Eastern,58,2,102,0.5686274509803921,60,-2,57,1
2017-18,2018-02-04,Columbus Blue Jackets,0,Metropolitan,Eastern,58,2,104,0.5576923076923077,61,-3,57,1
2017-18,2018-02-07,Columbus Blue Jackets,0,Metropolitan,Eastern,58,2,106,0.5471698113207547,62,-4,58,0
2017-18,2018-02-10,Columbus Blue Jackets,0,Metropolitan,Eastern,58,2,108,0.5370370370370371,62,-4,60,-2
2017-18,2018-02-11,Columbus Blue Jackets,2,Metropolitan,Eastern,60,2,110,0.5454545454545454,63,-3,61,-1
2017-18,2018-02-14,Columbus Blue Jackets,2,Metropolitan,Eastern,62,2,112,0.5535714285714286,66,-4,63,-1
2017-18,2018-02-15,Columbus Blue Jackets,0,Metropolitan,Eastern,62,2,114,0.543859649122807,66,-4,63,-1
2017-18,2018-02-17,Columbus Blue Jackets,1,Metropolitan,Eastern,63,2,116,0.5431034482758621,68,-5,64,-1
2017-18,2018-02-18,Columbus Blue Jackets,0,Metropolitan,Eastern,63,2,118,0.5338983050847458,70,-7,64,-1
2017-18,2018-02-21,Columbus Blue Jackets,2,Metropolitan,Eastern,65,2,120,0.5416666666666666,72,-7,65,0
2017-18,2018-02-23,Columbus Blue Jackets,0,Metropolitan,Eastern,65,2,122,0.5327868852459017,72,-7,65,0
2017-18,2018-02-25,Columbus Blue Jackets,2,Metropolitan,Eastern,67,2,124,0.5403225806451613,76,-9,67,0
2017-18,2018-02-27,Columbus Blue Jackets,2,Metropolitan,Eastern,69,2,126,0.5476190476190477,76,-7,69,0
2017-18,2018-03-02,Columbus Blue Jackets,0,Metropolitan,Eastern,69,2,128,0.5390625,76,-7,69,0
2017-18,2018-03-03,Columbus Blue Jackets,0,Metropolitan,Eastern,69,2,130,0.5307692307692308,78,-9,69,0
2017-18,2018-03-05,Columbus Blue Jackets,2,Metropolitan,Eastern,71,2,132,0.5378787878787878,78,-7,71,0
2017-18,2018-03-07,Columbus Blue Jackets,2,Metropolitan,Eastern,73,2,134,0.5447761194029851,79,-6,73,0
2017-18,2018-03-09,Columbus Blue Jackets,2,Metropolitan,Eastern,75,2,136,0.5514705882352942,79,-4,75,0
2017-18,2018-03-10,Columbus Blue Jackets,2,Metropolitan,Eastern,77,2,138,0.5579710144927537,81,-4,76,1
2017-18,2018-03-12,Columbus Blue Jackets,2,Metropolitan,Eastern,79,2,140,0.5642857142857143,81,-2,78,1
2017-18,2018-03-15,Columbus Blue Jackets,2,Metropolitan,Eastern,81,2,142,0.5704225352112676,81,0,80,1
2017-18,2018-03-17,Columbus Blue Jackets,2,Metropolitan,Eastern,83,2,144,0.5763888888888888,83,0,82,1
2017-18,2018-03-19,Columbus Blue Jackets,2,Metropolitan,Eastern,85,2,146,0.5821917808219178,85,0,82,3
2017-18,2018-03-20,Columbus Blue Jackets,2,Metropolitan,Eastern,87,2,148,0.5878378378378378,87,0,82,5
2017-18,2018-03-22,Columbus Blue Jackets,2,Metropolitan,Eastern,89,2,150,0.5933333333333334,89,0,82,7
2017-18,2018-03-24,Columbus Blue Jackets,0,Metropolitan,Eastern,89,2,152,0.5855263157894737,89,0,86,3
2017-18,2018-03-28,Columbus Blue Jackets,2,Metropolitan,Eastern,91,2,154,0.5909090909090909,91,0,88,3
2017-18,2018-03-30,Columbus Blue Jackets,2,Metropolitan,Eastern,93,2,156,0.5961538461538461,93,0,89,4
2017-18,2018-03-31,Columbus Blue Jackets,1,Metropolitan,Eastern,94,2,158,0.5949367088607594,94,0,91,3
2017-18,2018-04-03,Columbus Blue Jackets,2,Metropolitan,Eastern,96,2,160,0.6,96,0,94,2
2017-18,2018-04-05,Columbus Blue Jackets,1,Metropolitan,Eastern,97,2,162,0.5987654320987654,97,0,96,1
2017-18,2018-04-08,Columbus Blue Jackets,0,Metropolitan,Eastern,97,2,164,0.5914634146341463,98,-1,97,0
2017-18,2017-10-07,Dallas Stars,0,Central,Western,0,2,2,0.0,2,-2,1,-1
2017-18,2017-10-08,Dallas Stars,0,Central,Western,0,2,4,0.0,2,-2,2,-2
2017-18,2017-10-11,Dallas Stars,2,Central,Western,2,2,6,0.3333333333333333,4,-2,3,-1
2017-18,2017-10-13,Dallas Stars,0,Central,Western,2,2,8,0.25,6,-4,4,-2
2017-18,2017-10-15,Dallas Stars,2,Central,Western,4,2,10,0.4,8,-4,5,-1
2017-18,2017-10-18,Dallas Stars,2,Central,Western,6,2,12,0.5,8,-2,6,0
2017-18,2017-10-20,Dallas Stars,2,Central,Western,8,2,14,0.5714285714285714,9,-1,8,0
2017-18,2017-10-22,Dallas Stars,2,Central,Western,10,2,16,0.625,10,0,8,2
2017-18,2017-10-25,Dallas Stars,0,Central,Western,10,2,18,0.5555555555555556,10,0,10,0
2017-18,2017-10-27,Dallas Stars,0,Central,Western,10,2,20,0.5,10,0,10,0
2017-18,2017-10-28,Dallas Stars,2,Central,Western,12,2,22,0.5454545454545454,12,0,11,1
2017-18,2017-10-31,Dallas Stars,2,Central,Western,14,2,24,0.5833333333333334,12,2,12,2
2017-18,2017-11-03,Dallas Stars,0,Central,Western,14,2,26,0.5384615384615384,14,0,14,0
2017-18,2017-11-05,Dallas Stars,2,Central,Western,16,2,28,0.5714285714285714,16,0,16,0
2017-18,2017-11-07,Dallas Stars,0,Central,Western,16,2,30,0.5333333333333333,16,0,16,0
2017-18,2017-11-11,Dallas Stars,2,Central,Western,18,2,32,0.5625,18,0,18,0
2017-18,2017-11-14,Dallas Stars,0,Central,Western,18,2,34,0.5294117647058824,20,-2,18,0
2017-18,2017-11-15,Dallas Stars,1,Central,Western,19,2,36,0.5277777777777778,22,-3,20,-1
2017-18,2017-11-17,Dallas Stars,0,Central,Western,19,2,38,0.5,22,-3,20,-1
2017-18,2017-11-18,Dallas Stars,2,Central,Western,21,2,40,0.525,22,-1,20,1
2017-18,2017-11-22,Dallas Stars,2,Central,Western,23,2,42,0.5476190476190477,26,-3,23,0
2017-18,2017-11-23,Dallas Stars,0,Central,Western,23,2,44,0.5227272727272727,28,-5,23,0
2017-18,2017-11-25,Dallas Stars,2,Central,Western,25,2,46,0.5434782608695652,30,-5,25,0
2017-18,2017-11-29,Dallas Stars,2,Central,Western,27,2,48,0.5625,33,-6,27,0
2017-18,2017-12-01,Dallas Stars,2,Central,Western,29,2,50,0.58,33,-4,28,1
2017-18,2017-12-03,Dallas Stars,2,Central,Western,31,2,52,0.5961538461538461,35,-4,30,1
2017-18,2017-12-04,Dallas Stars,2,Central,Western,33,2,54,0.6111111111111112,35,-2,30,3
2017-18,2017-12-06,Dallas Stars,0,Central,Western,33,2,56,0.5892857142857143,38,-5,30,3
2017-18,2017-12-08,Dallas Stars,0,Central,Western,33,2,58,0.5689655172413793,38,-5,32,1
2017-18,2017-12-10,Dallas Stars,0,Central,Western,33,2,60,0.55,39,-6,33,0
2017-18,2017-12-12,Dallas Stars,2,Central,Western,35,2,62,0.5645161290322581,40,-5,34,1
2017-18,2017-12-14,Dallas Stars,2,Central,Western,37,2,64,0.578125,41,-4,35,2
2017-18,2017-12-16,Dallas Stars,0,Central,Western,37,2,66,0.5606060606060606,41,-4,37,0
2017-18,2017-12-17,Dallas Stars,1,Central,Western,38,2,68,0.5588235294117647,43,-5,37,1
2017-18,2017-12-20,Dallas Stars,1,Central,Western,39,2,70,0.5571428571428572,45,-6,39,0
2017-18,2017-12-22,Dallas Stars,2,Central,Western,41,2,72,0.5694444444444444,46,-5,39,2
2017-18,2017-12-24,Dallas Stars,2,Central,Western,43,2,74,0.581081081081081,46,-3,40,3
2017-18,2017-12-28,Dallas Stars,0,Central,Western,43,2,76,0.5657894736842105,48,-5,41,2
2017-18,2017-12-30,Dallas Stars,2,Central,Western,45,2,78,0.5769230769230769,48,-3,43,2
2017-18,2018-01-01,Dallas Stars,2,Central,Western,47,2,80,0.5875,50,-3,44,3
2017-18,2018-01-03,Dallas Stars,0,Central,Western,47,2,82,0.573170731707317,51,-4,46,1
2017-18,2018-01-05,Dallas Stars,2,Central,Western,49,2,84,0.5833333333333334,52,-3,47,2
2017-18,2018-01-06,Dallas Stars,2,Central,Western,51,2,86,0.5930232558139535,52,-1,47,4
2017-18,2018-01-14,Dallas Stars,0,Central,Western,51,2,88,0.5795454545454546,55,-4,51,0
2017-18,2018-01-15,Dallas Stars,2,Central,Western,53,2,90,0.5888888888888889,55,-2,53,0
2017-18,2018-01-17,Dallas Stars,2,Central,Western,55,2,92,0.5978260869565217,57,-2,53,2
2017-18,2018-01-19,Dallas Stars,1,Central,Western,56,2,94,0.5957446808510638,59,-3,53,3
2017-18,2018-01-20,Dallas Stars,2,Central,Western,58,2,96,0.6041666666666666,59,-1,54,4
2017-18,2018-01-24,Dallas Stars,2,Central,Western,60,2,98,0.6122448979591837,61,-1,57,3
2017-18,2018-01-26,Dallas Stars,0,Central,Western,60,2,100,0.6,63,-3,57,3
2017-18,2018-01-31,Dallas Stars,0,Central,Western,60,2,102,0.5882352941176471,65,-5,59,1
2017-18,2018-02-02,Dallas Stars,2,Central,Western,62,2,104,0.5961538461538461,65,-3,60,2
2017-18,2018-02-04,Dallas Stars,2,Central,Western,64,2,106,0.6037735849056604,67,-3,61,3
2017-18,2018-02-06,Dallas Stars,2,Central,Western,66,2,108,0.6111111111111112,67,-1,61,5
2017-18,2018-02-09,Dallas Stars,2,Central,Western,68,2,110,0.6181818181818182,69,-1,64,4
2017-18,2018-02-10,Dallas Stars,2,Central,Western,70,2,112,0.625,71,-1,64,6
2017-18,2018-02-11,Dallas Stars,0,Central,Western,70,2,114,0.6140350877192983,71,-1,65,5
2017-18,2018-02-17,Dallas Stars,2,Central,Western,72,2,116,0.6206896551724138,72,0,69,3
2017-18,2018-02-19,Dallas Stars,0,Central,Western,72,2,118,0.6101694915254238,72,0,69,3
2017-18,2018-02-22,Dallas Stars,0,Central,Western,72,2,120,0.6,72,0,71,1
2017-18,2018-02-23,Dallas Stars,2,Central,Western,74,2,122,0.6065573770491803,74,0,72,2
2017-18,2018-02-25,Dallas Stars,0,Central,Western,74,2,124,0.5967741935483871,75,-1,73,1
2017-18,2018-02-28,Dallas Stars,2,Central,Western,76,2,126,0.6031746031746031,79,-3,74,2
2017-18,2018-03-02,Dallas Stars,1,Central,Western,77,2,128,0.6015625,79,-2,74,3
2017-18,2018-03-03,Dallas Stars,2,Central,Western,79,2,130,0.6076923076923076,79,0,76,3
2017-18,2018-03-06,Dallas Stars,1,Central,Western,80,2,132,0.6060606060606061,81,-1,77,3
2017-18,2018-03-07,Dallas Stars,0,Central,Western,80,2,134,0.5970149253731343,83,-3,77,3
2017-18,2018-03-10,Dallas Stars,2,Central,Western,82,2,136,0.6029411764705882,85,-3,80,2
2017-18,2018-03-11,Dallas Stars,0,Central,Western,82,2,138,0.5942028985507246,85,-3,80,2
2017-18,2018-03-13,Dallas Stars,0,Central,Western,82,2,140,0.5857142857142857,85,-3,80,2
2017-18,2018-03-14,Dallas Stars,1,Central,Western,83,2,142,0.5845070422535211,85,-2,82,1
2017-18,2018-03-16,Dallas Stars,1,Central,Western,84,2,144,0.5833333333333334,85,-1,84,0
2017-18,2018-03-18,Dallas Stars,0,Central,Western,84,2,146,0.5753424657534246,89,-5,84,0
2017-18,2018-03-20,Dallas Stars,0,Central,Western,84,2,148,0.5675675675675675,90,-6,86,-2
2017-18,2018-03-24,Dallas Stars,0,Central,Western,84,2,150,0.56,90,-6,89,-5
2017-18,2018-03-25,Dallas Stars,0,Central,Western,84,2,152,0.5526315789473685,93,-9,89,-5
2017-18,2018-03-28,Dallas Stars,2,Central,Western,86,2,154,0.5584415584415584,94,-8,91,-5
2017-18,2018-03-30,Dallas Stars,0,Central,Western,86,2,156,0.5512820512820513,96,-10,91,-5
2017-18,2018-04-01,Dallas Stars,2,Central,Western,88,2,158,0.5569620253164557,96,-8,92,-4
2017-18,2018-04-04,Dallas Stars,2,Central,Western,90,2,160,0.5625,98,-8,93,-3
2017-18,2018-04-07,Dallas Stars,0,Central,Western,90,2,162,0.5555555555555556,99,-9,94,-4
2017-18,2018-04-08,Dallas Stars,2,Central,Western,92,2,164,0.5609756097560976,101,-9,95,-3
2017-18,2017-10-05,Detroit Red Wings,2,Atlantic,Eastern,2,2,2,1.0,2,0,1,1
2017-18,2017-10-07,Detroit Red Wings,2,Atlantic,Eastern,4,2,4,1.0,2,2,2,2
2017-18,2017-10-11,Detroit Red Wings,0,Atlantic,Eastern,4,2,6,0.6666666666666666,4,0,4,0
2017-18,2017-10-13,Detroit Red Wings,2,Atlantic,Eastern,6,2,8,0.75,6,0,4,2
2017-18,2017-10-14,Detroit Red Wings,2,Atlantic,Eastern,8,2,10,0.8,8,0,6,2
2017-18,2017-10-16,Detroit Red Wings,0,Atlantic,Eastern,8,2,12,0.6666666666666666,8,0,7,1
2017-18,2017-10-18,Detroit Red Wings,0,Atlantic,Eastern,8,2,14,0.5714285714285714,8,0,8,0
2017-18,2017-10-20,Detroit Red Wings,1,Atlantic,Eastern,9,2,16,0.5625,9,0,9,0
2017-18,2017-10-22,Detroit Red Wings,0,Atlantic,Eastern,9,2,18,0.5,11,-2,9,0
2017-18,2017-10-24,Detroit Red Wings,0,Atlantic,Eastern,9,2,20,0.45,12,-3,10,-1
2017-18,2017-10-26,Detroit Red Wings,0,Atlantic,Eastern,9,2,22,0.4090909090909091,14,-5,10,-1
2017-18,2017-10-28,Detroit Red Wings,2,Atlantic,Eastern,11,2,24,0.4583333333333333,14,-3,11,0
2017-18,2017-10-31,Detroit Red Wings,2,Atlantic,Eastern,13,2,26,0.5,14,-1,13,0
2017-18,2017-11-02,Detroit Red Wings,0,Atlantic,Eastern,13,2,28,0.4642857142857143,16,-3,13,0
2017-18,2017-11-05,Detroit Red Wings,2,Atlantic,Eastern,15,2,30,0.5,16,-1,16,-1
2017-18,2017-11-07,Detroit Red Wings,2,Atlantic,Eastern,17,2,32,0.53125,17,0,17,0
2017-18,2017-11-10,Detroit Red Wings,0,Atlantic,Eastern,17,2,34,0.5,17,0,18,-1
2017-18,2017-11-12,Detroit Red Wings,1,Atlantic,Eastern,18,2,36,0.5,21,-3,20,-2
2017-18,2017-11-16,Detroit Red Wings,2,Atlantic,Eastern,20,2,38,0.5263157894736842,21,-1,20,0
2017-18,2017-11-18,Detroit Red Wings,2,Atlantic,Eastern,22,2,40,0.55,22,0,22,0
2017-18,2017-11-19,Detroit Red Wings,1,Atlantic,Eastern,23,2,42,0.5476190476190477,23,0,23,0
2017-18,2017-11-23,Detroit Red Wings,0,Atlantic,Eastern,23,2,44,0.5227272727272727,23,0,24,-1
2017-18,2017-11-25,Detroit Red Wings,1,Atlantic,Eastern,24,2,46,0.5217391304347826,24,0,25,-1
2017-18,2017-11-26,Detroit Red Wings,1,Atlantic,Eastern,25,2,48,0.5208333333333334,25,0,27,-2
2017-18,2017-11-29,Detroit Red Wings,0,Atlantic,Eastern,25,2,50,0.5,25,0,28,-3
2017-18,2017-12-01,Detroit Red Wings,0,Atlantic,Eastern,25,2,52,0.4807692307692308,27,-2,28,-3
2017-18,2017-12-03,Detroit Red Wings,0,Atlantic,Eastern,25,2,54,0.46296296296296297,29,-4,30,-5
2017-18,2017-12-06,Detroit Red Wings,2,Atlantic,Eastern,27,2,56,0.48214285714285715,29,-2,32,-5
2017-18,2017-12-09,Detroit Red Wings,0,Atlantic,Eastern,27,2,58,0.46551724137931033,30,-3,32,-5
2017-18,2017-12-12,Detroit Red Wings,1,Atlantic,Eastern,28,2,60,0.4666666666666667,32,-4,35,-7
2017-18,2017-12-14,Detroit Red Wings,1,Atlantic,Eastern,29,2,62,0.46774193548387094,34,-5,35,-6
2017-18,2017-12-16,Detroit Red Wings,2,Atlantic,Eastern,31,2,64,0.484375,35,-4,35,-4
2017-18,2017-12-20,Detroit Red Wings,2,Atlantic,Eastern,33,2,66,0.5,39,-6,39,-6
2017-18,2017-12-21,Detroit Red Wings,0,Atlantic,Eastern,33,2,68,0.4852941176470588,39,-6,39,-6
2017-18,2017-12-23,Detroit Red Wings,0,Atlantic,Eastern,33,2,70,0.4714285714285714,43,-10,42,-9
2017-18,2017-12-28,Detroit Red Wings,0,Atlantic,Eastern,33,2,72,0.4583333333333333,45,-12,44,-11
2017-18,2017-12-30,Detroit Red Wings,2,Atlantic,Eastern,35,2,74,0.47297297297297297,46,-11,44,-9
2017-18,2018-01-01,Detroit Red Wings,2,Atlantic,Eastern,37,2,76,0.4868421052631579,48,-11,44,-7
2017-18,2018-01-04,Detroit Red Wings,2,Atlantic,Eastern,39,2,78,0.5,48,-9,44,-5
2017-18,2018-01-06,Detroit Red Wings,2,Atlantic,Eastern,41,2,80,0.5125,50,-9,46,-5
2017-18,2018-01-08,Detroit Red Wings,0,Atlantic,Eastern,41,2,82,0.5,52,-11,47,-6
2017-18,2018-01-13,Detroit Red Wings,0,Atlantic,Eastern,41,2,84,0.4880952380952381,53,-12,49,-8
2017-18,2018-01-14,Detroit Red Wings,2,Atlantic,Eastern,43,2,86,0.5,53,-10,49,-6
2017-18,2018-01-17,Detroit Red Wings,0,Atlantic,Eastern,43,2,88,0.48863636363636365,54,-11,51,-8
2017-18,2018-01-21,Detroit Red Wings,0,Atlantic,Eastern,43,2,90,0.4777777777777778,57,-14,53,-10
2017-18,2018-01-23,Detroit Red Wings,2,Atlantic,Eastern,45,2,92,0.4891304347826087,57,-12,53,-8
2017-18,2018-01-24,Detroit Red Wings,1,Atlantic,Eastern,46,2,94,0.48936170212765956,57,-11,55,-9
2017-18,2018-01-26,Detroit Red Wings,0,Atlantic,Eastern,46,2,96,0.4791666666666667,61,-15,56,-10
2017-18,2018-02-01,Detroit Red Wings,2,Atlantic,Eastern,48,2,98,0.4897959183673469,63,-15,56,-8
2017-18,2018-02-03,Detroit Red Wings,2,Atlantic,Eastern,50,2,100,0.5,65,-15,57,-7
2017-18,2018-02-04,Detroit Red Wings,0,Atlantic,Eastern,50,2,102,0.49019607843137253,65,-15,57,-7
2017-18,2018-02-07,Detroit Red Wings,0,Atlantic,Eastern,50,2,104,0.4807692307692308,67,-17,58,-8
2017-18,2018-02-10,Detroit Red Wings,1,Atlantic,Eastern,51,2,106,0.4811320754716981,69,-18,60,-9
2017-18,2018-02-11,Detroit Red Wings,2,Atlantic,Eastern,53,2,108,0.49074074074074076,71,-18,61,-8
2017-18,2018-02-14,Detroit Red Wings,2,Atlantic,Eastern,55,2,110,0.5,73,-18,63,-8
2017-18,2018-02-16,Detroit Red Wings,0,Atlantic,Eastern,55,2,112,0.49107142857142855,75,-20,63,-8
2017-18,2018-02-18,Detroit Red Wings,2,Atlantic,Eastern,57,2,114,0.5,75,-18,64,-7
2017-18,2018-02-19,Detroit Red Wings,0,Atlantic,Eastern,57,2,116,0.49137931034482757,77,-20,64,-7
2017-18,2018-02-21,Detroit Red Wings,0,Atlantic,Eastern,57,2,118,0.4830508474576271,79,-22,65,-8
2017-18,2018-02-23,Detroit Red Wings,1,Atlantic,Eastern,58,2,120,0.48333333333333334,81,-23,65,-7
2017-18,2018-02-25,Detroit Red Wings,2,Atlantic,Eastern,60,2,122,0.4918032786885246,82,-22,67,-7
2017-18,2018-02-26,Detroit Red Wings,2,Atlantic,Eastern,62,2,124,0.5,82,-20,67,-5
2017-18,2018-03-01,Detroit Red Wings,0,Atlantic,Eastern,62,2,126,0.49206349206349204,84,-22,69,-7
2017-18,2018-03-03,Detroit Red Wings,0,Atlantic,Eastern,62,2,128,0.484375,85,-23,69,-7
2017-18,2018-03-05,Detroit Red Wings,0,Atlantic,Eastern,62,2,130,0.47692307692307695,85,-23,71,-9
2017-18,2018-03-07,Detroit Red Wings,1,Atlantic,Eastern,63,2,132,0.4772727272727273,85,-22,73,-10
2017-18,2018-03-09,Detroit Red Wings,0,Atlantic,Eastern,63,2,134,0.4701492537313433,85,-22,75,-12
2017-18,2018-03-10,Detroit Red Wings,0,Atlantic,Eastern,63,2,136,0.4632352941176471,85,-22,76,-13
2017-18,2018-03-13,Detroit Red Wings,0,Atlantic,Eastern,63,2,138,0.45652173913043476,87,-24,78,-15
2017-18,2018-03-16,Detroit Red Wings,0,Atlantic,Eastern,63,2,140,0.45,91,-28,80,-17
2017-18,2018-03-17,Detroit Red Wings,0,Atlantic,Eastern,63,2,142,0.44366197183098594,93,-30,82,-19
2017-18,2018-03-18,Detroit Red Wings,0,Atlantic,Eastern,63,2,144,0.4375,93,-30,82,-19
2017-18,2018-03-20,Detroit Red Wings,2,Atlantic,Eastern,65,2,146,0.4452054794520548,93,-28,82,-17
2017-18,2018-03-22,Detroit Red Wings,0,Atlantic,Eastern,65,2,148,0.4391891891891892,93,-28,82,-17
2017-18,2018-03-24,Detroit Red Wings,0,Atlantic,Eastern,65,2,150,0.43333333333333335,97,-32,86,-21
2017-18,2018-03-26,Detroit Red Wings,0,Atlantic,Eastern,65,2,152,0.4276315789473684,97,-32,86,-21
2017-18,2018-03-27,Detroit Red Wings,2,Atlantic,Eastern,67,2,154,0.43506493506493504,97,-30,88,-21
2017-18,2018-03-29,Detroit Red Wings,2,Atlantic,Eastern,69,2,156,0.4423076923076923,99,-30,89,-20
2017-18,2018-03-31,Detroit Red Wings,2,Atlantic,Eastern,71,2,158,0.44936708860759494,101,-30,91,-20
2017-18,2018-04-03,Detroit Red Wings,1,Atlantic,Eastern,72,2,160,0.45,103,-31,94,-22
2017-18,2018-04-05,Detroit Red Wings,0,Atlantic,Eastern,72,2,162,0.4444444444444444,103,-31,96,-24
2017-18,2018-04-07,Detroit Red Wings,1,Atlantic,Eastern,73,2,164,0.4451219512195122,105,-32,97,-24
2017-18,2017-10-05,Edmonton Oilers,2,Pacific,Western,2,2,2,1.0,0,2,0,2
2017-18,2017-10-08,Edmonton Oilers,0,Pacific,Western,2,2,4,0.5,3,-1,2,0
2017-18,2017-10-10,Edmonton Oilers,0,Pacific,Western,2,2,6,0.3333333333333333,4,-2,2,0
2017-18,2017-10-15,Edmonton Oilers,0,Pacific,Western,2,2,8,0.25,7,-5,5,-3
2017-18,2017-10-18,Edmonton Oilers,0,Pacific,Western,2,2,10,0.2,8,-6,6,-4
2017-18,2017-10-20,Edmonton Oilers,2,Pacific,Western,4,2,12,0.3333333333333333,8,-4,8,-4
2017-18,2017-10-21,Edmonton Oilers,0,Pacific,Western,4,2,14,0.2857142857142857,8,-4,8,-4
2017-18,2017-10-24,Edmonton Oilers,1,Pacific,Western,5,2,16,0.3125,9,-4,9,-4
2017-18,2017-10-27,Edmonton Oilers,2,Pacific,Western,7,2,18,0.3888888888888889,13,-6,10,-3
2017-18,2017-10-29,Edmonton Oilers,0,Pacific,Western,7,2,20,0.35,13,-6,12,-5
2017-18,2017-11-02,Edmonton Oilers,0,Pacific,Western,7,2,22,0.3181818181818182,14,-7,14,-7
2017-18,2017-11-04,Edmonton Oilers,2,Pacific,Western,9,2,24,0.375,14,-5,14,-5
2017-18,2017-11-05,Edmonton Oilers,0,Pacific,Western,9,2,26,0.34615384615384615,16,-7,16,-7
2017-18,2017-11-08,Edmonton Oilers,2,Pacific,Western,11,2,28,0.39285714285714285,18,-7,16,-5
2017-18,2017-11-10,Edmonton Oilers,2,Pacific,Western,13,2,30,0.43333333333333335,18,-5,17,-4
2017-18,2017-11-11,Edmonton Oilers,0,Pacific,Western,13,2,32,0.40625,18,-5,18,-5
2017-18,2017-11-13,Edmonton Oilers,1,Pacific,Western,14,2,34,0.4117647058823529,20,-6,18,-4
2017-18,2017-11-15,Edmonton Oilers,2,Pacific,Western,16,2,36,0.4444444444444444,20,-4,20,-4
2017-18,2017-11-17,Edmonton Oilers,0,Pacific,Western,16,2,38,0.42105263157894735,20,-4,20,-4
2017-18,2017-11-18,Edmonton Oilers,0,Pacific,Western,16,2,40,0.4,22,-6,20,-4
2017-18,2017-11-22,Edmonton Oilers,0,Pacific,Western,16,2,42,0.38095238095238093,24,-8,23,-7
2017-18,2017-11-23,Edmonton Oilers,2,Pacific,Western,18,2,44,0.4090909090909091,25,-7,23,-5
2017-18,2017-11-25,Edmonton Oilers,0,Pacific,Western,18,2,46,0.391304347826087,25,-7,25,-7
2017-18,2017-11-26,Edmonton Oilers,2,Pacific,Western,20,2,48,0.4166666666666667,27,-7,26,-6
2017-18,2017-11-29,Edmonton Oilers,2,Pacific,Western,22,2,50,0.44,28,-6,27,-5
2017-18,2017-12-01,Edmonton Oilers,0,Pacific,Western,22,2,52,0.4230769230769231,29,-7,28,-6
2017-18,2017-12-03,Edmonton Oilers,2,Pacific,Western,24,2,54,0.4444444444444444,30,-6,30,-6
2017-18,2017-12-07,Edmonton Oilers,0,Pacific,Western,24,2,56,0.42857142857142855,32,-8,30,-6
2017-18,2017-12-10,Edmonton Oilers,2,Pacific,Western,26,2,58,0.4482758620689655,34,-8,33,-7
2017-18,2017-12-11,Edmonton Oilers,0,Pacific,Western,26,2,60,0.43333333333333335,35,-9,33,-7
2017-18,2017-12-13,Edmonton Oilers,2,Pacific,Western,28,2,62,0.45161290322580644,35,-7,35,-7
2017-18,2017-12-15,Edmonton Oilers,0,Pacific,Western,28,2,64,0.4375,37,-9,37,-9
2017-18,2017-12-16,Edmonton Oilers,2,Pacific,Western,30,2,66,0.45454545454545453,38,-8,37,-7
2017-18,2017-12-19,Edmonton Oilers,2,Pacific,Western,32,2,68,0.47058823529411764,38,-6,38,-6
2017-18,2017-12-22,Edmonton Oilers,2,Pacific,Western,34,2,70,0.4857142857142857,40,-6,39,-5
2017-18,2017-12-24,Edmonton Oilers,2,Pacific,Western,36,2,72,0.5,42,-6,40,-4
2017-18,2017-12-28,Edmonton Oilers,0,Pacific,Western,36,2,74,0.4864864864864865,42,-6,41,-5
2017-18,2017-12-30,Edmonton Oilers,1,Pacific,Western,37,2,76,0.4868421052631579,44,-7,43,-6
2017-18,2018-01-01,Edmonton Oilers,0,Pacific,Western,37,2,78,0.47435897435897434,44,-7,44,-7
2017-18,2018-01-03,Edmonton Oilers,0,Pacific,Western,37,2,80,0.4625,46,-9,46,-9
2017-18,2018-01-05,Edmonton Oilers,2,Pacific,Western,39,2,82,0.47560975609756095,47,-8,47,-8
2017-18,2018-01-06,Edmonton Oilers,0,Pacific,Western,39,2,84,0.4642857142857143,48,-9,47,-8
2017-18,2018-01-07,Edmonton Oilers,0,Pacific,Western,39,2,86,0.45348837209302323,48,-9,47,-8
2017-18,2018-01-10,Edmonton Oilers,0,Pacific,Western,39,2,88,0.4431818181818182,48,-9,48,-9
2017-18,2018-01-13,Edmonton Oilers,2,Pacific,Western,41,2,90,0.45555555555555555,52,-11,50,-9
2017-18,2018-01-14,Edmonton Oilers,2,Pacific,Western,43,2,92,0.4673913043478261,53,-10,51,-8
2017-18,2018-01-21,Edmonton Oilers,2,Pacific,Western,45,2,94,0.4787234042553192,55,-10,55,-10
2017-18,2018-01-24,Edmonton Oilers,0,Pacific,Western,45,2,96,0.46875,56,-11,57,-12
2017-18,2018-01-26,Edmonton Oilers,2,Pacific,Western,47,2,98,0.47959183673469385,58,-11,57,-10
2017-18,2018-02-02,Edmonton Oilers,1,Pacific,Western,48,2,100,0.48,60,-12,60,-12
2017-18,2018-02-06,Edmonton Oilers,2,Pacific,Western,50,2,102,0.49019607843137253,61,-11,61,-11
2017-18,2018-02-08,Edmonton Oilers,0,Pacific,Western,50,2,104,0.4807692307692308,63,-13,63,-13
2017-18,2018-02-10,Edmonton Oilers,0,Pacific,Western,50,2,106,0.4716981132075472,64,-14,64,-14
2017-18,2018-02-11,Edmonton Oilers,0,Pacific,Western,50,2,108,0.46296296296296297,65,-15,65,-15
2017-18,2018-02-13,Edmonton Oilers,0,Pacific,Western,50,2,110,0.45454545454545453,66,-16,66,-16
2017-18,2018-02-16,Edmonton Oilers,0,Pacific,Western,50,2,112,0.44642857142857145,68,-18,68,-18
2017-18,2018-02-17,Edmonton Oilers,0,Pacific,Western,50,2,114,0.43859649122807015,69,-19,69,-19
2017-18,2018-02-18,Edmonton Oilers,2,Pacific,Western,52,2,116,0.4482758620689655,69,-17,69,-17
2017-18,2018-02-21,Edmonton Oilers,0,Pacific,Western,52,2,118,0.4406779661016949,71,-19,71,-19
2017-18,2018-02-23,Edmonton Oilers,2,Pacific,Western,54,2,120,0.45,73,-19,72,-18
2017-18,2018-02-25,Edmonton Oilers,2,Pacific,Western,56,2,122,0.45901639344262296,73,-17,73,-17
2017-18,2018-02-26,Edmonton Oilers,2,Pacific,Western,58,2,124,0.46774193548387094,74,-16,73,-15
2017-18,2018-02-28,Edmonton Oilers,0,Pacific,Western,58,2,126,0.4603174603174603,75,-17,74,-16
2017-18,2018-03-02,Edmonton Oilers,0,Pacific,Western,58,2,128,0.453125,77,-19,74,-16
2017-18,2018-03-04,Edmonton Oilers,0,Pacific,Western,58,2,130,0.4461538461538462,78,-20,77,-19
2017-18,2018-03-06,Edmonton Oilers,2,Pacific,Western,60,2,132,0.45454545454545453,78,-18,77,-17
2017-18,2018-03-09,Edmonton Oilers,2,Pacific,Western,62,2,134,0.4626865671641791,80,-18,79,-17
2017-18,2018-03-11,Edmonton Oilers,2,Pacific,Western,64,2,136,0.47058823529411764,80,-16,80,-16
2017-18,2018-03-14,Edmonton Oilers,0,Pacific,Western,64,2,138,0.463768115942029,82,-18,82,-18
2017-18,2018-03-15,Edmonton Oilers,1,Pacific,Western,65,2,140,0.4642857142857143,82,-17,82,-17
2017-18,2018-03-17,Edmonton Oilers,2,Pacific,Western,67,2,142,0.47183098591549294,84,-17,84,-17
2017-18,2018-03-18,Edmonton Oilers,0,Pacific,Western,67,2,144,0.4652777777777778,84,-17,84,-17
2017-18,2018-03-20,Edmonton Oilers,2,Pacific,Western,69,2,146,0.4726027397260274,86,-17,86,-17
2017-18,2018-03-22,Edmonton Oilers,2,Pacific,Western,71,2,148,0.4797297297297297,88,-17,87,-16
2017-18,2018-03-25,Edmonton Oilers,2,Pacific,Western,73,2,150,0.4866666666666667,89,-16,89,-16
2017-18,2018-03-26,Edmonton Oilers,1,Pacific,Western,74,2,152,0.4868421052631579,91,-17,89,-15
2017-18,2018-03-28,Edmonton Oilers,0,Pacific,Western,74,2,154,0.4805194805194805,91,-17,91,-17
2017-18,2018-03-30,Edmonton Oilers,0,Pacific,Western,74,2,156,0.47435897435897434,93,-19,91,-17
2017-18,2018-04-01,Edmonton Oilers,0,Pacific,Western,74,2,158,0.46835443037974683,94,-20,92,-18
2017-18,2018-04-03,Edmonton Oilers,0,Pacific,Western,74,2,160,0.4625,96,-22,93,-19
2017-18,2018-04-06,Edmonton Oilers,2,Pacific,Western,76,2,162,0.4691358024691358,98,-22,93,-17
2017-18,2018-04-08,Edmonton Oilers,2,Pacific,Western,78,2,164,0.47560975609756095,100,-22,95,-17
2017-18,2017-10-06,Florida Panthers,0,Atlantic,Eastern,0,2,2,0.0,2,-2,2,-2
2017-18,2017-10-07,Florida Panthers,2,Atlantic,Eastern,2,2,4,0.5,2,0,2,0
2017-18,2017-10-12,Florida Panthers,2,Atlantic,Eastern,4,2,6,0.6666666666666666,4,0,4,0
2017-18,2017-10-14,Florida Panthers,0,Atlantic,Eastern,4,2,8,0.5,8,-4,6,-2
2017-18,2017-10-17,Florida Panthers,0,Atlantic,Eastern,4,2,10,0.4,8,-4,8,-4
2017-18,2017-10-20,Florida Panthers,0,Atlantic,Eastern,4,2,12,0.3333333333333333,9,-5,9,-5
2017-18,2017-10-21,Florida Panthers,2,Atlantic,Eastern,6,2,14,0.42857142857142855,11,-5,9,-3
2017-18,2017-10-24,Florida Panthers,0,Atlantic,Eastern,6,2,16,0.375,12,-6,10,-4
2017-18,2017-10-26,Florida Panthers,2,Atlantic,Eastern,8,2,18,0.4444444444444444,14,-6,10,-2
2017-18,2017-10-28,Florida Panthers,1,Atlantic,Eastern,9,2,20,0.45,14,-5,11,-2
2017-18,2017-10-30,Florida Panthers,0,Atlantic,Eastern,9,2,22,0.4090909090909091,14,-5,13,-4
2017-18,2017-11-02,Florida Panthers,0,Atlantic,Eastern,9,2,24,0.375,16,-7,13,-4
2017-18,2017-11-04,Florida Panthers,1,Atlantic,Eastern,10,2,26,0.38461538461538464,16,-6,15,-5
2017-18,2017-11-08,Florida Panthers,0,Atlantic,Eastern,10,2,28,0.35714285714285715,17,-7,17,-7
2017-18,2017-11-11,Florida Panthers,2,Atlantic,Eastern,12,2,30,0.4,19,-7,19,-7
2017-18,2017-11-12,Florida Panthers,0,Atlantic,Eastern,12,2,32,0.375,21,-9,20,-8
2017-18,2017-11-15,Florida Panthers,2,Atlantic,Eastern,14,2,34,0.4117647058823529,21,-7,20,-6
2017-18,2017-11-17,Florida Panthers,2,Atlantic,Eastern,16,2,36,0.4444444444444444,21,-5,21,-5
2017-18,2017-11-18,Florida Panthers,0,Atlantic,Eastern,16,2,38,0.42105263157894735,22,-6,22,-6
2017-18,2017-11-20,Florida Panthers,0,Atlantic,Eastern,16,2,40,0.4,23,-7,23,-7
2017-18,2017-11-23,Florida Panthers,2,Atlantic,Eastern,18,2,42,0.42857142857142855,23,-5,24,-6
2017-18,2017-11-26,Florida Panthers,0,Atlantic,Eastern,18,2,44,0.4090909090909091,25,-7,27,-9
2017-18,2017-11-28,Florida Panthers,2,Atlantic,Eastern,20,2,46,0.43478260869565216,25,-5,28,-8
2017-18,2017-11-29,Florida Panthers,2,Atlantic,Eastern,22,2,48,0.4583333333333333,25,-3,28,-6
2017-18,2017-12-02,Florida Panthers,0,Atlantic,Eastern,22,2,50,0.44,28,-6,29,-7
2017-18,2017-12-03,Florida Panthers,1,Atlantic,Eastern,23,2,52,0.4423076923076923,29,-6,30,-7
2017-18,2017-12-05,Florida Panthers,1,Atlantic,Eastern,24,2,54,0.4444444444444444,29,-5,30,-6
2017-18,2017-12-08,Florida Panthers,2,Atlantic,Eastern,26,2,56,0.4642857142857143,30,-4,32,-6
2017-18,2017-12-10,Florida Panthers,0,Atlantic,Eastern,26,2,58,0.4482758620689655,32,-6,34,-8
2017-18,2017-12-12,Florida Panthers,2,Atlantic,Eastern,28,2,60,0.4666666666666667,32,-4,35,-7
2017-18,2017-12-13,Florida Panthers,1,Atlantic,Eastern,29,2,62,0.46774193548387094,32,-3,35,-6
2017-18,2017-12-15,Florida Panthers,0,Atlantic,Eastern,29,2,64,0.453125,34,-5,35,-6
2017-18,2017-12-18,Florida Panthers,0,Atlantic,Eastern,29,2,66,0.4393939393939394,35,-6,37,-8
2017-18,2017-12-20,Florida Panthers,2,Atlantic,Eastern,31,2,68,0.45588235294117646,39,-8,39,-8
2017-18,2017-12-23,Florida Panthers,2,Atlantic,Eastern,33,2,70,0.4714285714285714,43,-10,42,-9
2017-18,2017-12-24,Florida Panthers,2,Atlantic,Eastern,35,2,72,0.4861111111111111,43,-8,42,-7
2017-18,2017-12-29,Florida Panthers,2,Atlantic,Eastern,37,2,74,0.5,46,-9,44,-7
2017-18,2017-12-31,Florida Panthers,2,Atlantic,Eastern,39,2,76,0.5131578947368421,48,-9,44,-5
2017-18,2018-01-03,Florida Panthers,0,Atlantic,Eastern,39,2,78,0.5,48,-9,44,-5
2017-18,2018-01-06,Florida Panthers,0,Atlantic,Eastern,39,2,80,0.4875,50,-11,46,-7
2017-18,2018-01-07,Florida Panthers,1,Atlantic,Eastern,40,2,82,0.4878048780487805,52,-12,46,-6
2017-18,2018-01-10,Florida Panthers,2,Atlantic,Eastern,42,2,84,0.5,53,-11,47,-5
2017-18,2018-01-13,Florida Panthers,0,Atlantic,Eastern,42,2,86,0.4883720930232558,53,-11,49,-7
2017-18,2018-01-20,Florida Panthers,2,Atlantic,Eastern,44,2,88,0.5,55,-11,53,-9
2017-18,2018-01-21,Florida Panthers,0,Atlantic,Eastern,44,2,90,0.4888888888888889,57,-13,53,-9
2017-18,2018-01-24,Florida Panthers,0,Atlantic,Eastern,44,2,92,0.4782608695652174,57,-13,55,-11
2017-18,2018-01-26,Florida Panthers,0,Atlantic,Eastern,44,2,94,0.46808510638297873,61,-17,56,-12
2017-18,2018-01-31,Florida Panthers,2,Atlantic,Eastern,46,2,96,0.4791666666666667,61,-15,56,-10
2017-18,2018-02-02,Florida Panthers,2,Atlantic,Eastern,48,2,98,0.4897959183673469,65,-17,56,-8
2017-18,2018-02-04,Florida Panthers,2,Atlantic,Eastern,50,2,100,0.5,65,-15,57,-7
2017-18,2018-02-07,Florida Panthers,2,Atlantic,Eastern,52,2,102,0.5098039215686274,67,-15,58,-6
2017-18,2018-02-10,Florida Panthers,0,Atlantic,Eastern,52,2,104,0.5,69,-17,60,-8
2017-18,2018-02-13,Florida Panthers,2,Atlantic,Eastern,54,2,106,0.5094339622641509,73,-19,61,-7
2017-18,2018-02-15,Florida Panthers,2,Atlantic,Eastern,56,2,108,0.5185185185185185,75,-19,63,-7
2017-18,2018-02-18,Florida Panthers,2,Atlantic,Eastern,58,2,110,0.5272727272727272,75,-17,64,-6
2017-18,2018-02-19,Florida Panthers,0,Atlantic,Eastern,58,2,112,0.5178571428571429,77,-19,64,-6
2017-18,2018-02-21,Florida Panthers,0,Atlantic,Eastern,58,2,114,0.5087719298245614,79,-21,65,-7
2017-18,2018-02-23,Florida Panthers,2,Atlantic,Eastern,60,2,116,0.5172413793103449,81,-21,65,-5
2017-18,2018-02-25,Florida Panthers,2,Atlantic,Eastern,62,2,118,0.5254237288135594,82,-20,67,-5
2017-18,2018-02-28,Florida Panthers,2,Atlantic,Eastern,64,2,120,0.5333333333333333,84,-20,69,-5
2017-18,2018-03-02,Florida Panthers,2,Atlantic,Eastern,66,2,122,0.5409836065573771,85,-19,69,-3
2017-18,2018-03-03,Florida Panthers,2,Atlantic,Eastern,68,2,124,0.5483870967741935,85,-17,69,-1
2017-18,2018-03-04,Florida Panthers,2,Atlantic,Eastern,70,2,126,0.5555555555555556,85,-15,70,0
2017-18,2018-03-07,Florida Panthers,1,Atlantic,Eastern,71,2,128,0.5546875,85,-14,73,-2
2017-18,2018-03-09,Florida Panthers,2,Atlantic,Eastern,73,2,130,0.5615384615384615,85,-12,75,-2
2017-18,2018-03-11,Florida Panthers,2,Atlantic,Eastern,75,2,132,0.5681818181818182,87,-12,77,-2
2017-18,2018-03-12,Florida Panthers,0,Atlantic,Eastern,75,2,134,0.5597014925373134,87,-12,78,-3
2017-18,2018-03-15,Florida Panthers,2,Atlantic,Eastern,77,2,136,0.5661764705882353,91,-14,80,-3
2017-18,2018-03-17,Florida Panthers,0,Atlantic,Eastern,77,2,138,0.5579710144927537,93,-16,82,-5
2017-18,2018-03-19,Florida Panthers,2,Atlantic,Eastern,79,2,140,0.5642857142857143,93,-14,82,-3
2017-18,2018-03-20,Florida Panthers,2,Atlantic,Eastern,81,2,142,0.5704225352112676,93,-12,82,-1
2017-18,2018-03-22,Florida Panthers,0,Atlantic,Eastern,81,2,144,0.5625,93,-12,82,-1
2017-18,2018-03-24,Florida Panthers,2,Atlantic,Eastern,83,2,146,0.5684931506849316,97,-14,86,-3
2017-18,2018-03-26,Florida Panthers,2,Atlantic,Eastern,85,2,148,0.5743243243243243,97,-12,86,-1
2017-18,2018-03-28,Florida Panthers,0,Atlantic,Eastern,85,2,150,0.5666666666666667,99,-14,88,-3
2017-18,2018-03-29,Florida Panthers,1,Atlantic,Eastern,86,2,152,0.5657894736842105,99,-13,89,-3
2017-18,2018-03-31,Florida Panthers,0,Atlantic,Eastern,86,2,154,0.5584415584415584,101,-15,91,-5
2017-18,2018-04-02,Florida Panthers,2,Atlantic,Eastern,88,2,156,0.5641025641025641,103,-15,93,-5
2017-18,2018-04-03,Florida Panthers,2,Atlantic,Eastern,90,2,158,0.569620253164557,103,-13,94,-4
2017-18,2018-04-05,Florida Panthers,2,Atlantic,Eastern,92,2,160,0.575,103,-11,96,-4
2017-18,2018-04-07,Florida Panthers,2,Atlantic,Eastern,94,2,162,0.5802469135802469,105,-11,97,-3
2017-18,2018-04-08,Florida Panthers,2,Atlantic,Eastern,96,2,164,0.5853658536585366,105,-9,97,-1
2017-18,2017-10-06,Los Angeles Kings,2,Pacific,Western,2,2,2,1.0,2,0,0,2
2017-18,2017-10-08,Los Angeles Kings,2,Pacific,Western,4,2,4,1.0,3,1,2,2
2017-18,2017-10-12,Los Angeles Kings,1,Pacific,Western,5,2,6,0.8333333333333334,5,0,3,2
2017-18,2017-10-15,Los Angeles Kings,2,Pacific,Western,7,2,8,0.875,7,0,5,2
2017-18,2017-10-16,Los Angeles Kings,2,Pacific,Western,9,2,10,0.9,8,1,5,4
2017-18,2017-10-19,Los Angeles Kings,2,Pacific,Western,11,2,12,0.9166666666666666,8,3,6,5
2017-18,2017-10-21,Los Angeles Kings,2,Pacific,Western,13,2,14,0.9285714285714286,8,5,8,5
2017-18,2017-10-23,Los Angeles Kings,0,Pacific,Western,13,2,16,0.8125,9,4,8,5
2017-18,2017-10-24,Los Angeles Kings,2,Pacific,Western,15,2,18,0.8333333333333334,9,6,9,6
2017-18,2017-10-26,Los Angeles Kings,2,Pacific,Western,17,2,20,0.85,11,6,10,7
2017-18,2017-10-28,Los Angeles Kings,2,Pacific,Western,19,2,22,0.8636363636363636,13,6,11,8
2017-18,2017-10-31,Los Angeles Kings,0,Pacific,Western,19,2,24,0.7916666666666666,14,5,12,7
2017-18,2017-11-03,Los Angeles Kings,2,Pacific,Western,21,2,26,0.8076923076923077,14,7,14,7
2017-18,2017-11-05,Los Angeles Kings,1,Pacific,Western,22,2,28,0.7857142857142857,16,6,16,6
2017-18,2017-11-08,Los Angeles Kings,2,Pacific,Western,24,2,30,0.8,18,6,16,8
2017-18,2017-11-10,Los Angeles Kings,0,Pacific,Western,24,2,32,0.75,18,6,17,7
2017-18,2017-11-13,Los Angeles Kings,0,Pacific,Western,24,2,34,0.7058823529411765,20,4,18,6
2017-18,2017-11-15,Los Angeles Kings,0,Pacific,Western,24,2,36,0.6666666666666666,20,4,20,4
2017-18,2017-11-17,Los Angeles Kings,0,Pacific,Western,24,2,38,0.631578947368421,20,4,20,4
2017-18,2017-11-18,Los Angeles Kings,2,Pacific,Western,26,2,40,0.65,22,4,20,6
2017-18,2017-11-20,Los Angeles Kings,0,Pacific,Western,26,2,42,0.6190476190476191,22,4,21,5
2017-18,2017-11-23,Los Angeles Kings,0,Pacific,Western,26,2,44,0.5909090909090909,25,1,23,3
2017-18,2017-11-25,Los Angeles Kings,1,Pacific,Western,27,2,46,0.5869565217391305,25,2,25,2
2017-18,2017-11-26,Los Angeles Kings,2,Pacific,Western,29,2,48,0.6041666666666666,27,2,26,3
2017-18,2017-11-29,Los Angeles Kings,2,Pacific,Western,31,2,50,0.62,28,3,27,4
2017-18,2017-12-01,Los Angeles Kings,2,Pacific,Western,33,2,52,0.6346153846153846,29,4,28,5
2017-18,2017-12-02,Los Angeles Kings,2,Pacific,Western,35,2,54,0.6481481481481481,30,5,29,6
2017-18,2017-12-04,Los Angeles Kings,2,Pacific,Western,37,2,56,0.6607142857142857,30,7,30,7
2017-18,2017-12-06,Los Angeles Kings,2,Pacific,Western,39,2,58,0.6724137931034483,32,7,30,9
2017-18,2017-12-08,Los Angeles Kings,2,Pacific,Western,41,2,60,0.6833333333333333,32,9,32,9
2017-18,2017-12-10,Los Angeles Kings,2,Pacific,Western,43,2,62,0.6935483870967742,34,9,33,10
2017-18,2017-12-13,Los Angeles Kings,0,Pacific,Western,43,2,64,0.671875,35,8,35,8
2017-18,2017-12-16,Los Angeles Kings,0,Pacific,Western,43,2,66,0.6515151515151515,38,5,37,6
2017-18,2017-12-17,Los Angeles Kings,1,Pacific,Western,44,2,68,0.6470588235294118,38,6,37,7
2017-18,2017-12-19,Los Angeles Kings,2,Pacific,Western,46,2,70,0.6571428571428571,38,8,38,8
2017-18,2017-12-22,Los Angeles Kings,2,Pacific,Western,48,2,72,0.6666666666666666,40,8,39,9
2017-18,2017-12-24,Los Angeles Kings,0,Pacific,Western,48,2,74,0.6486486486486487,42,6,40,8
2017-18,2017-12-29,Los Angeles Kings,1,Pacific,Western,49,2,76,0.6447368421052632,44,5,41,8
2017-18,2017-12-31,Los Angeles Kings,2,Pacific,Western,51,2,78,0.6538461538461539,44,7,44,7
2017-18,2018-01-03,Los Angeles Kings,2,Pacific,Western,53,2,80,0.6625,46,7,46,7
2017-18,2018-01-05,Los Angeles Kings,0,Pacific,Western,53,2,82,0.6463414634146342,47,6,47,6
2017-18,2018-01-07,Los Angeles Kings,0,Pacific,Western,53,2,84,0.6309523809523809,48,5,47,6
2017-18,2018-01-14,Los Angeles Kings,0,Pacific,Western,53,2,86,0.6162790697674418,53,0,51,2
2017-18,2018-01-15,Los Angeles Kings,0,Pacific,Western,53,2,88,0.6022727272727273,53,0,53,0
2017-18,2018-01-19,Los Angeles Kings,0,Pacific,Western,53,2,90,0.5888888888888889,54,-1,53,0
2017-18,2018-01-20,Los Angeles Kings,0,Pacific,Western,53,2,92,0.5760869565217391,54,-1,54,-1
2017-18,2018-01-22,Los Angeles Kings,2,Pacific,Western,55,2,94,0.5851063829787234,55,0,55,0
2017-18,2018-01-24,Los Angeles Kings,0,Pacific,Western,55,2,96,0.5729166666666666,56,-1,57,-2
2017-18,2018-01-25,Los Angeles Kings,2,Pacific,Western,57,2,98,0.5816326530612245,57,0,57,0
2017-18,2018-01-31,Los Angeles Kings,2,Pacific,Western,59,2,100,0.59,59,0,59,0
2017-18,2018-02-02,Los Angeles Kings,0,Pacific,Western,59,2,102,0.5784313725490197,60,-1,60,-1
2017-18,2018-02-04,Los Angeles Kings,2,Pacific,Western,61,2,104,0.5865384615384616,61,0,61,0
2017-18,2018-02-08,Los Angeles Kings,2,Pacific,Western,63,2,106,0.5943396226415094,63,0,63,0
2017-18,2018-02-10,Los Angeles Kings,2,Pacific,Western,65,2,108,0.6018518518518519,64,1,64,1
2017-18,2018-02-11,Los Angeles Kings,0,Pacific,Western,65,2,110,0.5909090909090909,65,0,65,0
2017-18,2018-02-14,Los Angeles Kings,0,Pacific,Western,65,2,112,0.5803571428571429,66,-1,66,-1
2017-18,2018-02-16,Los Angeles Kings,0,Pacific,Western,65,2,114,0.5701754385964912,68,-3,68,-3
2017-18,2018-02-17,Los Angeles Kings,2,Pacific,Western,67,2,116,0.5775862068965517,69,-2,69,-2
2017-18,2018-02-20,Los Angeles Kings,2,Pacific,Western,69,2,118,0.5847457627118644,71,-2,71,-2
2017-18,2018-02-21,Los Angeles Kings,2,Pacific,Western,71,2,120,0.5916666666666667,71,0,71,0
2017-18,2018-02-23,Los Angeles Kings,0,Pacific,Western,71,2,122,0.5819672131147541,73,-2,72,-1
2017-18,2018-02-25,Los Angeles Kings,0,Pacific,Western,71,2,124,0.5725806451612904,73,-2,73,-2
2017-18,2018-02-27,Los Angeles Kings,2,Pacific,Western,73,2,126,0.5793650793650794,74,-1,73,0
2017-18,2018-02-28,Los Angeles Kings,2,Pacific,Western,75,2,128,0.5859375,75,0,74,1
2017-18,2018-03-02,Los Angeles Kings,2,Pacific,Western,77,2,130,0.5923076923076923,77,0,74,3
2017-18,2018-03-03,Los Angeles Kings,0,Pacific,Western,77,2,132,0.5833333333333334,77,0,76,1
2017-18,2018-03-09,Los Angeles Kings,2,Pacific,Western,79,2,134,0.5895522388059702,80,-1,79,0
2017-18,2018-03-10,Los Angeles Kings,0,Pacific,Western,79,2,136,0.5808823529411765,80,-1,80,-1
2017-18,2018-03-13,Los Angeles Kings,2,Pacific,Western,81,2,138,0.5869565217391305,81,0,80,1
2017-18,2018-03-14,Los Angeles Kings,1,Pacific,Western,82,2,140,0.5857142857142857,82,0,82,0
2017-18,2018-03-16,Los Angeles Kings,2,Pacific,Western,84,2,142,0.5915492957746479,84,0,84,0
2017-18,2018-03-17,Los Angeles Kings,0,Pacific,Western,84,2,144,0.5833333333333334,84,0,84,0
2017-18,2018-03-20,Los Angeles Kings,2,Pacific,Western,86,2,146,0.589041095890411,86,0,86,0
2017-18,2018-03-21,Los Angeles Kings,1,Pacific,Western,87,2,148,0.5878378378378378,87,0,86,1
2017-18,2018-03-23,Los Angeles Kings,2,Pacific,Western,89,2,150,0.5933333333333334,89,0,88,1
2017-18,2018-03-25,Los Angeles Kings,0,Pacific,Western,89,2,152,0.5855263157894737,89,0,89,0
2017-18,2018-03-27,Los Angeles Kings,2,Pacific,Western,91,2,154,0.5909090909090909,91,0,90,1
2017-18,2018-03-30,Los Angeles Kings,2,Pacific,Western,93,2,156,0.5961538461538461,93,0,91,2
2017-18,2018-03-31,Los Angeles Kings,1,Pacific,Western,94,2,158,0.5949367088607594,94,0,92,2
2017-18,2018-04-03,Los Angeles Kings,2,Pacific,Western,96,2,160,0.6,96,0,93,3
2017-18,2018-04-06,Los Angeles Kings,2,Pacific,Western,98,2,162,0.6049382716049383,98,0,93,5
2017-18,2018-04-08,Los Angeles Kings,0,Pacific,Western,98,2,164,0.5975609756097561,100,-2,95,3
2017-18,2017-10-05,Minnesota Wild,0,Central,Western,0,2,2,0.0,0,0,0,0
2017-18,2017-10-07,Minnesota Wild,1,Central,Western,1,2,4,0.25,2,-1,1,0
2017-18,2017-10-13,Minnesota Wild,2,Central,Western,3,2,6,0.5,6,-3,4,-1
2017-18,2017-10-15,Minnesota Wild,1,Central,Western,4,2,8,0.5,8,-4,5,-1
2017-18,2017-10-21,Minnesota Wild,0,Central,Western,4,2,10,0.4,9,-5,8,-4
2017-18,2017-10-22,Minnesota Wild,2,Central,Western,6,2,12,0.5,10,-4,8,-2
2017-18,2017-10-25,Minnesota Wild,0,Central,Western,6,2,14,0.42857142857142855,10,-4,10,-4
2017-18,2017-10-27,Minnesota Wild,2,Central,Western,8,2,16,0.5,10,-2,10,-2
2017-18,2017-10-29,Minnesota Wild,2,Central,Western,10,2,18,0.5555555555555556,12,-2,12,-2
2017-18,2017-11-01,Minnesota Wild,0,Central,Western,10,2,20,0.5,14,-4,12,-2
2017-18,2017-11-03,Minnesota Wild,2,Central,Western,12,2,22,0.5454545454545454,14,-2,14,-2
2017-18,2017-11-05,Minnesota Wild,0,Central,Western,12,2,24,0.5,16,-4,16,-4
2017-18,2017-11-07,Minnesota Wild,0,Central,Western,12,2,26,0.46153846153846156,16,-4,16,-4
2017-18,2017-11-09,Minnesota Wild,0,Central,Western,12,2,28,0.42857142857142855,18,-6,16,-4
2017-18,2017-11-10,Minnesota Wild,2,Central,Western,14,2,30,0.4666666666666667,18,-4,17,-3
2017-18,2017-11-12,Minnesota Wild,2,Central,Western,16,2,32,0.5,20,-4,18,-2
2017-18,2017-11-15,Minnesota Wild,2,Central,Western,18,2,34,0.5294117647058824,22,-4,20,-2
2017-18,2017-11-17,Minnesota Wild,2,Central,Western,20,2,36,0.5555555555555556,22,-2,20,0
2017-18,2017-11-19,Minnesota Wild,0,Central,Western,20,2,38,0.5263157894736842,24,-4,21,-1
2017-18,2017-11-21,Minnesota Wild,1,Central,Western,21,2,40,0.525,26,-5,22,-1
2017-18,2017-11-23,Minnesota Wild,2,Central,Western,23,2,42,0.5476190476190477,28,-5,23,0
2017-18,2017-11-24,Minnesota Wild,2,Central,Western,25,2,44,0.5681818181818182,28,-3,25,0
2017-18,2017-11-26,Minnesota Wild,0,Central,Western,25,2,46,0.5434782608695652,31,-6,26,-1
2017-18,2017-11-28,Minnesota Wild,0,Central,Western,25,2,48,0.5208333333333334,31,-6,26,-1
2017-18,2017-12-01,Minnesota Wild,2,Central,Western,27,2,50,0.54,33,-6,28,-1
2017-18,2017-12-02,Minnesota Wild,2,Central,Western,29,2,52,0.5576923076923077,33,-4,29,0
2017-18,2017-12-06,Minnesota Wild,0,Central,Western,29,2,54,0.5370370370370371,38,-9,30,-1
2017-18,2017-12-09,Minnesota Wild,2,Central,Western,31,2,56,0.5535714285714286,38,-7,32,-1
2017-18,2017-12-11,Minnesota Wild,2,Central,Western,33,2,58,0.5689655172413793,39,-6,33,0
2017-18,2017-12-13,Minnesota Wild,2,Central,Western,35,2,60,0.5833333333333334,40,-5,35,0
2017-18,2017-12-15,Minnesota Wild,2,Central,Western,37,2,62,0.5967741935483871,41,-4,37,0
2017-18,2017-12-16,Minnesota Wild,0,Central,Western,37,2,64,0.578125,41,-4,37,0
2017-18,2017-12-18,Minnesota Wild,0,Central,Western,37,2,66,0.5606060606060606,43,-6,38,-1
2017-18,2017-12-20,Minnesota Wild,2,Central,Western,39,2,68,0.5735294117647058,45,-6,39,0
2017-18,2017-12-23,Minnesota Wild,0,Central,Western,39,2,70,0.5571428571428572,46,-7,39,0
2017-18,2017-12-24,Minnesota Wild,0,Central,Western,39,2,72,0.5416666666666666,46,-7,40,-1
2017-18,2017-12-28,Minnesota Wild,2,Central,Western,41,2,74,0.5540540540540541,48,-7,41,0
2017-18,2017-12-30,Minnesota Wild,2,Central,Western,43,2,76,0.5657894736842105,48,-5,43,0
2017-18,2017-12-31,Minnesota Wild,0,Central,Western,43,2,78,0.5512820512820513,50,-7,44,-1
2017-18,2018-01-03,Minnesota Wild,2,Central,Western,45,2,80,0.5625,51,-6,46,-1
2017-18,2018-01-05,Minnesota Wild,2,Central,Western,47,2,82,0.573170731707317,52,-5,47,0
2017-18,2018-01-07,Minnesota Wild,0,Central,Western,47,2,84,0.5595238095238095,54,-7,47,0
2017-18,2018-01-10,Minnesota Wild,1,Central,Western,48,2,86,0.5581395348837209,55,-7,48,0
2017-18,2018-01-11,Minnesota Wild,2,Central,Western,50,2,88,0.5681818181818182,55,-5,48,2
2017-18,2018-01-14,Minnesota Wild,2,Central,Western,52,2,90,0.5777777777777777,55,-3,51,1
2017-18,2018-01-15,Minnesota Wild,1,Central,Western,53,2,92,0.5760869565217391,55,-2,53,0
2017-18,2018-01-21,Minnesota Wild,2,Central,Western,55,2,94,0.5851063829787234,59,-4,55,0
2017-18,2018-01-23,Minnesota Wild,2,Central,Western,57,2,96,0.59375,59,-2,57,0
2017-18,2018-01-26,Minnesota Wild,0,Central,Western,57,2,98,0.5816326530612245,63,-6,57,0
2017-18,2018-01-31,Minnesota Wild,2,Central,Western,59,2,100,0.59,65,-6,59,0
2017-18,2018-02-03,Minnesota Wild,2,Central,Western,61,2,102,0.5980392156862745,65,-4,60,1
2017-18,2018-02-04,Minnesota Wild,0,Central,Western,61,2,104,0.5865384615384616,67,-6,61,0
2017-18,2018-02-07,Minnesota Wild,2,Central,Western,63,2,106,0.5943396226415094,67,-4,62,1
2017-18,2018-02-09,Minnesota Wild,1,Central,Western,64,2,108,0.5925925925925926,69,-5,64,0
2017-18,2018-02-11,Minnesota Wild,2,Central,Western,66,2,110,0.6,71,-5,65,1
2017-18,2018-02-14,Minnesota Wild,2,Central,Western,68,2,112,0.6071428571428571,72,-4,66,2
2017-18,2018-02-16,Minnesota Wild,0,Central,Western,68,2,114,0.5964912280701754,72,-4,68,0
2017-18,2018-02-17,Minnesota Wild,1,Central,Western,69,2,116,0.5948275862068966,72,-3,69,0
2017-18,2018-02-19,Minnesota Wild,2,Central,Western,71,2,118,0.6016949152542372,72,-1,69,2
2017-18,2018-02-23,Minnesota Wild,2,Central,Western,73,2,120,0.6083333333333333,74,-1,72,1
2017-18,2018-02-24,Minnesota Wild,2,Central,Western,75,2,122,0.6147540983606558,75,0,73,2
2017-18,2018-02-26,Minnesota Wild,2,Central,Western,77,2,124,0.6209677419354839,77,0,73,4
2017-18,2018-02-28,Minnesota Wild,2,Central,Western,79,2,126,0.626984126984127,79,0,74,5
2017-18,2018-03-02,Minnesota Wild,0,Central,Western,79,2,128,0.6171875,79,0,74,5
2017-18,2018-03-03,Minnesota Wild,0,Central,Western,79,2,130,0.6076923076923076,79,0,76,3
2017-18,2018-03-05,Minnesota Wild,2,Central,Western,81,2,132,0.6136363636363636,81,0,77,4
2017-18,2018-03-07,Minnesota Wild,2,Central,Western,83,2,134,0.6194029850746269,83,0,77,6
2017-18,2018-03-10,Minnesota Wild,2,Central,Western,85,2,136,0.625,85,0,80,5
2017-18,2018-03-11,Minnesota Wild,0,Central,Western,85,2,138,0.6159420289855072,85,0,80,5
2017-18,2018-03-14,Minnesota Wild,0,Central,Western,85,2,140,0.6071428571428571,85,0,82,3
2017-18,2018-03-17,Minnesota Wild,2,Central,Western,87,2,142,0.6126760563380281,87,0,84,3
2017-18,2018-03-18,Minnesota Wild,2,Central,Western,89,2,144,0.6180555555555556,89,0,84,5
2017-18,2018-03-20,Minnesota Wild,1,Central,Western,90,2,146,0.6164383561643836,90,0,86,4
2017-18,2018-03-25,Minnesota Wild,1,Central,Western,91,2,148,0.6148648648648649,93,-2,89,2
2017-18,2018-03-25,Minnesota Wild,2,Central,Western,93,2,150,0.62,93,0,89,4
2017-18,2018-03-28,Minnesota Wild,1,Central,Western,94,2,152,0.618421052631579,94,0,91,3
2017-18,2018-03-30,Minnesota Wild,2,Central,Western,96,2,154,0.6233766233766234,96,0,91,5
2017-18,2018-04-01,Minnesota Wild,0,Central,Western,96,2,156,0.6153846153846154,96,0,92,4
2017-18,2018-04-03,Minnesota Wild,2,Central,Western,98,2,158,0.620253164556962,98,0,93,5
2017-18,2018-04-05,Minnesota Wild,0,Central,Western,98,2,160,0.6125,98,0,93,5
2017-18,2018-04-06,Minnesota Wild,1,Central,Western,99,2,162,0.6111111111111112,99,0,93,6
2017-18,2018-04-08,Minnesota Wild,2,Central,Western,101,2,164,0.6158536585365854,101,0,95,6
2017-18,2017-10-05,Montréal Canadiens,2,Atlantic,Eastern,2,2,2,1.0,2,0,1,1
2017-18,2017-10-07,Montréal Canadiens,0,Atlantic,Eastern,2,2,4,0.5,2,0,2,0
2017-18,2017-10-08,Montréal Canadiens,0,Atlantic,Eastern,2,2,6,0.3333333333333333,2,0,2,0
2017-18,2017-10-10,Montréal Canadiens,0,Atlantic,Eastern,2,2,8,0.25,4,-2,3,-1
2017-18,2017-10-14,Montréal Canadiens,1,Atlantic,Eastern,3,2,10,0.3,8,-5,6,-3
2017-18,2017-10-18,Montréal Canadiens,0,Atlantic,Eastern,3,2,12,0.25,8,-5,8,-5
2017-18,2017-10-19,Montréal Canadiens,0,Atlantic,Eastern,3,2,14,0.21428571428571427,9,-6,8,-5
2017-18,2017-10-21,Montréal Canadiens,0,Atlantic,Eastern,3,2,16,0.1875,11,-8,9,-6
2017-18,2017-10-24,Montréal Canadiens,2,Atlantic,Eastern,5,2,18,0.2777777777777778,12,-7,10,-5
2017-18,2017-10-26,Montréal Canadiens,0,Atlantic,Eastern,5,2,20,0.25,14,-9,10,-5
2017-18,2017-10-28,Montréal Canadiens,2,Atlantic,Eastern,7,2,22,0.3181818181818182,14,-7,11,-4
2017-18,2017-10-30,Montréal Canadiens,2,Atlantic,Eastern,9,2,24,0.375,14,-5,13,-4
2017-18,2017-11-03,Montréal Canadiens,0,Atlantic,Eastern,9,2,26,0.34615384615384615,16,-7,15,-6
2017-18,2017-11-04,Montréal Canadiens,2,Atlantic,Eastern,11,2,28,0.39285714285714285,16,-5,15,-4
2017-18,2017-11-06,Montréal Canadiens,2,Atlantic,Eastern,13,2,30,0.43333333333333335,16,-3,16,-3
2017-18,2017-11-08,Montréal Canadiens,2,Atlantic,Eastern,15,2,32,0.46875,17,-2,17,-2
2017-18,2017-11-10,Montréal Canadiens,0,Atlantic,Eastern,15,2,34,0.4411764705882353,17,-2,18,-3
2017-18,2017-11-12,Montréal Canadiens,2,Atlantic,Eastern,17,2,36,0.4722222222222222,21,-4,20,-3
2017-18,2017-11-15,Montréal Canadiens,1,Atlantic,Eastern,18,2,38,0.47368421052631576,21,-3,20,-2
2017-18,2017-11-17,Montréal Canadiens,0,Atlantic,Eastern,18,2,40,0.45,21,-3,21,-3
2017-18,2017-11-19,Montréal Canadiens,0,Atlantic,Eastern,18,2,42,0.42857142857142855,23,-5,23,-5
2017-18,2017-11-22,Montréal Canadiens,0,Atlantic,Eastern,18,2,44,0.4090909090909091,23,-5,23,-5
2017-18,2017-11-23,Montréal Canadiens,1,Atlantic,Eastern,19,2,46,0.41304347826086957,23,-4,24,-5
2017-18,2017-11-26,Montréal Canadiens,2,Atlantic,Eastern,21,2,48,0.4375,25,-4,27,-6
2017-18,2017-11-28,Montréal Canadiens,2,Atlantic,Eastern,23,2,50,0.46,25,-2,28,-5
2017-18,2017-11-30,Montréal Canadiens,2,Atlantic,Eastern,25,2,52,0.4807692307692308,26,-1,28,-3
2017-18,2017-12-01,Montréal Canadiens,2,Atlantic,Eastern,27,2,54,0.5,27,0,28,-1
2017-18,2017-12-03,Montréal Canadiens,2,Atlantic,Eastern,29,2,56,0.5178571428571429,29,0,30,-1
2017-18,2017-12-06,Montréal Canadiens,0,Atlantic,Eastern,29,2,58,0.5,29,0,32,-3
2017-18,2017-12-08,Montréal Canadiens,1,Atlantic,Eastern,30,2,60,0.5,30,0,32,-2
2017-18,2017-12-10,Montréal Canadiens,0,Atlantic,Eastern,30,2,62,0.4838709677419355,32,-2,34,-4
2017-18,2017-12-15,Montréal Canadiens,2,Atlantic,Eastern,32,2,64,0.5,34,-2,35,-3
2017-18,2017-12-17,Montréal Canadiens,0,Atlantic,Eastern,32,2,66,0.48484848484848486,35,-3,37,-5
2017-18,2017-12-20,Montréal Canadiens,2,Atlantic,Eastern,34,2,68,0.5,39,-5,39,-5
2017-18,2017-12-23,Montréal Canadiens,2,Atlantic,Eastern,36,2,70,0.5142857142857142,43,-7,42,-6
2017-18,2017-12-24,Montréal Canadiens,0,Atlantic,Eastern,36,2,72,0.5,43,-7,42,-6
2017-18,2017-12-28,Montréal Canadiens,0,Atlantic,Eastern,36,2,74,0.4864864864864865,45,-9,44,-8
2017-18,2017-12-29,Montréal Canadiens,0,Atlantic,Eastern,36,2,76,0.47368421052631576,46,-10,44,-8
2017-18,2017-12-31,Montréal Canadiens,0,Atlantic,Eastern,36,2,78,0.46153846153846156,48,-12,44,-8
2017-18,2018-01-03,Montréal Canadiens,0,Atlantic,Eastern,36,2,80,0.45,48,-12,44,-8
2017-18,2018-01-05,Montréal Canadiens,2,Atlantic,Eastern,38,2,82,0.4634146341463415,50,-12,46,-8
2017-18,2018-01-08,Montréal Canadiens,2,Atlantic,Eastern,40,2,84,0.47619047619047616,52,-12,47,-7
2017-18,2018-01-14,Montréal Canadiens,1,Atlantic,Eastern,41,2,86,0.47674418604651164,53,-12,49,-8
2017-18,2018-01-16,Montréal Canadiens,1,Atlantic,Eastern,42,2,88,0.4772727272727273,53,-11,50,-8
2017-18,2018-01-18,Montréal Canadiens,0,Atlantic,Eastern,42,2,90,0.4666666666666667,54,-12,51,-9
2017-18,2018-01-20,Montréal Canadiens,2,Atlantic,Eastern,44,2,92,0.4782608695652174,55,-11,53,-9
2017-18,2018-01-21,Montréal Canadiens,0,Atlantic,Eastern,44,2,94,0.46808510638297873,57,-13,53,-9
2017-18,2018-01-24,Montréal Canadiens,2,Atlantic,Eastern,46,2,96,0.4791666666666667,57,-11,55,-9
2017-18,2018-01-26,Montréal Canadiens,0,Atlantic,Eastern,46,2,98,0.46938775510204084,61,-15,56,-10
2017-18,2018-01-31,Montréal Canadiens,0,Atlantic,Eastern,46,2,100,0.46,61,-15,56,-10
2017-18,2018-02-02,Montréal Canadiens,0,Atlantic,Eastern,46,2,102,0.45098039215686275,65,-19,56,-10
2017-18,2018-02-03,Montréal Canadiens,2,Atlantic,Eastern,48,2,104,0.46153846153846156,65,-17,57,-9
2017-18,2018-02-04,Montréal Canadiens,2,Atlantic,Eastern,50,2,106,0.4716981132075472,65,-15,57,-7
2017-18,2018-02-09,Montréal Canadiens,0,Atlantic,Eastern,50,2,108,0.46296296296296297,69,-19,58,-8
2017-18,2018-02-11,Montréal Canadiens,1,Atlantic,Eastern,51,2,110,0.4636363636363636,71,-20,61,-10
2017-18,2018-02-15,Montréal Canadiens,0,Atlantic,Eastern,51,2,112,0.45535714285714285,75,-24,63,-12
2017-18,2018-02-16,Montréal Canadiens,0,Atlantic,Eastern,51,2,114,0.4473684210526316,75,-24,63,-12
2017-18,2018-02-18,Montréal Canadiens,0,Atlantic,Eastern,51,2,116,0.4396551724137931,75,-24,64,-13
2017-18,2018-02-21,Montréal Canadiens,1,Atlantic,Eastern,52,2,118,0.4406779661016949,79,-27,65,-13
2017-18,2018-02-23,Montréal Canadiens,2,Atlantic,Eastern,54,2,120,0.45,81,-27,65,-11
2017-18,2018-02-25,Montréal Canadiens,1,Atlantic,Eastern,55,2,122,0.45081967213114754,82,-27,67,-12
2017-18,2018-02-27,Montréal Canadiens,1,Atlantic,Eastern,56,2,124,0.45161290322580644,82,-26,69,-13
2017-18,2018-03-01,Montréal Canadiens,2,Atlantic,Eastern,58,2,126,0.4603174603174603,84,-26,69,-11
2017-18,2018-03-03,Montréal Canadiens,2,Atlantic,Eastern,60,2,128,0.46875,85,-25,69,-9
2017-18,2018-03-03,Montréal Canadiens,1,Atlantic,Eastern,61,2,130,0.46923076923076923,85,-24,69,-8
2017-18,2018-03-07,Montréal Canadiens,0,Atlantic,Eastern,61,2,132,0.4621212121212121,85,-24,73,-12
2017-18,2018-03-09,Montréal Canadiens,0,Atlantic,Eastern,61,2,134,0.4552238805970149,85,-24,75,-14
2017-18,2018-03-10,Montréal Canadiens,1,Atlantic,Eastern,62,2,136,0.45588235294117646,85,-23,76,-14
2017-18,2018-03-12,Montréal Canadiens,0,Atlantic,Eastern,62,2,138,0.4492753623188406,87,-25,78,-16
2017-18,2018-03-13,Montréal Canadiens,2,Atlantic,Eastern,64,2,140,0.45714285714285713,87,-23,78,-14
2017-18,2018-03-15,Montréal Canadiens,0,Atlantic,Eastern,64,2,142,0.4507042253521127,91,-27,80,-16
2017-18,2018-03-17,Montréal Canadiens,0,Atlantic,Eastern,64,2,144,0.4444444444444444,93,-29,82,-18
2017-18,2018-03-19,Montréal Canadiens,0,Atlantic,Eastern,64,2,146,0.4383561643835616,93,-29,82,-18
2017-18,2018-03-21,Montréal Canadiens,0,Atlantic,Eastern,64,2,148,0.43243243243243246,93,-29,82,-18
2017-18,2018-03-23,Montréal Canadiens,2,Atlantic,Eastern,66,2,150,0.44,95,-29,84,-18
2017-18,2018-03-24,Montréal Canadiens,0,Atlantic,Eastern,66,2,152,0.4342105263157895,97,-31,86,-20
2017-18,2018-03-26,Montréal Canadiens,2,Atlantic,Eastern,68,2,154,0.44155844155844154,97,-29,86,-18
2017-18,2018-03-31,Montréal Canadiens,0,Atlantic,Eastern,68,2,156,0.4358974358974359,101,-33,91,-23
2017-18,2018-04-01,Montréal Canadiens,0,Atlantic,Eastern,68,2,158,0.43037974683544306,101,-33,93,-25
2017-18,2018-04-03,Montréal Canadiens,1,Atlantic,Eastern,69,2,160,0.43125,103,-34,94,-25
2017-18,2018-04-05,Montréal Canadiens,2,Atlantic,Eastern,71,2,162,0.4382716049382716,103,-32,96,-25
2017-18,2018-04-07,Montréal Canadiens,0,Atlantic,Eastern,71,2,164,0.4329268292682927,105,-34,97,-26
2017-18,2017-10-05,Nashville Predators,0,Central,Western,0,2,2,0.0,0,0,0,0
2017-18,2017-10-07,Nashville Predators,0,Central,Western,0,2,4,0.0,2,-2,1,-1
2017-18,2017-10-11,Nashville Predators,2,Central,Western,2,2,6,0.3333333333333333,4,-2,3,-1
2017-18,2017-10-13,Nashville Predators,2,Central,Western,4,2,8,0.5,6,-2,4,0
2017-18,2017-10-15,Nashville Predators,1,Central,Western,5,2,10,0.5,8,-3,5,0
2017-18,2017-10-18,Nashville Predators,2,Central,Western,7,2,12,0.5833333333333334,8,-1,6,1
2017-18,2017-10-19,Nashville Predators,2,Central,Western,9,2,14,0.6428571428571429,9,0,6,3
2017-18,2017-10-21,Nashville Predators,0,Central,Western,9,2,16,0.5625,9,0,8,1
2017-18,2017-10-25,Nashville Predators,1,Central,Western,10,2,18,0.5555555555555556,10,0,10,0
2017-18,2017-10-28,Nashville Predators,2,Central,Western,12,2,20,0.6,12,0,11,1
2017-18,2017-10-29,Nashville Predators,0,Central,Western,12,2,22,0.5454545454545454,12,0,12,0
2017-18,2017-11-02,Nashville Predators,0,Central,Western,12,2,24,0.5,14,-2,14,-2
2017-18,2017-11-04,Nashville Predators,2,Central,Western,14,2,26,0.5384615384615384,16,-2,14,0
2017-18,2017-11-05,Nashville Predators,2,Central,Western,16,2,28,0.5714285714285714,16,0,16,0
2017-18,2017-11-08,Nashville Predators,2,Central,Western,18,2,30,0.6,18,0,16,2
2017-18,2017-11-12,Nashville Predators,2,Central,Western,20,2,32,0.625,20,0,18,2
2017-18,2017-11-15,Nashville Predators,2,Central,Western,22,2,34,0.6470588235294118,22,0,20,2
2017-18,2017-11-17,Nashville Predators,0,Central,Western,22,2,36,0.6111111111111112,22,0,20,2
2017-18,2017-11-19,Nashville Predators,2,Central,Western,24,2,38,0.631578947368421,24,0,21,3
2017-18,2017-11-21,Nashville Predators,2,Central,Western,26,2,40,0.65,26,0,22,4
2017-18,2017-11-23,Nashville Predators,2,Central,Western,28,2,42,0.6666666666666666,28,0,23,5
2017-18,2017-11-25,Nashville Predators,2,Central,Western,30,2,44,0.6818181818181818,30,0,25,5
2017-18,2017-11-26,Nashville Predators,1,Central,Western,31,2,46,0.6739130434782609,31,0,26,5
2017-18,2017-11-29,Nashville Predators,2,Central,Western,33,2,48,0.6875,33,0,27,6
2017-18,2017-12-01,Nashville Predators,0,Central,Western,33,2,50,0.66,33,0,28,5
2017-18,2017-12-03,Nashville Predators,2,Central,Western,35,2,52,0.6730769230769231,35,0,30,5
2017-18,2017-12-05,Nashville Predators,2,Central,Western,37,2,54,0.6851851851851852,35,2,30,7
2017-18,2017-12-06,Nashville Predators,2,Central,Western,39,2,56,0.6964285714285714,38,1,30,9
2017-18,2017-12-09,Nashville Predators,1,Central,Western,40,2,58,0.6896551724137931,38,2,32,8
2017-18,2017-12-14,Nashville Predators,2,Central,Western,42,2,60,0.7,41,1,35,7
2017-18,2017-12-15,Nashville Predators,2,Central,Western,44,2,62,0.7096774193548387,41,3,37,7
2017-18,2017-12-17,Nashville Predators,2,Central,Western,46,2,64,0.71875,43,3,37,9
2017-18,2017-12-20,Nashville Predators,0,Central,Western,46,2,66,0.696969696969697,45,1,39,7
2017-18,2017-12-22,Nashville Predators,0,Central,Western,46,2,68,0.6764705882352942,46,0,39,7
2017-18,2017-12-24,Nashville Predators,1,Central,Western,47,2,70,0.6714285714285714,46,1,40,7
2017-18,2017-12-28,Nashville Predators,2,Central,Western,49,2,72,0.6805555555555556,48,1,41,8
2017-18,2017-12-30,Nashville Predators,0,Central,Western,49,2,74,0.6621621621621622,48,1,43,6
2017-18,2017-12-31,Nashville Predators,2,Central,Western,51,2,76,0.6710526315789473,50,1,44,7
2017-18,2018-01-03,Nashville Predators,0,Central,Western,51,2,78,0.6538461538461539,51,0,46,5
2017-18,2018-01-05,Nashville Predators,1,Central,Western,52,2,80,0.65,52,0,47,5
2017-18,2018-01-07,Nashville Predators,2,Central,Western,54,2,82,0.6585365853658537,54,0,47,7
2017-18,2018-01-10,Nashville Predators,2,Central,Western,56,2,84,0.6666666666666666,55,1,48,8
2017-18,2018-01-17,Nashville Predators,2,Central,Western,58,2,86,0.6744186046511628,57,1,53,5
2017-18,2018-01-19,Nashville Predators,2,Central,Western,60,2,88,0.6818181818181818,59,1,53,7
2017-18,2018-01-21,Nashville Predators,2,Central,Western,62,2,90,0.6888888888888889,59,3,55,7
2017-18,2018-01-24,Nashville Predators,1,Central,Western,63,2,92,0.6847826086956522,61,2,57,6
2017-18,2018-01-26,Nashville Predators,2,Central,Western,65,2,94,0.6914893617021277,63,2,57,8
2017-18,2018-01-31,Nashville Predators,0,Central,Western,65,2,96,0.6770833333333334,65,0,59,6
2017-18,2018-02-02,Nashville Predators,2,Central,Western,67,2,98,0.6836734693877551,65,2,60,7
2017-18,2018-02-04,Nashville Predators,2,Central,Western,69,2,100,0.69,67,2,61,8
2017-18,2018-02-06,Nashville Predators,2,Central,Western,71,2,102,0.696078431372549,67,4,61,10
2017-18,2018-02-08,Nashville Predators,1,Central,Western,72,2,104,0.6923076923076923,67,5,63,9
2017-18,2018-02-09,Nashville Predators,1,Central,Western,73,2,106,0.6886792452830188,69,4,64,9
2017-18,2018-02-11,Nashville Predators,2,Central,Western,75,2,108,0.6944444444444444,71,4,65,10
2017-18,2018-02-14,Nashville Predators,2,Central,Western,77,2,110,0.7,72,5,66,11
2017-18,2018-02-16,Nashville Predators,0,Central,Western,77,2,112,0.6875,72,5,68,9
2017-18,2018-02-18,Nashville Predators,0,Central,Western,77,2,114,0.6754385964912281,72,5,69,8
2017-18,2018-02-20,Nashville Predators,2,Central,Western,79,2,116,0.6810344827586207,72,7,71,8
2017-18,2018-02-21,Nashville Predators,2,Central,Western,81,2,118,0.6864406779661016,72,9,71,10
2017-18,2018-02-23,Nashville Predators,2,Central,Western,83,2,120,0.6916666666666667,74,9,72,11
2017-18,2018-02-25,Nashville Predators,2,Central,Western,85,2,122,0.6967213114754098,75,10,73,12
2017-18,2018-02-28,Nashville Predators,2,Central,Western,87,2,124,0.7016129032258065,79,8,74,13
2017-18,2018-03-02,Nashville Predators,2,Central,Western,89,2,126,0.7063492063492064,79,10,74,15
2017-18,2018-03-03,Nashville Predators,2,Central,Western,91,2,128,0.7109375,79,12,76,15
2017-18,2018-03-04,Nashville Predators,2,Central,Western,93,2,130,0.7153846153846154,79,14,77,16
2017-18,2018-03-07,Nashville Predators,2,Central,Western,95,2,132,0.7196969696969697,83,12,77,18
2017-18,2018-03-09,Nashville Predators,2,Central,Western,97,2,134,0.7238805970149254,83,14,79,18
2017-18,2018-03-11,Nashville Predators,1,Central,Western,98,2,136,0.7205882352941176,85,13,80,18
2017-18,2018-03-14,Nashville Predators,2,Central,Western,100,2,138,0.7246376811594203,85,15,82,18
2017-18,2018-03-16,Nashville Predators,2,Central,Western,102,2,140,0.7285714285714285,85,17,84,18
2017-18,2018-03-17,Nashville Predators,2,Central,Western,104,2,142,0.7323943661971831,87,17,84,20
2017-18,2018-03-19,Nashville Predators,2,Central,Western,106,2,144,0.7361111111111112,89,17,84,22
2017-18,2018-03-23,Nashville Predators,0,Central,Western,106,2,146,0.726027397260274,90,16,88,18
2017-18,2018-03-25,Nashville Predators,1,Central,Western,107,2,148,0.722972972972973,93,14,89,18
2017-18,2018-03-25,Nashville Predators,0,Central,Western,107,2,150,0.7133333333333334,93,14,89,18
2017-18,2018-03-28,Nashville Predators,2,Central,Western,109,2,152,0.7171052631578947,94,15,91,18
2017-18,2018-03-30,Nashville Predators,2,Central,Western,111,2,154,0.7207792207792207,96,15,91,20
2017-18,2018-04-01,Nashville Predators,0,Central,Western,111,2,156,0.7115384615384616,96,15,92,19
2017-18,2018-04-01,Nashville Predators,2,Central,Western,113,2,158,0.7151898734177216,96,17,92,21
2017-18,2018-04-03,Nashville Predators,0,Central,Western,113,2,160,0.70625,98,15,93,20
2017-18,2018-04-05,Nashville Predators,2,Central,Western,115,2,162,0.7098765432098766,98,17,93,22
2017-18,2018-04-08,Nashville Predators,2,Central,Western,117,2,164,0.7134146341463414,101,16,95,22
2017-18,2017-10-07,New Jersey Devils,2,Metropolitan,Eastern,2,2,2,1.0,2,0,2,0
2017-18,2017-10-09,New Jersey Devils,2,Metropolitan,Eastern,4,2,4,1.0,4,0,3,1
2017-18,2017-10-11,New Jersey Devils,2,Metropolitan,Eastern,6,2,6,1.0,5,1,4,2
2017-18,2017-10-13,New Jersey Devils,0,Metropolitan,Eastern,6,2,8,0.75,6,0,4,2
2017-18,2017-10-14,New Jersey Devils,2,Metropolitan,Eastern,8,2,10,0.8,7,1,6,2
2017-18,2017-10-17,New Jersey Devils,2,Metropolitan,Eastern,10,2,12,0.8333333333333334,8,2,8,2
2017-18,2017-10-19,New Jersey Devils,2,Metropolitan,Eastern,12,2,14,0.8571428571428571,9,3,8,4
2017-18,2017-10-20,New Jersey Devils,0,Metropolitan,Eastern,12,2,16,0.75,10,2,9,3
2017-18,2017-10-27,New Jersey Devils,2,Metropolitan,Eastern,14,2,18,0.7777777777777778,14,0,10,4
2017-18,2017-10-28,New Jersey Devils,2,Metropolitan,Eastern,16,2,20,0.8,14,2,11,5
2017-18,2017-11-02,New Jersey Devils,2,Metropolitan,Eastern,18,2,22,0.8181818181818182,17,1,13,5
2017-18,2017-11-04,New Jersey Devils,0,Metropolitan,Eastern,18,2,24,0.75,18,0,15,3
2017-18,2017-11-06,New Jersey Devils,1,Metropolitan,Eastern,19,2,26,0.7307692307692307,18,1,16,3
2017-18,2017-11-08,New Jersey Devils,0,Metropolitan,Eastern,19,2,28,0.6785714285714286,19,0,17,2
2017-18,2017-11-10,New Jersey Devils,1,Metropolitan,Eastern,20,2,30,0.6666666666666666,19,1,18,2
2017-18,2017-11-12,New Jersey Devils,2,Metropolitan,Eastern,22,2,32,0.6875,21,1,20,2
2017-18,2017-11-13,New Jersey Devils,2,Metropolitan,Eastern,24,2,34,0.7058823529411765,21,3,20,4
2017-18,2017-11-17,New Jersey Devils,1,Metropolitan,Eastern,25,2,36,0.6944444444444444,23,2,21,4
2017-18,2017-11-18,New Jersey Devils,0,Metropolitan,Eastern,25,2,38,0.6578947368421053,25,0,22,3
2017-18,2017-11-21,New Jersey Devils,2,Metropolitan,Eastern,27,2,40,0.675,25,2,23,4
2017-18,2017-11-23,New Jersey Devils,1,Metropolitan,Eastern,28,2,42,0.6666666666666666,26,2,24,4
2017-18,2017-11-25,New Jersey Devils,2,Metropolitan,Eastern,30,2,44,0.6818181818181818,28,2,25,5
2017-18,2017-11-26,New Jersey Devils,2,Metropolitan,Eastern,32,2,46,0.6956521739130435,30,2,27,5
2017-18,2017-11-28,New Jersey Devils,0,Metropolitan,Eastern,32,2,48,0.6666666666666666,30,2,28,4
2017-18,2017-12-02,New Jersey Devils,2,Metropolitan,Eastern,34,2,50,0.68,32,2,29,5
2017-18,2017-12-03,New Jersey Devils,0,Metropolitan,Eastern,34,2,52,0.6538461538461539,33,1,30,4
2017-18,2017-12-06,New Jersey Devils,2,Metropolitan,Eastern,36,2,54,0.6666666666666666,34,2,32,4
2017-18,2017-12-09,New Jersey Devils,0,Metropolitan,Eastern,36,2,56,0.6428571428571429,36,0,32,4
2017-18,2017-12-10,New Jersey Devils,0,Metropolitan,Eastern,36,2,58,0.6206896551724138,36,0,34,2
2017-18,2017-12-13,New Jersey Devils,2,Metropolitan,Eastern,38,2,60,0.6333333333333333,38,0,35,3
2017-18,2017-12-15,New Jersey Devils,1,Metropolitan,Eastern,39,2,62,0.6290322580645161,39,0,35,4
2017-18,2017-12-16,New Jersey Devils,2,Metropolitan,Eastern,41,2,64,0.640625,41,0,35,6
2017-18,2017-12-19,New Jersey Devils,2,Metropolitan,Eastern,43,2,66,0.6515151515151515,41,2,37,6
2017-18,2017-12-22,New Jersey Devils,2,Metropolitan,Eastern,45,2,68,0.6617647058823529,44,1,40,5
2017-18,2017-12-24,New Jersey Devils,2,Metropolitan,Eastern,47,2,70,0.6714285714285714,46,1,42,5
2017-18,2017-12-28,New Jersey Devils,2,Metropolitan,Eastern,49,2,72,0.6805555555555556,47,2,44,5
2017-18,2017-12-30,New Jersey Devils,1,Metropolitan,Eastern,50,2,74,0.6756756756756757,47,3,44,6
2017-18,2017-12-31,New Jersey Devils,0,Metropolitan,Eastern,50,2,76,0.6578947368421053,47,3,44,6
2017-18,2018-01-03,New Jersey Devils,1,Metropolitan,Eastern,51,2,78,0.6538461538461539,49,2,44,7
2017-18,2018-01-05,New Jersey Devils,0,Metropolitan,Eastern,51,2,80,0.6375,49,2,46,5
2017-18,2018-01-07,New Jersey Devils,1,Metropolitan,Eastern,52,2,82,0.6341463414634146,51,1,46,6
2017-18,2018-01-14,New Jersey Devils,0,Metropolitan,Eastern,52,2,84,0.6190476190476191,52,0,49,3
2017-18,2018-01-17,New Jersey Devils,2,Metropolitan,Eastern,54,2,86,0.627906976744186,53,1,51,3
2017-18,2018-01-19,New Jersey Devils,2,Metropolitan,Eastern,56,2,88,0.6363636363636364,55,1,53,3
2017-18,2018-01-20,New Jersey Devils,0,Metropolitan,Eastern,56,2,90,0.6222222222222222,55,1,53,3
2017-18,2018-01-23,New Jersey Devils,0,Metropolitan,Eastern,56,2,92,0.6086956521739131,55,1,53,3
2017-18,2018-01-24,New Jersey Devils,0,Metropolitan,Eastern,56,2,94,0.5957446808510638,56,0,55,1
2017-18,2018-01-26,New Jersey Devils,0,Metropolitan,Eastern,56,2,96,0.5833333333333334,57,-1,56,0
2017-18,2018-01-31,New Jersey Devils,2,Metropolitan,Eastern,58,2,98,0.5918367346938775,58,0,56,2
2017-18,2018-02-02,New Jersey Devils,2,Metropolitan,Eastern,60,2,100,0.6,59,1,56,4
2017-18,2018-02-04,New Jersey Devils,2,Metropolitan,Eastern,62,2,102,0.6078431372549019,61,1,57,5
2017-18,2018-02-07,New Jersey Devils,0,Metropolitan,Eastern,62,2,104,0.5961538461538461,62,0,58,4
2017-18,2018-02-09,New Jersey Devils,0,Metropolitan,Eastern,62,2,106,0.5849056603773585,62,0,58,4
2017-18,2018-02-11,New Jersey Devils,0,Metropolitan,Eastern,62,2,108,0.5740740740740741,63,-1,61,1
2017-18,2018-02-12,New Jersey Devils,0,Metropolitan,Eastern,62,2,110,0.5636363636363636,65,-3,61,1
2017-18,2018-02-14,New Jersey Devils,2,Metropolitan,Eastern,64,2,112,0.5714285714285714,66,-2,63,1
2017-18,2018-02-16,New Jersey Devils,2,Metropolitan,Eastern,66,2,114,0.5789473684210527,66,0,63,3
2017-18,2018-02-18,New Jersey Devils,2,Metropolitan,Eastern,68,2,116,0.5862068965517241,70,-2,64,4
2017-18,2018-02-18,New Jersey Devils,2,Metropolitan,Eastern,70,2,118,0.5932203389830508,70,0,64,6
2017-18,2018-02-21,New Jersey Devils,0,Metropolitan,Eastern,70,2,120,0.5833333333333334,72,-2,65,5
2017-18,2018-02-23,New Jersey Devils,0,Metropolitan,Eastern,70,2,122,0.5737704918032787,72,-2,65,5
2017-18,2018-02-25,New Jersey Devils,2,Metropolitan,Eastern,72,2,124,0.5806451612903226,76,-4,67,5
2017-18,2018-02-28,New Jersey Devils,2,Metropolitan,Eastern,74,2,126,0.5873015873015873,76,-2,69,5
2017-18,2018-03-02,New Jersey Devils,0,Metropolitan,Eastern,74,2,128,0.578125,76,-2,69,5
2017-18,2018-03-03,New Jersey Devils,0,Metropolitan,Eastern,74,2,130,0.5692307692307692,78,-4,69,5
2017-18,2018-03-04,New Jersey Devils,0,Metropolitan,Eastern,74,2,132,0.5606060606060606,78,-4,70,4
2017-18,2018-03-07,New Jersey Devils,2,Metropolitan,Eastern,76,2,134,0.5671641791044776,79,-3,73,3
2017-18,2018-03-09,New Jersey Devils,0,Metropolitan,Eastern,76,2,136,0.5588235294117647,79,-3,75,1
2017-18,2018-03-11,New Jersey Devils,2,Metropolitan,Eastern,78,2,138,0.5652173913043478,81,-3,77,1
2017-18,2018-03-15,New Jersey Devils,2,Metropolitan,Eastern,80,2,140,0.5714285714285714,81,-1,80,0
2017-18,2018-03-17,New Jersey Devils,2,Metropolitan,Eastern,82,2,142,0.5774647887323944,83,-1,82,0
2017-18,2018-03-19,New Jersey Devils,0,Metropolitan,Eastern,82,2,144,0.5694444444444444,85,-3,82,0
2017-18,2018-03-21,New Jersey Devils,0,Metropolitan,Eastern,82,2,146,0.5616438356164384,87,-5,82,0
2017-18,2018-03-23,New Jersey Devils,2,Metropolitan,Eastern,84,2,148,0.5675675675675675,89,-5,84,0
2017-18,2018-03-24,New Jersey Devils,2,Metropolitan,Eastern,86,2,150,0.5733333333333334,89,-3,86,0
2017-18,2018-03-27,New Jersey Devils,2,Metropolitan,Eastern,88,2,152,0.5789473684210527,89,-1,88,0
2017-18,2018-03-29,New Jersey Devils,1,Metropolitan,Eastern,89,2,154,0.577922077922078,92,-3,89,0
2017-18,2018-03-31,New Jersey Devils,2,Metropolitan,Eastern,91,2,156,0.5833333333333334,94,-3,91,0
2017-18,2018-04-01,New Jersey Devils,2,Metropolitan,Eastern,93,2,158,0.5886075949367089,94,-1,93,0
2017-18,2018-04-03,New Jersey Devils,2,Metropolitan,Eastern,95,2,160,0.59375,96,-1,94,1
2017-18,2018-04-05,New Jersey Devils,2,Metropolitan,Eastern,97,2,162,0.5987654320987654,97,0,96,1
2017-18,2018-04-07,New Jersey Devils,0,Metropolitan,Eastern,97,2,164,0.5914634146341463,98,-1,97,0
2017-18,2017-10-06,New York Islanders,0,Metropolitan,Eastern,0,2,2,0.0,2,-2,2,-2
2017-18,2017-10-07,New York Islanders,2,Metropolitan,Eastern,2,2,4,0.5,2,0,2,0
2017-18,2017-10-09,New York Islanders,1,Metropolitan,Eastern,3,2,6,0.5,4,-1,3,0
2017-18,2017-10-12,New York Islanders,0,Metropolitan,Eastern,3,2,8,0.375,5,-2,4,-1
2017-18,2017-10-15,New York Islanders,2,Metropolitan,Eastern,5,2,10,0.5,7,-2,7,-2
2017-18,2017-10-16,New York Islanders,0,Metropolitan,Eastern,5,2,12,0.4166666666666667,7,-2,7,-2
2017-18,2017-10-19,New York Islanders,2,Metropolitan,Eastern,7,2,14,0.5,9,-2,8,-1
2017-18,2017-10-21,New York Islanders,2,Metropolitan,Eastern,9,2,16,0.5625,10,-1,9,0
2017-18,2017-10-24,New York Islanders,2,Metropolitan,Eastern,11,2,18,0.6111111111111112,11,0,10,1
2017-18,2017-10-27,New York Islanders,0,Metropolitan,Eastern,11,2,20,0.55,14,-3,10,1
2017-18,2017-10-29,New York Islanders,2,Metropolitan,Eastern,13,2,22,0.5909090909090909,14,-1,12,1
2017-18,2017-10-30,New York Islanders,2,Metropolitan,Eastern,15,2,24,0.625,15,0,13,2
2017-18,2017-11-02,New York Islanders,0,Metropolitan,Eastern,15,2,26,0.5769230769230769,17,-2,13,2
2017-18,2017-11-05,New York Islanders,2,Metropolitan,Eastern,17,2,28,0.6071428571428571,18,-1,16,1
2017-18,2017-11-08,New York Islanders,1,Metropolitan,Eastern,18,2,30,0.6,19,-1,17,1
2017-18,2017-11-11,New York Islanders,0,Metropolitan,Eastern,18,2,32,0.5625,20,-2,19,-1
2017-18,2017-11-12,New York Islanders,2,Metropolitan,Eastern,20,2,34,0.5882352941176471,21,-1,20,0
2017-18,2017-11-17,New York Islanders,2,Metropolitan,Eastern,22,2,36,0.6111111111111112,23,-1,21,1
2017-18,2017-11-19,New York Islanders,0,Metropolitan,Eastern,22,2,38,0.5789473684210527,25,-3,23,-1
2017-18,2017-11-19,New York Islanders,2,Metropolitan,Eastern,24,2,40,0.6,25,-1,23,1
2017-18,2017-11-23,New York Islanders,2,Metropolitan,Eastern,26,2,42,0.6190476190476191,26,0,24,2
2017-18,2017-11-24,New York Islanders,2,Metropolitan,Eastern,28,2,44,0.6363636363636364,28,0,24,4
2017-18,2017-11-26,New York Islanders,2,Metropolitan,Eastern,30,2,46,0.6521739130434783,30,0,27,3
2017-18,2017-11-29,New York Islanders,2,Metropolitan,Eastern,32,2,48,0.6666666666666666,32,0,28,4
2017-18,2017-12-02,New York Islanders,0,Metropolitan,Eastern,32,2,50,0.64,32,0,29,3
2017-18,2017-12-05,New York Islanders,2,Metropolitan,Eastern,34,2,52,0.6538461538461539,34,0,30,4
2017-18,2017-12-06,New York Islanders,0,Metropolitan,Eastern,34,2,54,0.6296296296296297,34,0,32,2
2017-18,2017-12-08,New York Islanders,1,Metropolitan,Eastern,35,2,56,0.625,35,0,32,3
2017-18,2017-12-10,New York Islanders,0,Metropolitan,Eastern,35,2,58,0.603448275862069,36,-1,34,1
2017-18,2017-12-12,New York Islanders,2,Metropolitan,Eastern,37,2,60,0.6166666666666667,37,0,35,2
2017-18,2017-12-14,New York Islanders,0,Metropolitan,Eastern,37,2,62,0.5967741935483871,38,-1,35,2
2017-18,2017-12-15,New York Islanders,0,Metropolitan,Eastern,37,2,64,0.578125,39,-2,35,2
2017-18,2017-12-17,New York Islanders,2,Metropolitan,Eastern,39,2,66,0.5909090909090909,41,-2,37,2
2017-18,2017-12-20,New York Islanders,0,Metropolitan,Eastern,39,2,68,0.5735294117647058,41,-2,39,0
2017-18,2017-12-22,New York Islanders,1,Metropolitan,Eastern,40,2,70,0.5714285714285714,44,-4,40,0
2017-18,2017-12-23,New York Islanders,2,Metropolitan,Eastern,42,2,72,0.5833333333333334,44,-2,42,0
2017-18,2017-12-28,New York Islanders,2,Metropolitan,Eastern,44,2,74,0.5945945945945946,47,-3,44,0
2017-18,2017-12-30,New York Islanders,0,Metropolitan,Eastern,44,2,76,0.5789473684210527,47,-3,44,0
2017-18,2018-01-01,New York Islanders,0,Metropolitan,Eastern,44,2,78,0.5641025641025641,47,-3,44,0
2017-18,2018-01-03,New York Islanders,0,Metropolitan,Eastern,44,2,80,0.55,49,-5,44,0
2017-18,2018-01-05,New York Islanders,0,Metropolitan,Eastern,44,2,82,0.5365853658536586,49,-5,46,-2
2017-18,2018-01-06,New York Islanders,0,Metropolitan,Eastern,44,2,84,0.5238095238095238,49,-5,46,-2
2017-18,2018-01-07,New York Islanders,2,Metropolitan,Eastern,46,2,86,0.5348837209302325,51,-5,46,0
2017-18,2018-01-13,New York Islanders,2,Metropolitan,Eastern,48,2,88,0.5454545454545454,52,-4,49,-1
2017-18,2018-01-16,New York Islanders,2,Metropolitan,Eastern,50,2,90,0.5555555555555556,52,-2,50,0
2017-18,2018-01-17,New York Islanders,0,Metropolitan,Eastern,50,2,92,0.5434782608695652,53,-3,51,-1
2017-18,2018-01-19,New York Islanders,0,Metropolitan,Eastern,50,2,94,0.5319148936170213,55,-5,53,-3
2017-18,2018-01-21,New York Islanders,2,Metropolitan,Eastern,52,2,96,0.5416666666666666,55,-3,53,-1
2017-18,2018-01-23,New York Islanders,1,Metropolitan,Eastern,53,2,98,0.5408163265306123,55,-2,53,0
2017-18,2018-01-26,New York Islanders,2,Metropolitan,Eastern,55,2,100,0.55,57,-2,56,-1
2017-18,2018-01-31,New York Islanders,0,Metropolitan,Eastern,55,2,102,0.5392156862745098,58,-3,56,-1
2017-18,2018-02-01,New York Islanders,0,Metropolitan,Eastern,55,2,104,0.5288461538461539,58,-3,56,-1
2017-18,2018-02-04,New York Islanders,2,Metropolitan,Eastern,57,2,106,0.5377358490566038,61,-4,57,0
2017-18,2018-02-06,New York Islanders,1,Metropolitan,Eastern,58,2,108,0.5370370370370371,61,-3,58,0
2017-18,2018-02-09,New York Islanders,0,Metropolitan,Eastern,58,2,110,0.5272727272727272,62,-4,58,0
2017-18,2018-02-10,New York Islanders,2,Metropolitan,Eastern,60,2,112,0.5357142857142857,62,-2,60,0
2017-18,2018-02-12,New York Islanders,0,Metropolitan,Eastern,60,2,114,0.5263157894736842,65,-5,61,-1
2017-18,2018-02-14,New York Islanders,0,Metropolitan,Eastern,60,2,116,0.5172413793103449,66,-6,63,-3
2017-18,2018-02-16,New York Islanders,2,Metropolitan,Eastern,62,2,118,0.5254237288135594,66,-4,63,-1
2017-18,2018-02-17,New York Islanders,2,Metropolitan,Eastern,64,2,120,0.5333333333333333,68,-4,64,0
2017-18,2018-02-19,New York Islanders,0,Metropolitan,Eastern,64,2,122,0.5245901639344263,70,-6,64,0
2017-18,2018-02-23,New York Islanders,1,Metropolitan,Eastern,65,2,124,0.5241935483870968,72,-7,65,0
2017-18,2018-02-25,New York Islanders,0,Metropolitan,Eastern,65,2,126,0.5158730158730159,76,-11,67,-2
2017-18,2018-03-01,New York Islanders,0,Metropolitan,Eastern,65,2,128,0.5078125,76,-11,69,-4
2017-18,2018-03-03,New York Islanders,0,Metropolitan,Eastern,65,2,130,0.5,78,-13,69,-4
2017-18,2018-03-03,New York Islanders,1,Metropolitan,Eastern,66,2,132,0.5,78,-12,69,-3
2017-18,2018-03-06,New York Islanders,1,Metropolitan,Eastern,67,2,134,0.5,79,-12,71,-4
2017-18,2018-03-09,New York Islanders,1,Metropolitan,Eastern,68,2,136,0.5,79,-11,75,-7
2017-18,2018-03-11,New York Islanders,2,Metropolitan,Eastern,70,2,138,0.5072463768115942,81,-11,77,-7
2017-18,2018-03-15,New York Islanders,0,Metropolitan,Eastern,70,2,140,0.5,81,-11,80,-10
2017-18,2018-03-16,New York Islanders,0,Metropolitan,Eastern,70,2,142,0.49295774647887325,81,-11,80,-10
2017-18,2018-03-18,New York Islanders,0,Metropolitan,Eastern,70,2,144,0.4861111111111111,85,-15,82,-12
2017-18,2018-03-20,New York Islanders,2,Metropolitan,Eastern,72,2,146,0.4931506849315068,87,-15,82,-10
2017-18,2018-03-22,New York Islanders,0,Metropolitan,Eastern,72,2,148,0.4864864864864865,89,-17,82,-10
2017-18,2018-03-24,New York Islanders,0,Metropolitan,Eastern,72,2,150,0.48,89,-17,86,-14
2017-18,2018-03-26,New York Islanders,0,Metropolitan,Eastern,72,2,152,0.47368421052631576,89,-17,86,-14
2017-18,2018-03-27,New York Islanders,2,Metropolitan,Eastern,74,2,154,0.4805194805194805,89,-15,88,-14
2017-18,2018-03-30,New York Islanders,0,Metropolitan,Eastern,74,2,156,0.47435897435897434,93,-19,89,-15
2017-18,2018-03-31,New York Islanders,0,Metropolitan,Eastern,74,2,158,0.46835443037974683,94,-20,91,-17
2017-18,2018-04-03,New York Islanders,2,Metropolitan,Eastern,76,2,160,0.475,96,-20,94,-18
2017-18,2018-04-05,New York Islanders,2,Metropolitan,Eastern,78,2,162,0.48148148148148145,97,-19,96,-18
2017-18,2018-04-07,New York Islanders,2,Metropolitan,Eastern,80,2,164,0.4878048780487805,98,-18,97,-17
2017-18,2017-10-05,New York Rangers,0,Metropolitan,Eastern,0,2,2,0.0,1,-1,1,-1
2017-18,2017-10-07,New York Rangers,0,Metropolitan,Eastern,0,2,4,0.0,2,-2,2,-2
2017-18,2017-10-08,New York Rangers,2,Metropolitan,Eastern,2,2,6,0.3333333333333333,3,-1,2,0
2017-18,2017-10-10,New York Rangers,0,Metropolitan,Eastern,2,2,8,0.25,4,-2,3,-1
2017-18,2017-10-13,New York Rangers,0,Metropolitan,Eastern,2,2,10,0.2,6,-4,4,-2
2017-18,2017-10-14,New York Rangers,0,Metropolitan,Eastern,2,2,12,0.16666666666666666,7,-5,6,-4
2017-18,2017-10-17,New York Rangers,1,Metropolitan,Eastern,3,2,14,0.21428571428571427,8,-5,8,-5
2017-18,2017-10-19,New York Rangers,1,Metropolitan,Eastern,4,2,16,0.25,9,-5,8,-4
2017-18,2017-10-21,New York Rangers,2,Metropolitan,Eastern,6,2,18,0.3333333333333333,10,-4,9,-3
2017-18,2017-10-23,New York Rangers,0,Metropolitan,Eastern,6,2,20,0.3,10,-4,9,-3
2017-18,2017-10-26,New York Rangers,2,Metropolitan,Eastern,8,2,22,0.36363636363636365,12,-4,10,-2
2017-18,2017-10-28,New York Rangers,0,Metropolitan,Eastern,8,2,24,0.3333333333333333,14,-6,11,-3
2017-18,2017-10-31,New York Rangers,2,Metropolitan,Eastern,10,2,26,0.38461538461538464,15,-5,13,-3
2017-18,2017-11-02,New York Rangers,2,Metropolitan,Eastern,12,2,28,0.42857142857142855,17,-5,13,-1
2017-18,2017-11-04,New York Rangers,2,Metropolitan,Eastern,14,2,30,0.4666666666666667,18,-4,15,-1
2017-18,2017-11-07,New York Rangers,2,Metropolitan,Eastern,16,2,32,0.5,18,-2,17,-1
2017-18,2017-11-09,New York Rangers,2,Metropolitan,Eastern,18,2,34,0.5294117647058824,19,-1,17,1
2017-18,2017-11-11,New York Rangers,2,Metropolitan,Eastern,20,2,36,0.5555555555555556,20,0,19,1
2017-18,2017-11-16,New York Rangers,0,Metropolitan,Eastern,20,2,38,0.5263157894736842,23,-3,20,0
2017-18,2017-11-18,New York Rangers,0,Metropolitan,Eastern,20,2,40,0.5,25,-5,22,-2
2017-18,2017-11-20,New York Rangers,2,Metropolitan,Eastern,22,2,42,0.5238095238095238,25,-3,23,-1
2017-18,2017-11-23,New York Rangers,2,Metropolitan,Eastern,24,2,44,0.5454545454545454,26,-2,24,0
2017-18,2017-11-25,New York Rangers,2,Metropolitan,Eastern,26,2,46,0.5652173913043478,28,-2,25,1
2017-18,2017-11-26,New York Rangers,2,Metropolitan,Eastern,28,2,48,0.5833333333333334,30,-2,27,1
2017-18,2017-11-29,New York Rangers,0,Metropolitan,Eastern,28,2,50,0.56,32,-4,28,0
2017-18,2017-12-02,New York Rangers,2,Metropolitan,Eastern,30,2,52,0.5769230769230769,32,-2,29,1
2017-18,2017-12-06,New York Rangers,2,Metropolitan,Eastern,32,2,54,0.5925925925925926,34,-2,32,0
2017-18,2017-12-09,New York Rangers,0,Metropolitan,Eastern,32,2,56,0.5714285714285714,36,-4,32,0
2017-18,2017-12-10,New York Rangers,2,Metropolitan,Eastern,34,2,58,0.5862068965517241,36,-2,34,0
2017-18,2017-12-12,New York Rangers,1,Metropolitan,Eastern,35,2,60,0.5833333333333334,37,-2,35,0
2017-18,2017-12-14,New York Rangers,0,Metropolitan,Eastern,35,2,62,0.5645161290322581,38,-3,35,0
2017-18,2017-12-16,New York Rangers,2,Metropolitan,Eastern,37,2,64,0.578125,41,-4,35,2
2017-18,2017-12-16,New York Rangers,2,Metropolitan,Eastern,39,2,66,0.5909090909090909,41,-2,35,4
2017-18,2017-12-20,New York Rangers,2,Metropolitan,Eastern,41,2,68,0.6029411764705882,41,0,39,2
2017-18,2017-12-22,New York Rangers,1,Metropolitan,Eastern,42,2,70,0.6,44,-2,40,2
2017-18,2017-12-24,New York Rangers,0,Metropolitan,Eastern,42,2,72,0.5833333333333334,46,-4,42,0
2017-18,2017-12-28,New York Rangers,2,Metropolitan,Eastern,44,2,74,0.5945945945945946,47,-3,44,0
2017-18,2017-12-30,New York Rangers,1,Metropolitan,Eastern,45,2,76,0.5921052631578947,47,-2,44,1
2017-18,2018-01-01,New York Rangers,2,Metropolitan,Eastern,47,2,78,0.6025641025641025,47,0,44,3
2017-18,2018-01-04,New York Rangers,0,Metropolitan,Eastern,47,2,80,0.5875,49,-2,44,3
2017-18,2018-01-07,New York Rangers,2,Metropolitan,Eastern,49,2,82,0.5975609756097561,51,-2,46,3
2017-18,2018-01-08,New York Rangers,0,Metropolitan,Eastern,49,2,84,0.5833333333333334,51,-2,47,2
2017-18,2018-01-13,New York Rangers,0,Metropolitan,Eastern,49,2,86,0.5697674418604651,52,-3,49,0
2017-18,2018-01-15,New York Rangers,0,Metropolitan,Eastern,49,2,88,0.5568181818181818,52,-3,49,0
2017-18,2018-01-17,New York Rangers,2,Metropolitan,Eastern,51,2,90,0.5666666666666667,53,-2,51,0
2017-18,2018-01-19,New York Rangers,2,Metropolitan,Eastern,53,2,92,0.5760869565217391,55,-2,53,0
2017-18,2018-01-20,New York Rangers,0,Metropolitan,Eastern,53,2,94,0.5638297872340425,55,-2,53,0
2017-18,2018-01-22,New York Rangers,0,Metropolitan,Eastern,53,2,96,0.5520833333333334,55,-2,53,0
2017-18,2018-01-24,New York Rangers,0,Metropolitan,Eastern,53,2,98,0.5408163265306123,56,-3,55,-2
2017-18,2018-01-26,New York Rangers,2,Metropolitan,Eastern,55,2,100,0.55,57,-2,56,-1
2017-18,2018-02-02,New York Rangers,0,Metropolitan,Eastern,55,2,102,0.5392156862745098,59,-4,56,-1
2017-18,2018-02-04,New York Rangers,0,Metropolitan,Eastern,55,2,104,0.5288461538461539,61,-6,57,-2
2017-18,2018-02-06,New York Rangers,0,Metropolitan,Eastern,55,2,106,0.5188679245283019,61,-6,58,-3
2017-18,2018-02-08,New York Rangers,0,Metropolitan,Eastern,55,2,108,0.5092592592592593,62,-7,58,-3
2017-18,2018-02-10,New York Rangers,2,Metropolitan,Eastern,57,2,110,0.5181818181818182,62,-5,60,-3
2017-18,2018-02-11,New York Rangers,2,Metropolitan,Eastern,59,2,112,0.5267857142857143,63,-4,61,-2
2017-18,2018-02-14,New York Rangers,0,Metropolitan,Eastern,59,2,114,0.5175438596491229,66,-7,63,-4
2017-18,2018-02-16,New York Rangers,0,Metropolitan,Eastern,59,2,116,0.5086206896551724,66,-7,63,-4
2017-18,2018-02-17,New York Rangers,0,Metropolitan,Eastern,59,2,118,0.5,68,-9,64,-5
2017-18,2018-02-18,New York Rangers,0,Metropolitan,Eastern,59,2,120,0.49166666666666664,70,-11,64,-5
2017-18,2018-02-23,New York Rangers,0,Metropolitan,Eastern,59,2,122,0.48360655737704916,72,-13,65,-6
2017-18,2018-02-24,New York Rangers,0,Metropolitan,Eastern,59,2,124,0.47580645161290325,75,-16,65,-6
2017-18,2018-02-26,New York Rangers,1,Metropolitan,Eastern,60,2,126,0.47619047619047616,76,-16,67,-7
2017-18,2018-03-01,New York Rangers,2,Metropolitan,Eastern,62,2,128,0.484375,76,-14,69,-7
2017-18,2018-03-03,New York Rangers,2,Metropolitan,Eastern,64,2,130,0.49230769230769234,78,-14,69,-5
2017-18,2018-03-04,New York Rangers,2,Metropolitan,Eastern,66,2,132,0.5,78,-12,70,-4
2017-18,2018-03-07,New York Rangers,0,Metropolitan,Eastern,66,2,134,0.4925373134328358,79,-13,73,-7
2017-18,2018-03-09,New York Rangers,0,Metropolitan,Eastern,66,2,136,0.4852941176470588,79,-13,75,-9
2017-18,2018-03-11,New York Rangers,1,Metropolitan,Eastern,67,2,138,0.4855072463768116,81,-14,77,-10
2017-18,2018-03-12,New York Rangers,2,Metropolitan,Eastern,69,2,140,0.4928571428571429,81,-12,78,-9
2017-18,2018-03-15,New York Rangers,2,Metropolitan,Eastern,71,2,142,0.5,81,-10,80,-9
2017-18,2018-03-18,New York Rangers,1,Metropolitan,Eastern,72,2,144,0.5,85,-13,82,-10
2017-18,2018-03-20,New York Rangers,0,Metropolitan,Eastern,72,2,146,0.4931506849315068,87,-15,82,-10
2017-18,2018-03-22,New York Rangers,0,Metropolitan,Eastern,72,2,148,0.4864864864864865,89,-17,82,-10
2017-18,2018-03-24,New York Rangers,2,Metropolitan,Eastern,74,2,150,0.49333333333333335,89,-15,86,-12
2017-18,2018-03-26,New York Rangers,0,Metropolitan,Eastern,74,2,152,0.4868421052631579,89,-15,86,-12
2017-18,2018-03-29,New York Rangers,1,Metropolitan,Eastern,75,2,154,0.487012987012987,92,-17,89,-14
2017-18,2018-03-30,New York Rangers,0,Metropolitan,Eastern,75,2,156,0.4807692307692308,93,-18,89,-14
2017-18,2018-03-31,New York Rangers,2,Metropolitan,Eastern,77,2,158,0.4873417721518987,94,-17,91,-14
2017-18,2018-04-03,New York Rangers,0,Metropolitan,Eastern,77,2,160,0.48125,96,-19,94,-17
2017-18,2018-04-05,New York Rangers,0,Metropolitan,Eastern,77,2,162,0.47530864197530864,97,-20,96,-19
2017-18,2018-04-07,New York Rangers,0,Metropolitan,Eastern,77,2,164,0.4695121951219512,98,-21,97,-20
2017-18,2017-10-05,Ottawa Senators,1,Atlantic,Eastern,1,2,2,0.5,2,-1,1,0
2017-18,2017-10-07,Ottawa Senators,1,Atlantic,Eastern,2,2,4,0.5,2,0,2,0
2017-18,2017-10-11,Ottawa Senators,2,Atlantic,Eastern,4,2,6,0.6666666666666666,4,0,4,0
2017-18,2017-10-14,Ottawa Senators,2,Atlantic,Eastern,6,2,8,0.75,8,-2,6,0
2017-18,2017-10-15,Ottawa Senators,2,Atlantic,Eastern,8,2,10,0.8,8,0,7,1
2017-18,2017-10-17,Ottawa Senators,0,Atlantic,Eastern,8,2,12,0.6666666666666666,8,0,8,0
2017-18,2017-10-19,Ottawa Senators,1,Atlantic,Eastern,9,2,14,0.6428571428571429,9,0,8,1
2017-18,2017-10-21,Ottawa Senators,2,Atlantic,Eastern,11,2,16,0.6875,11,0,9,2
2017-18,2017-10-24,Ottawa Senators,1,Atlantic,Eastern,12,2,18,0.6666666666666666,12,0,10,2
2017-18,2017-10-26,Ottawa Senators,2,Atlantic,Eastern,14,2,20,0.7,14,0,10,4
2017-18,2017-10-27,Ottawa Senators,1,Atlantic,Eastern,15,2,22,0.6818181818181818,14,1,10,5
2017-18,2017-10-30,Ottawa Senators,0,Atlantic,Eastern,15,2,24,0.625,14,1,13,2
2017-18,2017-11-02,Ottawa Senators,2,Atlantic,Eastern,17,2,26,0.6538461538461539,16,1,13,4
2017-18,2017-11-04,Ottawa Senators,0,Atlantic,Eastern,17,2,28,0.6071428571428571,16,1,15,2
2017-18,2017-11-11,Ottawa Senators,2,Atlantic,Eastern,19,2,30,0.6333333333333333,19,0,19,0
2017-18,2017-11-12,Ottawa Senators,2,Atlantic,Eastern,21,2,32,0.65625,21,0,20,1
2017-18,2017-11-17,Ottawa Senators,0,Atlantic,Eastern,21,2,34,0.6176470588235294,21,0,21,0
2017-18,2017-11-18,Ottawa Senators,1,Atlantic,Eastern,22,2,36,0.6111111111111112,22,0,22,0
2017-18,2017-11-20,Ottawa Senators,0,Atlantic,Eastern,22,2,38,0.5789473684210527,23,-1,23,-1
2017-18,2017-11-23,Ottawa Senators,0,Atlantic,Eastern,22,2,40,0.55,23,-1,24,-2
2017-18,2017-11-25,Ottawa Senators,0,Atlantic,Eastern,22,2,42,0.5238095238095238,24,-2,25,-3
2017-18,2017-11-26,Ottawa Senators,0,Atlantic,Eastern,22,2,44,0.5,25,-3,27,-5
2017-18,2017-11-30,Ottawa Senators,0,Atlantic,Eastern,22,2,46,0.4782608695652174,26,-4,28,-6
2017-18,2017-12-02,Ottawa Senators,2,Atlantic,Eastern,24,2,48,0.5,28,-4,29,-5
2017-18,2017-12-04,Ottawa Senators,0,Atlantic,Eastern,24,2,50,0.48,29,-5,30,-6
2017-18,2017-12-07,Ottawa Senators,0,Atlantic,Eastern,24,2,52,0.46153846153846156,29,-5,32,-8
2017-18,2017-12-08,Ottawa Senators,1,Atlantic,Eastern,25,2,54,0.46296296296296297,30,-5,32,-7
2017-18,2017-12-10,Ottawa Senators,0,Atlantic,Eastern,25,2,56,0.44642857142857145,32,-7,34,-9
2017-18,2017-12-13,Ottawa Senators,0,Atlantic,Eastern,25,2,58,0.43103448275862066,32,-7,35,-10
2017-18,2017-12-14,Ottawa Senators,2,Atlantic,Eastern,27,2,60,0.45,34,-7,35,-8
2017-18,2017-12-17,Ottawa Senators,2,Atlantic,Eastern,29,2,62,0.46774193548387094,35,-6,37,-8
2017-18,2017-12-20,Ottawa Senators,0,Atlantic,Eastern,29,2,64,0.453125,39,-10,39,-10
2017-18,2017-12-22,Ottawa Senators,1,Atlantic,Eastern,30,2,66,0.45454545454545453,41,-11,40,-10
2017-18,2017-12-24,Ottawa Senators,0,Atlantic,Eastern,30,2,68,0.4411764705882353,43,-13,42,-12
2017-18,2017-12-28,Ottawa Senators,0,Atlantic,Eastern,30,2,70,0.42857142857142855,45,-15,44,-14
2017-18,2017-12-30,Ottawa Senators,2,Atlantic,Eastern,32,2,72,0.4444444444444444,46,-14,44,-12
2017-18,2017-12-31,Ottawa Senators,0,Atlantic,Eastern,32,2,74,0.43243243243243246,48,-16,44,-12
2017-18,2018-01-04,Ottawa Senators,1,Atlantic,Eastern,33,2,76,0.4342105263157895,48,-15,44,-11
2017-18,2018-01-06,Ottawa Senators,2,Atlantic,Eastern,35,2,78,0.44871794871794873,50,-15,46,-11
2017-18,2018-01-07,Ottawa Senators,2,Atlantic,Eastern,37,2,80,0.4625,52,-15,46,-9
2017-18,2018-01-10,Ottawa Senators,0,Atlantic,Eastern,37,2,82,0.45121951219512196,53,-16,47,-10
2017-18,2018-01-11,Ottawa Senators,2,Atlantic,Eastern,39,2,84,0.4642857142857143,53,-14,47,-8
2017-18,2018-01-19,Ottawa Senators,0,Atlantic,Eastern,39,2,86,0.45348837209302323,55,-16,53,-14
2017-18,2018-01-21,Ottawa Senators,0,Atlantic,Eastern,39,2,88,0.4431818181818182,57,-18,53,-14
2017-18,2018-01-23,Ottawa Senators,0,Atlantic,Eastern,39,2,90,0.43333333333333335,57,-18,53,-14
2017-18,2018-01-24,Ottawa Senators,0,Atlantic,Eastern,39,2,92,0.42391304347826086,57,-18,55,-16
2017-18,2018-01-26,Ottawa Senators,0,Atlantic,Eastern,39,2,94,0.4148936170212766,61,-22,56,-17
2017-18,2018-01-31,Ottawa Senators,0,Atlantic,Eastern,39,2,96,0.40625,61,-22,56,-17
2017-18,2018-02-02,Ottawa Senators,2,Atlantic,Eastern,41,2,98,0.41836734693877553,65,-24,56,-15
2017-18,2018-02-03,Ottawa Senators,2,Atlantic,Eastern,43,2,100,0.43,65,-22,57,-14
2017-18,2018-02-04,Ottawa Senators,0,Atlantic,Eastern,43,2,102,0.4215686274509804,65,-22,57,-14
2017-18,2018-02-07,Ottawa Senators,2,Atlantic,Eastern,45,2,104,0.4326923076923077,67,-22,58,-13
2017-18,2018-02-09,Ottawa Senators,2,Atlantic,Eastern,47,2,106,0.44339622641509435,69,-22,58,-11
2017-18,2018-02-11,Ottawa Senators,0,Atlantic,Eastern,47,2,108,0.4351851851851852,71,-24,61,-14
2017-18,2018-02-14,Ottawa Senators,0,Atlantic,Eastern,47,2,110,0.42727272727272725,73,-26,63,-16
2017-18,2018-02-16,Ottawa Senators,2,Atlantic,Eastern,49,2,112,0.4375,75,-26,63,-14
2017-18,2018-02-17,Ottawa Senators,2,Atlantic,Eastern,51,2,114,0.4473684210526316,75,-24,64,-13
2017-18,2018-02-20,Ottawa Senators,0,Atlantic,Eastern,51,2,116,0.4396551724137931,77,-26,64,-13
2017-18,2018-02-22,Ottawa Senators,1,Atlantic,Eastern,52,2,118,0.4406779661016949,79,-27,65,-13
2017-18,2018-02-23,Ottawa Senators,0,Atlantic,Eastern,52,2,120,0.43333333333333335,81,-29,65,-13
2017-18,2018-02-24,Ottawa Senators,0,Atlantic,Eastern,52,2,122,0.4262295081967213,81,-29,65,-13
2017-18,2018-02-28,Ottawa Senators,0,Atlantic,Eastern,52,2,124,0.41935483870967744,84,-32,69,-17
2017-18,2018-03-03,Ottawa Senators,2,Atlantic,Eastern,54,2,126,0.42857142857142855,85,-31,69,-15
2017-18,2018-03-04,Ottawa Senators,0,Atlantic,Eastern,54,2,128,0.421875,85,-31,70,-16
2017-18,2018-03-06,Ottawa Senators,2,Atlantic,Eastern,56,2,130,0.4307692307692308,85,-29,71,-15
2017-18,2018-03-09,Ottawa Senators,1,Atlantic,Eastern,57,2,132,0.4318181818181818,85,-28,75,-18
2017-18,2018-03-10,Ottawa Senators,0,Atlantic,Eastern,57,2,134,0.4253731343283582,85,-28,76,-19
2017-18,2018-03-12,Ottawa Senators,2,Atlantic,Eastern,59,2,136,0.4338235294117647,87,-28,78,-19
2017-18,2018-03-13,Ottawa Senators,2,Atlantic,Eastern,61,2,138,0.4420289855072464,87,-26,78,-17
2017-18,2018-03-16,Ottawa Senators,2,Atlantic,Eastern,63,2,140,0.45,91,-28,80,-17
2017-18,2018-03-17,Ottawa Senators,0,Atlantic,Eastern,63,2,142,0.44366197183098594,93,-30,82,-19
2017-18,2018-03-20,Ottawa Senators,0,Atlantic,Eastern,63,2,144,0.4375,93,-30,82,-19
2017-18,2018-03-22,Ottawa Senators,0,Atlantic,Eastern,63,2,146,0.4315068493150685,93,-30,82,-19
2017-18,2018-03-24,Ottawa Senators,0,Atlantic,Eastern,63,2,148,0.42567567567567566,97,-34,86,-23
2017-18,2018-03-26,Ottawa Senators,0,Atlantic,Eastern,63,2,150,0.42,97,-34,86,-23
2017-18,2018-03-27,Ottawa Senators,0,Atlantic,Eastern,63,2,152,0.4144736842105263,97,-34,88,-25
2017-18,2018-03-29,Ottawa Senators,2,Atlantic,Eastern,65,2,154,0.42207792207792205,99,-34,89,-24
2017-18,2018-03-31,Ottawa Senators,0,Atlantic,Eastern,65,2,156,0.4166666666666667,101,-36,91,-26
2017-18,2018-04-02,Ottawa Senators,0,Atlantic,Eastern,65,2,158,0.41139240506329117,103,-38,93,-28
2017-18,2018-04-04,Ottawa Senators,2,Atlantic,Eastern,67,2,160,0.41875,103,-36,94,-27
2017-18,2018-04-06,Ottawa Senators,0,Atlantic,Eastern,67,2,162,0.41358024691358025,103,-36,96,-29
2017-18,2018-04-07,Ottawa Senators,0,Atlantic,Eastern,67,2,164,0.40853658536585363,105,-38,97,-30
2017-18,2017-10-05,Philadelphia Flyers,2,Metropolitan,Eastern,2,2,2,1.0,1,1,1,1
2017-18,2017-10-06,Philadelphia Flyers,0,Metropolitan,Eastern,2,2,4,0.5,2,0,2,0
2017-18,2017-10-08,Philadelphia Flyers,2,Metropolitan,Eastern,4,2,6,0.6666666666666666,3,1,2,2
2017-18,2017-10-11,Philadelphia Flyers,0,Metropolitan,Eastern,4,2,8,0.5,5,-1,4,0
2017-18,2017-10-14,Philadelphia Flyers,2,Metropolitan,Eastern,6,2,10,0.6,7,-1,6,0
2017-18,2017-10-17,Philadelphia Flyers,2,Metropolitan,Eastern,8,2,12,0.6666666666666666,8,0,8,0
2017-18,2017-10-19,Philadelphia Flyers,0,Metropolitan,Eastern,8,2,14,0.5714285714285714,9,-1,8,0
2017-18,2017-10-21,Philadelphia Flyers,2,Metropolitan,Eastern,10,2,16,0.625,10,0,9,1
2017-18,2017-10-24,Philadelphia Flyers,0,Metropolitan,Eastern,10,2,18,0.5555555555555556,11,-1,10,0
2017-18,2017-10-26,Philadelphia Flyers,0,Metropolitan,Eastern,10,2,20,0.5,12,-2,10,0
2017-18,2017-10-28,Philadelphia Flyers,2,Metropolitan,Eastern,12,2,22,0.5454545454545454,14,-2,11,1
2017-18,2017-10-30,Philadelphia Flyers,1,Metropolitan,Eastern,13,2,24,0.5416666666666666,15,-2,13,0
2017-18,2017-11-02,Philadelphia Flyers,0,Metropolitan,Eastern,13,2,26,0.5,17,-4,13,0
2017-18,2017-11-03,Philadelphia Flyers,2,Metropolitan,Eastern,15,2,28,0.5357142857142857,18,-3,15,0
2017-18,2017-11-04,Philadelphia Flyers,1,Metropolitan,Eastern,16,2,30,0.5333333333333333,18,-2,15,1
2017-18,2017-11-10,Philadelphia Flyers,2,Metropolitan,Eastern,18,2,32,0.5625,19,-1,18,0
2017-18,2017-11-12,Philadelphia Flyers,0,Metropolitan,Eastern,18,2,34,0.5294117647058824,21,-3,20,-2
2017-18,2017-11-15,Philadelphia Flyers,0,Metropolitan,Eastern,18,2,36,0.5,23,-5,20,-2
2017-18,2017-11-17,Philadelphia Flyers,1,Metropolitan,Eastern,19,2,38,0.5,23,-4,21,-2
2017-18,2017-11-18,Philadelphia Flyers,1,Metropolitan,Eastern,20,2,40,0.5,25,-5,22,-2
2017-18,2017-11-22,Philadelphia Flyers,0,Metropolitan,Eastern,20,2,42,0.47619047619047616,25,-5,23,-3
2017-18,2017-11-23,Philadelphia Flyers,1,Metropolitan,Eastern,21,2,44,0.4772727272727273,26,-5,24,-3
2017-18,2017-11-24,Philadelphia Flyers,1,Metropolitan,Eastern,22,2,46,0.4782608695652174,28,-6,24,-2
2017-18,2017-11-28,Philadelphia Flyers,1,Metropolitan,Eastern,23,2,48,0.4791666666666667,30,-7,28,-5
2017-18,2017-11-29,Philadelphia Flyers,0,Metropolitan,Eastern,23,2,50,0.46,32,-9,28,-5
2017-18,2017-12-02,Philadelphia Flyers,0,Metropolitan,Eastern,23,2,52,0.4423076923076923,32,-9,29,-6
2017-18,2017-12-05,Philadelphia Flyers,2,Metropolitan,Eastern,25,2,54,0.46296296296296297,34,-9,30,-5
2017-18,2017-12-07,Philadelphia Flyers,2,Metropolitan,Eastern,27,2,56,0.48214285714285715,35,-8,32,-5
2017-18,2017-12-08,Philadelphia Flyers,2,Metropolitan,Eastern,29,2,58,0.5,35,-6,32,-3
2017-18,2017-12-13,Philadelphia Flyers,2,Metropolitan,Eastern,31,2,60,0.5166666666666667,38,-7,35,-4
2017-18,2017-12-15,Philadelphia Flyers,2,Metropolitan,Eastern,33,2,62,0.532258064516129,39,-6,35,-2
2017-18,2017-12-17,Philadelphia Flyers,2,Metropolitan,Eastern,35,2,64,0.546875,41,-6,37,-2
2017-18,2017-12-19,Philadelphia Flyers,0,Metropolitan,Eastern,35,2,66,0.5303030303030303,41,-6,37,-2
2017-18,2017-12-21,Philadelphia Flyers,2,Metropolitan,Eastern,37,2,68,0.5441176470588235,43,-6,39,-2
2017-18,2017-12-23,Philadelphia Flyers,0,Metropolitan,Eastern,37,2,70,0.5285714285714286,44,-7,42,-5
2017-18,2017-12-24,Philadelphia Flyers,1,Metropolitan,Eastern,38,2,72,0.5277777777777778,46,-8,42,-4
2017-18,2017-12-29,Philadelphia Flyers,0,Metropolitan,Eastern,38,2,74,0.5135135135135135,47,-9,44,-6
2017-18,2017-12-30,Philadelphia Flyers,2,Metropolitan,Eastern,40,2,76,0.5263157894736842,47,-7,44,-4
2017-18,2018-01-03,Philadelphia Flyers,0,Metropolitan,Eastern,40,2,78,0.5128205128205128,49,-9,44,-4
2017-18,2018-01-05,Philadelphia Flyers,2,Metropolitan,Eastern,42,2,80,0.525,49,-7,46,-4
2017-18,2018-01-06,Philadelphia Flyers,2,Metropolitan,Eastern,44,2,82,0.5365853658536586,49,-5,46,-2
2017-18,2018-01-07,Philadelphia Flyers,2,Metropolitan,Eastern,46,2,84,0.5476190476190477,51,-5,46,0
2017-18,2018-01-14,Philadelphia Flyers,2,Metropolitan,Eastern,48,2,86,0.5581395348837209,52,-4,49,-1
2017-18,2018-01-17,Philadelphia Flyers,0,Metropolitan,Eastern,48,2,88,0.5454545454545454,53,-5,51,-3
2017-18,2018-01-19,Philadelphia Flyers,2,Metropolitan,Eastern,50,2,90,0.5555555555555556,55,-5,53,-3
2017-18,2018-01-20,Philadelphia Flyers,2,Metropolitan,Eastern,52,2,92,0.5652173913043478,55,-3,53,-1
2017-18,2018-01-21,Philadelphia Flyers,2,Metropolitan,Eastern,54,2,94,0.574468085106383,55,-1,53,1
2017-18,2018-01-24,Philadelphia Flyers,2,Metropolitan,Eastern,56,2,96,0.5833333333333334,56,0,55,1
2017-18,2018-01-26,Philadelphia Flyers,0,Metropolitan,Eastern,56,2,98,0.5714285714285714,57,-1,56,0
2017-18,2018-02-01,Philadelphia Flyers,0,Metropolitan,Eastern,56,2,100,0.56,58,-2,56,0
2017-18,2018-02-02,Philadelphia Flyers,0,Metropolitan,Eastern,56,2,102,0.5490196078431373,59,-3,56,0
2017-18,2018-02-03,Philadelphia Flyers,1,Metropolitan,Eastern,57,2,104,0.5480769230769231,60,-3,57,0
2017-18,2018-02-07,Philadelphia Flyers,2,Metropolitan,Eastern,59,2,106,0.5566037735849056,62,-3,58,1
2017-18,2018-02-09,Philadelphia Flyers,2,Metropolitan,Eastern,61,2,108,0.5648148148148148,62,-1,58,3
2017-18,2018-02-11,Philadelphia Flyers,2,Metropolitan,Eastern,63,2,110,0.5727272727272728,63,0,61,2
2017-18,2018-02-12,Philadelphia Flyers,2,Metropolitan,Eastern,65,2,112,0.5803571428571429,65,0,61,4
2017-18,2018-02-14,Philadelphia Flyers,1,Metropolitan,Eastern,66,2,114,0.5789473684210527,66,0,63,3
2017-18,2018-02-17,Philadelphia Flyers,2,Metropolitan,Eastern,68,2,116,0.5862068965517241,68,0,64,4
2017-18,2018-02-18,Philadelphia Flyers,2,Metropolitan,Eastern,70,2,118,0.5932203389830508,70,0,64,6
2017-18,2018-02-21,Philadelphia Flyers,2,Metropolitan,Eastern,72,2,120,0.6,72,0,65,7
2017-18,2018-02-23,Philadelphia Flyers,2,Metropolitan,Eastern,74,2,122,0.6065573770491803,72,2,65,9
2017-18,2018-02-24,Philadelphia Flyers,2,Metropolitan,Eastern,76,2,124,0.6129032258064516,75,1,65,11
2017-18,2018-02-27,Philadelphia Flyers,2,Metropolitan,Eastern,78,2,126,0.6190476190476191,76,2,69,9
2017-18,2018-03-02,Philadelphia Flyers,0,Metropolitan,Eastern,78,2,128,0.609375,76,2,69,9
2017-18,2018-03-03,Philadelphia Flyers,1,Metropolitan,Eastern,79,2,130,0.6076923076923076,78,1,69,10
2017-18,2018-03-04,Philadelphia Flyers,0,Metropolitan,Eastern,79,2,132,0.5984848484848485,78,1,70,9
2017-18,2018-03-08,Philadelphia Flyers,0,Metropolitan,Eastern,79,2,134,0.5895522388059702,79,0,73,6
2017-18,2018-03-09,Philadelphia Flyers,0,Metropolitan,Eastern,79,2,136,0.5808823529411765,79,0,75,4
2017-18,2018-03-10,Philadelphia Flyers,2,Metropolitan,Eastern,81,2,138,0.5869565217391305,81,0,76,5
2017-18,2018-03-12,Philadelphia Flyers,0,Metropolitan,Eastern,81,2,140,0.5785714285714286,81,0,78,3
2017-18,2018-03-15,Philadelphia Flyers,0,Metropolitan,Eastern,81,2,142,0.5704225352112676,81,0,80,1
2017-18,2018-03-17,Philadelphia Flyers,2,Metropolitan,Eastern,83,2,144,0.5763888888888888,83,0,82,1
2017-18,2018-03-18,Philadelphia Flyers,2,Metropolitan,Eastern,85,2,146,0.5821917808219178,85,0,82,3
2017-18,2018-03-20,Philadelphia Flyers,1,Metropolitan,Eastern,86,2,148,0.581081081081081,87,-1,82,4
2017-18,2018-03-22,Philadelphia Flyers,2,Metropolitan,Eastern,88,2,150,0.5866666666666667,89,-1,82,6
2017-18,2018-03-25,Philadelphia Flyers,1,Metropolitan,Eastern,89,2,152,0.5855263157894737,89,0,86,3
2017-18,2018-03-28,Philadelphia Flyers,1,Metropolitan,Eastern,90,2,154,0.5844155844155844,91,-1,88,2
2017-18,2018-03-29,Philadelphia Flyers,2,Metropolitan,Eastern,92,2,156,0.5897435897435898,92,0,89,3
2017-18,2018-04-01,Philadelphia Flyers,2,Metropolitan,Eastern,94,2,158,0.5949367088607594,94,0,93,1
2017-18,2018-04-03,Philadelphia Flyers,0,Metropolitan,Eastern,94,2,160,0.5875,96,-2,94,0
2017-18,2018-04-05,Philadelphia Flyers,2,Metropolitan,Eastern,96,2,162,0.5925925925925926,97,-1,96,0
2017-18,2018-04-07,Philadelphia Flyers,2,Metropolitan,Eastern,98,2,164,0.5975609756097561,98,0,97,1
2017-18,2017-10-05,Pittsburgh Penguins,1,Metropolitan,Eastern,1,2,2,0.5,1,0,1,0
2017-18,2017-10-06,Pittsburgh Penguins,0,Metropolitan,Eastern,1,2,4,0.25,2,-1,2,-1
2017-18,2017-10-07,Pittsburgh Penguins,2,Metropolitan,Eastern,3,2,6,0.5,2,1,2,1
2017-18,2017-10-11,Pittsburgh Penguins,2,Metropolitan,Eastern,5,2,8,0.625,5,0,4,1
2017-18,2017-10-12,Pittsburgh Penguins,0,Metropolitan,Eastern,5,2,10,0.5,5,0,4,1
2017-18,2017-10-14,Pittsburgh Penguins,2,Metropolitan,Eastern,7,2,12,0.5833333333333334,7,0,6,1
2017-18,2017-10-17,Pittsburgh Penguins,2,Metropolitan,Eastern,9,2,14,0.6428571428571429,8,1,8,1
2017-18,2017-10-20,Pittsburgh Penguins,2,Metropolitan,Eastern,11,2,16,0.6875,10,1,9,2
2017-18,2017-10-21,Pittsburgh Penguins,0,Metropolitan,Eastern,11,2,18,0.6111111111111112,10,1,9,2
2017-18,2017-10-24,Pittsburgh Penguins,2,Metropolitan,Eastern,13,2,20,0.65,11,2,10,3
2017-18,2017-10-26,Pittsburgh Penguins,2,Metropolitan,Eastern,15,2,22,0.6818181818181818,12,3,10,5
2017-18,2017-10-29,Pittsburgh Penguins,0,Metropolitan,Eastern,15,2,24,0.625,14,1,12,3
2017-18,2017-10-29,Pittsburgh Penguins,0,Metropolitan,Eastern,15,2,26,0.5769230769230769,14,1,12,3
2017-18,2017-11-02,Pittsburgh Penguins,2,Metropolitan,Eastern,17,2,28,0.6071428571428571,17,0,13,4
2017-18,2017-11-03,Pittsburgh Penguins,1,Metropolitan,Eastern,18,2,30,0.6,18,0,15,3
2017-18,2017-11-05,Pittsburgh Penguins,0,Metropolitan,Eastern,18,2,32,0.5625,18,0,16,2
2017-18,2017-11-08,Pittsburgh Penguins,2,Metropolitan,Eastern,20,2,34,0.5882352941176471,19,1,17,3
2017-18,2017-11-11,Pittsburgh Penguins,0,Metropolitan,Eastern,20,2,36,0.5555555555555556,20,0,19,1
2017-18,2017-11-12,Pittsburgh Penguins,1,Metropolitan,Eastern,21,2,38,0.5526315789473685,21,0,20,1
2017-18,2017-11-15,Pittsburgh Penguins,2,Metropolitan,Eastern,23,2,40,0.575,23,0,20,3
2017-18,2017-11-17,Pittsburgh Penguins,2,Metropolitan,Eastern,25,2,42,0.5952380952380952,23,2,21,4
2017-18,2017-11-19,Pittsburgh Penguins,0,Metropolitan,Eastern,25,2,44,0.5681818181818182,25,0,23,2
2017-18,2017-11-23,Pittsburgh Penguins,0,Metropolitan,Eastern,25,2,46,0.5434782608695652,26,-1,24,1
2017-18,2017-11-24,Pittsburgh Penguins,0,Metropolitan,Eastern,25,2,48,0.5208333333333334,28,-3,24,1
2017-18,2017-11-26,Pittsburgh Penguins,2,Metropolitan,Eastern,27,2,50,0.54,30,-3,27,0
2017-18,2017-11-28,Pittsburgh Penguins,2,Metropolitan,Eastern,29,2,52,0.5576923076923077,30,-1,28,1
2017-18,2017-12-02,Pittsburgh Penguins,2,Metropolitan,Eastern,31,2,54,0.5740740740740741,32,-1,29,2
2017-18,2017-12-03,Pittsburgh Penguins,2,Metropolitan,Eastern,33,2,56,0.5892857142857143,33,0,30,3
2017-18,2017-12-06,Pittsburgh Penguins,0,Metropolitan,Eastern,33,2,58,0.5689655172413793,34,-1,32,1
2017-18,2017-12-08,Pittsburgh Penguins,2,Metropolitan,Eastern,35,2,60,0.5833333333333334,35,0,32,3
2017-18,2017-12-10,Pittsburgh Penguins,0,Metropolitan,Eastern,35,2,62,0.5645161290322581,36,-1,34,1
2017-18,2017-12-12,Pittsburgh Penguins,0,Metropolitan,Eastern,35,2,64,0.546875,37,-2,35,0
2017-18,2017-12-15,Pittsburgh Penguins,0,Metropolitan,Eastern,35,2,66,0.5303030303030303,39,-4,35,0
2017-18,2017-12-17,Pittsburgh Penguins,2,Metropolitan,Eastern,37,2,68,0.5441176470588235,41,-4,37,0
2017-18,2017-12-19,Pittsburgh Penguins,0,Metropolitan,Eastern,37,2,70,0.5285714285714286,41,-4,37,0
2017-18,2017-12-22,Pittsburgh Penguins,2,Metropolitan,Eastern,39,2,72,0.5416666666666666,44,-5,40,-1
2017-18,2017-12-24,Pittsburgh Penguins,0,Metropolitan,Eastern,39,2,74,0.527027027027027,46,-7,42,-3
2017-18,2017-12-28,Pittsburgh Penguins,2,Metropolitan,Eastern,41,2,76,0.5394736842105263,47,-6,44,-3
2017-18,2017-12-30,Pittsburgh Penguins,0,Metropolitan,Eastern,41,2,78,0.5256410256410257,47,-6,44,-3
2017-18,2018-01-01,Pittsburgh Penguins,0,Metropolitan,Eastern,41,2,80,0.5125,47,-6,44,-3
2017-18,2018-01-03,Pittsburgh Penguins,2,Metropolitan,Eastern,43,2,82,0.524390243902439,49,-6,44,-1
2017-18,2018-01-05,Pittsburgh Penguins,0,Metropolitan,Eastern,43,2,84,0.5119047619047619,49,-6,46,-3
2017-18,2018-01-06,Pittsburgh Penguins,2,Metropolitan,Eastern,45,2,86,0.5232558139534884,49,-4,46,-1
2017-18,2018-01-08,Pittsburgh Penguins,2,Metropolitan,Eastern,47,2,88,0.5340909090909091,51,-4,47,0
2017-18,2018-01-13,Pittsburgh Penguins,2,Metropolitan,Eastern,49,2,90,0.5444444444444444,52,-3,49,0
2017-18,2018-01-15,Pittsburgh Penguins,2,Metropolitan,Eastern,51,2,92,0.5543478260869565,52,-1,49,2
2017-18,2018-01-18,Pittsburgh Penguins,0,Metropolitan,Eastern,51,2,94,0.5425531914893617,53,-2,51,0
2017-18,2018-01-19,Pittsburgh Penguins,2,Metropolitan,Eastern,53,2,96,0.5520833333333334,55,-2,53,0
2017-18,2018-01-21,Pittsburgh Penguins,0,Metropolitan,Eastern,53,2,98,0.5408163265306123,55,-2,53,0
2017-18,2018-01-24,Pittsburgh Penguins,2,Metropolitan,Eastern,55,2,100,0.55,56,-1,55,0
2017-18,2018-01-26,Pittsburgh Penguins,2,Metropolitan,Eastern,57,2,102,0.5588235294117647,57,0,56,1
2017-18,2018-01-31,Pittsburgh Penguins,2,Metropolitan,Eastern,59,2,104,0.5673076923076923,58,1,56,3
2017-18,2018-02-03,Pittsburgh Penguins,2,Metropolitan,Eastern,61,2,106,0.5754716981132075,60,1,57,4
2017-18,2018-02-04,Pittsburgh Penguins,0,Metropolitan,Eastern,61,2,108,0.5648148148148148,61,0,57,4
2017-18,2018-02-07,Pittsburgh Penguins,2,Metropolitan,Eastern,63,2,110,0.5727272727272728,62,1,58,5
2017-18,2018-02-10,Pittsburgh Penguins,1,Metropolitan,Eastern,64,2,112,0.5714285714285714,62,2,60,4
2017-18,2018-02-11,Pittsburgh Penguins,2,Metropolitan,Eastern,66,2,114,0.5789473684210527,63,3,61,5
2017-18,2018-02-14,Pittsburgh Penguins,2,Metropolitan,Eastern,68,2,116,0.5862068965517241,66,2,63,5
2017-18,2018-02-16,Pittsburgh Penguins,2,Metropolitan,Eastern,70,2,118,0.5932203389830508,66,4,63,7
2017-18,2018-02-18,Pittsburgh Penguins,2,Metropolitan,Eastern,72,2,120,0.6,70,2,64,8
2017-18,2018-02-18,Pittsburgh Penguins,2,Metropolitan,Eastern,74,2,122,0.6065573770491803,70,4,64,10
2017-18,2018-02-24,Pittsburgh Penguins,2,Metropolitan,Eastern,76,2,124,0.6129032258064516,75,1,65,11
2017-18,2018-02-25,Pittsburgh Penguins,0,Metropolitan,Eastern,76,2,126,0.6031746031746031,76,0,67,9
2017-18,2018-02-28,Pittsburgh Penguins,0,Metropolitan,Eastern,76,2,128,0.59375,76,0,69,7
2017-18,2018-03-02,Pittsburgh Penguins,0,Metropolitan,Eastern,76,2,130,0.5846153846153846,76,0,69,7
2017-18,2018-03-03,Pittsburgh Penguins,2,Metropolitan,Eastern,78,2,132,0.5909090909090909,78,0,69,9
2017-18,2018-03-06,Pittsburgh Penguins,2,Metropolitan,Eastern,80,2,134,0.5970149253731343,79,1,71,9
2017-18,2018-03-08,Pittsburgh Penguins,2,Metropolitan,Eastern,82,2,136,0.6029411764705882,79,3,73,9
2017-18,2018-03-11,Pittsburgh Penguins,2,Metropolitan,Eastern,84,2,138,0.6086956521739131,81,3,77,7
2017-18,2018-03-11,Pittsburgh Penguins,0,Metropolitan,Eastern,84,2,140,0.6,81,3,77,7
2017-18,2018-03-15,Pittsburgh Penguins,1,Metropolitan,Eastern,85,2,142,0.5985915492957746,81,4,80,5
2017-18,2018-03-15,Pittsburgh Penguins,2,Metropolitan,Eastern,87,2,144,0.6041666666666666,81,6,80,7
2017-18,2018-03-20,Pittsburgh Penguins,0,Metropolitan,Eastern,87,2,146,0.5958904109589042,87,0,82,5
2017-18,2018-03-21,Pittsburgh Penguins,2,Metropolitan,Eastern,89,2,148,0.6013513513513513,87,2,82,7
2017-18,2018-03-23,Pittsburgh Penguins,1,Metropolitan,Eastern,90,2,150,0.6,89,1,84,6
2017-18,2018-03-25,Pittsburgh Penguins,2,Metropolitan,Eastern,92,2,152,0.6052631578947368,89,3,86,6
2017-18,2018-03-27,Pittsburgh Penguins,0,Metropolitan,Eastern,92,2,154,0.5974025974025974,89,3,88,4
2017-18,2018-03-29,Pittsburgh Penguins,2,Metropolitan,Eastern,94,2,156,0.6025641025641025,92,2,89,5
2017-18,2018-03-31,Pittsburgh Penguins,2,Metropolitan,Eastern,96,2,158,0.6075949367088608,94,2,91,5
2017-18,2018-04-01,Pittsburgh Penguins,0,Metropolitan,Eastern,96,2,160,0.6,94,2,93,3
2017-18,2018-04-05,Pittsburgh Penguins,2,Metropolitan,Eastern,98,2,162,0.6049382716049383,97,1,96,2
2017-18,2018-04-06,Pittsburgh Penguins,2,Metropolitan,Eastern,100,2,164,0.6097560975609756,97,3,96,4
2017-18,2017-10-05,San Jose Sharks,0,Pacific,Western,0,2,2,0.0,0,0,0,0
2017-18,2017-10-08,San Jose Sharks,0,Pacific,Western,0,2,4,0.0,3,-3,2,-2
2017-18,2017-10-13,San Jose Sharks,2,Pacific,Western,2,2,6,0.3333333333333333,5,-3,4,-2
2017-18,2017-10-15,San Jose Sharks,0,Pacific,Western,2,2,8,0.25,7,-5,5,-3
2017-18,2017-10-18,San Jose Sharks,2,Pacific,Western,4,2,10,0.4,8,-4,6,-2
2017-18,2017-10-20,San Jose Sharks,2,Pacific,Western,6,2,12,0.5,8,-2,8,-2
2017-18,2017-10-21,San Jose Sharks,0,Pacific,Western,6,2,14,0.42857142857142855,8,-2,8,-2
2017-18,2017-10-23,San Jose Sharks,2,Pacific,Western,8,2,16,0.5,9,-1,8,0
2017-18,2017-10-26,San Jose Sharks,0,Pacific,Western,8,2,18,0.4444444444444444,11,-3,10,-2
2017-18,2017-10-28,San Jose Sharks,2,Pacific,Western,10,2,20,0.5,13,-3,11,-1
2017-18,2017-10-31,San Jose Sharks,2,Pacific,Western,12,2,22,0.5454545454545454,14,-2,12,0
2017-18,2017-11-02,San Jose Sharks,2,Pacific,Western,14,2,24,0.5833333333333334,14,0,14,0
2017-18,2017-11-05,San Jose Sharks,2,Pacific,Western,16,2,26,0.6153846153846154,16,0,16,0
2017-18,2017-11-09,San Jose Sharks,0,Pacific,Western,16,2,28,0.5714285714285714,18,-2,16,0
2017-18,2017-11-12,San Jose Sharks,2,Pacific,Western,18,2,30,0.6,18,0,18,0
2017-18,2017-11-13,San Jose Sharks,2,Pacific,Western,20,2,32,0.625,20,0,18,2
2017-18,2017-11-17,San Jose Sharks,0,Pacific,Western,20,2,34,0.5882352941176471,20,0,20,0
2017-18,2017-11-19,San Jose Sharks,0,Pacific,Western,20,2,36,0.5555555555555556,22,-2,21,-1
2017-18,2017-11-21,San Jose Sharks,1,Pacific,Western,21,2,38,0.5526315789473685,24,-3,22,-1
2017-18,2017-11-23,San Jose Sharks,2,Pacific,Western,23,2,40,0.575,25,-2,23,0
2017-18,2017-11-24,San Jose Sharks,1,Pacific,Western,24,2,42,0.5714285714285714,25,-1,25,-1
2017-18,2017-11-26,San Jose Sharks,2,Pacific,Western,26,2,44,0.5909090909090909,27,-1,26,0
2017-18,2017-11-29,San Jose Sharks,2,Pacific,Western,28,2,46,0.6086956521739131,28,0,27,1
2017-18,2017-12-02,San Jose Sharks,2,Pacific,Western,30,2,48,0.625,30,0,29,1
2017-18,2017-12-03,San Jose Sharks,0,Pacific,Western,30,2,50,0.6,30,0,30,0
2017-18,2017-12-05,San Jose Sharks,0,Pacific,Western,30,2,52,0.5769230769230769,30,0,30,0
2017-18,2017-12-08,San Jose Sharks,2,Pacific,Western,32,2,54,0.5925925925925926,32,0,32,0
2017-18,2017-12-10,San Jose Sharks,2,Pacific,Western,34,2,56,0.6071428571428571,34,0,33,1
2017-18,2017-12-11,San Jose Sharks,1,Pacific,Western,35,2,58,0.603448275862069,35,0,33,2
2017-18,2017-12-15,San Jose Sharks,2,Pacific,Western,37,2,60,0.6166666666666667,37,0,37,0
2017-18,2017-12-16,San Jose Sharks,1,Pacific,Western,38,2,62,0.6129032258064516,38,0,37,1
2017-18,2017-12-19,San Jose Sharks,0,Pacific,Western,38,2,64,0.59375,38,0,38,0
2017-18,2017-12-22,San Jose Sharks,2,Pacific,Western,40,2,66,0.6060606060606061,40,0,39,1
2017-18,2017-12-24,San Jose Sharks,2,Pacific,Western,42,2,68,0.6176470588235294,42,0,40,2
2017-18,2017-12-29,San Jose Sharks,2,Pacific,Western,44,2,70,0.6285714285714286,44,0,41,3
2017-18,2018-01-01,San Jose Sharks,0,Pacific,Western,44,2,72,0.6111111111111112,44,0,44,0
2017-18,2018-01-03,San Jose Sharks,2,Pacific,Western,46,2,74,0.6216216216216216,46,0,46,0
2017-18,2018-01-05,San Jose Sharks,1,Pacific,Western,47,2,76,0.618421052631579,47,0,47,0
2017-18,2018-01-06,San Jose Sharks,1,Pacific,Western,48,2,78,0.6153846153846154,48,0,47,1
2017-18,2018-01-07,San Jose Sharks,0,Pacific,Western,48,2,80,0.6,48,0,47,1
2017-18,2018-01-14,San Jose Sharks,2,Pacific,Western,50,2,82,0.6097560975609756,53,-3,51,-1
2017-18,2018-01-15,San Jose Sharks,2,Pacific,Western,52,2,84,0.6190476190476191,53,-1,53,-1
2017-18,2018-01-17,San Jose Sharks,2,Pacific,Western,54,2,86,0.627906976744186,54,0,53,1
2017-18,2018-01-19,San Jose Sharks,0,Pacific,Western,54,2,88,0.6136363636363636,54,0,53,1
2017-18,2018-01-21,San Jose Sharks,2,Pacific,Western,56,2,90,0.6222222222222222,55,1,55,1
2017-18,2018-01-22,San Jose Sharks,2,Pacific,Western,58,2,92,0.6304347826086957,55,3,55,3
2017-18,2018-01-24,San Jose Sharks,1,Pacific,Western,59,2,94,0.6276595744680851,56,3,57,2
2017-18,2018-01-26,San Jose Sharks,0,Pacific,Western,59,2,96,0.6145833333333334,58,1,57,2
2017-18,2018-01-31,San Jose Sharks,0,Pacific,Western,59,2,98,0.6020408163265306,59,0,59,0
2017-18,2018-02-01,San Jose Sharks,1,Pacific,Western,60,2,100,0.6,59,1,59,1
2017-18,2018-02-03,San Jose Sharks,2,Pacific,Western,62,2,102,0.6078431372549019,60,2,60,2
2017-18,2018-02-04,San Jose Sharks,2,Pacific,Western,64,2,104,0.6153846153846154,61,3,61,3
2017-18,2018-02-07,San Jose Sharks,0,Pacific,Western,64,2,106,0.6037735849056604,62,2,62,2
2017-18,2018-02-09,San Jose Sharks,0,Pacific,Western,64,2,108,0.5925925925925926,64,0,64,0
2017-18,2018-02-11,San Jose Sharks,2,Pacific,Western,66,2,110,0.6,65,1,65,1
2017-18,2018-02-12,San Jose Sharks,2,Pacific,Western,68,2,112,0.6071428571428571,66,2,66,2
2017-18,2018-02-14,San Jose Sharks,0,Pacific,Western,68,2,114,0.5964912280701754,66,2,66,2
2017-18,2018-02-16,San Jose Sharks,2,Pacific,Western,70,2,116,0.603448275862069,68,2,68,2
2017-18,2018-02-19,San Jose Sharks,2,Pacific,Western,72,2,118,0.6101694915254238,69,3,69,3
2017-18,2018-02-21,San Jose Sharks,2,Pacific,Western,74,2,120,0.6166666666666667,71,3,71,3
2017-18,2018-02-23,San Jose Sharks,0,Pacific,Western,74,2,122,0.6065573770491803,73,1,72,2
2017-18,2018-02-24,San Jose Sharks,0,Pacific,Western,74,2,124,0.5967741935483871,73,1,73,1
2017-18,2018-02-26,San Jose Sharks,1,Pacific,Western,75,2,126,0.5952380952380952,74,1,73,2
2017-18,2018-02-28,San Jose Sharks,2,Pacific,Western,77,2,128,0.6015625,75,2,74,3
2017-18,2018-03-02,San Jose Sharks,2,Pacific,Western,79,2,130,0.6076923076923076,77,2,74,5
2017-18,2018-03-05,San Jose Sharks,0,Pacific,Western,79,2,132,0.5984848484848485,78,1,77,2
2017-18,2018-03-09,San Jose Sharks,2,Pacific,Western,81,2,134,0.6044776119402985,80,1,79,2
2017-18,2018-03-10,San Jose Sharks,0,Pacific,Western,81,2,136,0.5955882352941176,80,1,80,1
2017-18,2018-03-13,San Jose Sharks,2,Pacific,Western,83,2,138,0.6014492753623188,81,2,80,3
2017-18,2018-03-15,San Jose Sharks,2,Pacific,Western,85,2,140,0.6071428571428571,82,3,82,3
2017-18,2018-03-17,San Jose Sharks,2,Pacific,Western,87,2,142,0.6126760563380281,84,3,84,3
2017-18,2018-03-18,San Jose Sharks,2,Pacific,Western,89,2,144,0.6180555555555556,84,5,84,5
2017-18,2018-03-21,San Jose Sharks,2,Pacific,Western,91,2,146,0.6232876712328768,87,4,86,5
2017-18,2018-03-23,San Jose Sharks,2,Pacific,Western,93,2,148,0.6283783783783784,89,4,88,5
2017-18,2018-03-24,San Jose Sharks,2,Pacific,Western,95,2,150,0.6333333333333333,89,6,89,6
2017-18,2018-03-27,San Jose Sharks,2,Pacific,Western,97,2,152,0.6381578947368421,91,6,90,7
2017-18,2018-03-28,San Jose Sharks,1,Pacific,Western,98,2,154,0.6363636363636364,91,7,91,7
2017-18,2018-03-30,San Jose Sharks,0,Pacific,Western,98,2,156,0.6282051282051282,93,5,91,7
2017-18,2018-04-01,San Jose Sharks,0,Pacific,Western,98,2,158,0.620253164556962,94,4,92,6
2017-18,2018-04-04,San Jose Sharks,0,Pacific,Western,98,2,160,0.6125,96,2,93,5
2017-18,2018-04-06,San Jose Sharks,2,Pacific,Western,100,2,162,0.6172839506172839,98,2,93,7
2017-18,2018-04-08,San Jose Sharks,0,Pacific,Western,100,2,164,0.6097560975609756,100,0,95,5
2017-18,2017-10-05,St. Louis Blues,2,Central,Western,2,2,2,1.0,0,2,0,2
2017-18,2017-10-08,St. Louis Blues,2,Central,Western,4,2,4,1.0,2,2,2,2
2017-18,2017-10-09,St. Louis Blues,2,Central,Western,6,2,6,1.0,4,2,2,4
2017-18,2017-10-10,St. Louis Blues,2,Central,Western,8,2,8,1.0,4,4,2,6
2017-18,2017-10-12,St. Louis Blues,0,Central,Western,8,2,10,0.8,6,2,3,5
2017-18,2017-10-14,St. Louis Blues,0,Central,Western,8,2,12,0.6666666666666666,7,1,5,3
2017-18,2017-10-19,St. Louis Blues,2,Central,Western,10,2,14,0.7142857142857143,9,1,6,4
2017-18,2017-10-20,St. Louis Blues,2,Central,Western,12,2,16,0.75,9,3,8,4
2017-18,2017-10-22,St. Louis Blues,1,Central,Western,13,2,18,0.7222222222222222,10,3,8,5
2017-18,2017-10-26,St. Louis Blues,2,Central,Western,15,2,20,0.75,10,5,10,5
2017-18,2017-10-27,St. Louis Blues,2,Central,Western,17,2,22,0.7727272727272727,10,7,10,7
2017-18,2017-10-29,St. Louis Blues,2,Central,Western,19,2,24,0.7916666666666666,12,7,12,7
2017-18,2017-10-31,St. Louis Blues,2,Central,Western,21,2,26,0.8076923076923077,12,9,12,9
2017-18,2017-11-03,St. Louis Blues,0,Central,Western,21,2,28,0.75,14,7,14,7
2017-18,2017-11-04,St. Louis Blues,2,Central,Western,23,2,30,0.7666666666666667,16,7,14,9
2017-18,2017-11-08,St. Louis Blues,2,Central,Western,25,2,32,0.78125,18,7,16,9
2017-18,2017-11-10,St. Louis Blues,2,Central,Western,27,2,34,0.7941176470588235,18,9,17,10
2017-18,2017-11-12,St. Louis Blues,0,Central,Western,27,2,36,0.75,20,7,18,9
2017-18,2017-11-14,St. Louis Blues,0,Central,Western,27,2,38,0.7105263157894737,20,7,18,9
2017-18,2017-11-17,St. Louis Blues,2,Central,Western,29,2,40,0.725,22,7,20,9
2017-18,2017-11-19,St. Louis Blues,2,Central,Western,31,2,42,0.7380952380952381,24,7,21,10
2017-18,2017-11-22,St. Louis Blues,2,Central,Western,33,2,44,0.75,26,7,23,10
2017-18,2017-11-25,St. Louis Blues,0,Central,Western,33,2,46,0.717391304347826,30,3,25,8
2017-18,2017-11-26,St. Louis Blues,2,Central,Western,35,2,48,0.7291666666666666,31,4,26,9
2017-18,2017-11-30,St. Louis Blues,0,Central,Western,35,2,50,0.7,33,2,27,8
2017-18,2017-12-02,St. Louis Blues,0,Central,Western,35,2,52,0.6730769230769231,33,2,29,6
2017-18,2017-12-02,St. Louis Blues,1,Central,Western,36,2,54,0.6666666666666666,33,3,29,7
2017-18,2017-12-06,St. Louis Blues,2,Central,Western,38,2,56,0.6785714285714286,38,0,30,8
2017-18,2017-12-08,St. Louis Blues,2,Central,Western,40,2,58,0.6896551724137931,38,2,32,8
2017-18,2017-12-09,St. Louis Blues,2,Central,Western,42,2,60,0.7,38,4,32,10
2017-18,2017-12-11,St. Louis Blues,2,Central,Western,44,2,62,0.7096774193548387,39,5,33,11
2017-18,2017-12-13,St. Louis Blues,0,Central,Western,44,2,64,0.6875,40,4,35,9
2017-18,2017-12-15,St. Louis Blues,0,Central,Western,44,2,66,0.6666666666666666,41,3,37,7
2017-18,2017-12-17,St. Louis Blues,2,Central,Western,46,2,68,0.6764705882352942,43,3,37,9
2017-18,2017-12-17,St. Louis Blues,0,Central,Western,46,2,70,0.6571428571428571,43,3,37,9
2017-18,2017-12-21,St. Louis Blues,0,Central,Western,46,2,72,0.6388888888888888,45,1,39,7
2017-18,2017-12-22,St. Louis Blues,0,Central,Western,46,2,74,0.6216216216216216,46,0,39,7
2017-18,2017-12-24,St. Louis Blues,2,Central,Western,48,2,76,0.631578947368421,46,2,40,8
2017-18,2017-12-28,St. Louis Blues,0,Central,Western,48,2,78,0.6153846153846154,48,0,41,7
2017-18,2017-12-30,St. Louis Blues,0,Central,Western,48,2,80,0.6,48,0,43,5
2017-18,2017-12-31,St. Louis Blues,2,Central,Western,50,2,82,0.6097560975609756,50,0,44,6
2017-18,2018-01-03,St. Louis Blues,2,Central,Western,52,2,84,0.6190476190476191,51,1,46,6
2017-18,2018-01-05,St. Louis Blues,2,Central,Western,54,2,86,0.627906976744186,52,2,47,7
2017-18,2018-01-06,St. Louis Blues,0,Central,Western,54,2,88,0.6136363636363636,52,2,47,7
2017-18,2018-01-07,St. Louis Blues,1,Central,Western,55,2,90,0.6111111111111112,54,1,47,8
2017-18,2018-01-10,St. Louis Blues,0,Central,Western,55,2,92,0.5978260869565217,55,0,48,7
2017-18,2018-01-17,St. Louis Blues,2,Central,Western,57,2,94,0.6063829787234043,57,0,53,4
2017-18,2018-01-19,St. Louis Blues,2,Central,Western,59,2,96,0.6145833333333334,59,0,53,6
2017-18,2018-01-21,St. Louis Blues,0,Central,Western,59,2,98,0.6020408163265306,59,0,55,4
2017-18,2018-01-24,St. Louis Blues,2,Central,Western,61,2,100,0.61,61,0,57,4
2017-18,2018-01-26,St. Louis Blues,2,Central,Western,63,2,102,0.6176470588235294,63,0,57,6
2017-18,2018-01-31,St. Louis Blues,2,Central,Western,65,2,104,0.625,65,0,59,6
2017-18,2018-02-02,St. Louis Blues,0,Central,Western,65,2,106,0.6132075471698113,65,0,60,5
2017-18,2018-02-04,St. Louis Blues,2,Central,Western,67,2,108,0.6203703703703703,67,0,61,6
2017-18,2018-02-07,St. Louis Blues,0,Central,Western,67,2,110,0.6090909090909091,67,0,62,5
2017-18,2018-02-09,St. Louis Blues,2,Central,Western,69,2,112,0.6160714285714286,69,0,64,5
2017-18,2018-02-10,St. Louis Blues,2,Central,Western,71,2,114,0.6228070175438597,71,0,64,7
2017-18,2018-02-11,St. Louis Blues,0,Central,Western,71,2,116,0.6120689655172413,71,0,65,6
2017-18,2018-02-14,St. Louis Blues,1,Central,Western,72,2,118,0.6101694915254238,72,0,66,6
2017-18,2018-02-17,St. Louis Blues,0,Central,Western,72,2,120,0.6,72,0,69,3
2017-18,2018-02-21,St. Louis Blues,0,Central,Western,72,2,122,0.5901639344262295,72,0,71,1
2017-18,2018-02-24,St. Louis Blues,0,Central,Western,72,2,124,0.5806451612903226,75,-3,73,-1
2017-18,2018-02-25,St. Louis Blues,0,Central,Western,72,2,126,0.5714285714285714,75,-3,73,-1
2017-18,2018-02-28,St. Louis Blues,0,Central,Western,72,2,128,0.5625,79,-7,74,-2
2017-18,2018-03-01,St. Louis Blues,2,Central,Western,74,2,130,0.5692307692307692,79,-5,74,0
2017-18,2018-03-03,St. Louis Blues,1,Central,Western,75,2,132,0.5681818181818182,79,-4,76,-1
2017-18,2018-03-09,St. Louis Blues,0,Central,Western,75,2,134,0.5597014925373134,83,-8,79,-4
2017-18,2018-03-10,St. Louis Blues,2,Central,Western,77,2,136,0.5661764705882353,85,-8,80,-3
2017-18,2018-03-13,St. Louis Blues,2,Central,Western,79,2,138,0.572463768115942,85,-6,80,-1
2017-18,2018-03-16,St. Louis Blues,0,Central,Western,79,2,140,0.5642857142857143,85,-6,84,-5
2017-18,2018-03-18,St. Louis Blues,2,Central,Western,81,2,142,0.5704225352112676,89,-8,84,-3
2017-18,2018-03-18,St. Louis Blues,2,Central,Western,83,2,144,0.5763888888888888,89,-6,84,-1
2017-18,2018-03-22,St. Louis Blues,2,Central,Western,85,2,146,0.5821917808219178,90,-5,87,-2
2017-18,2018-03-24,St. Louis Blues,2,Central,Western,87,2,148,0.5878378378378378,90,-3,89,-2
2017-18,2018-03-24,St. Louis Blues,2,Central,Western,89,2,150,0.5933333333333334,90,-1,89,0
2017-18,2018-03-28,St. Louis Blues,2,Central,Western,91,2,152,0.5986842105263158,94,-3,91,0
2017-18,2018-03-31,St. Louis Blues,1,Central,Western,92,2,154,0.5974025974025974,96,-4,92,0
2017-18,2018-04-01,St. Louis Blues,0,Central,Western,92,2,156,0.5897435897435898,96,-4,92,0
2017-18,2018-04-03,St. Louis Blues,0,Central,Western,92,2,158,0.5822784810126582,98,-6,93,-1
2017-18,2018-04-05,St. Louis Blues,0,Central,Western,92,2,160,0.575,98,-6,93,-1
2017-18,2018-04-07,St. Louis Blues,2,Central,Western,94,2,162,0.5802469135802469,99,-5,94,0
2017-18,2018-04-08,St. Louis Blues,0,Central,Western,94,2,164,0.573170731707317,101,-7,95,-1
2017-18,2017-10-06,Tampa Bay Lightning,2,Atlantic,Eastern,2,2,2,1.0,2,0,2,0
2017-18,2017-10-07,Tampa Bay Lightning,0,Atlantic,Eastern,2,2,4,0.5,2,0,2,0
2017-18,2017-10-09,Tampa Bay Lightning,2,Atlantic,Eastern,4,2,6,0.6666666666666666,4,0,3,1
2017-18,2017-10-12,Tampa Bay Lightning,2,Atlantic,Eastern,6,2,8,0.75,4,2,4,2
2017-18,2017-10-14,Tampa Bay Lightning,2,Atlantic,Eastern,8,2,10,0.8,8,0,6,2
2017-18,2017-10-16,Tampa Bay Lightning,2,Atlantic,Eastern,10,2,12,0.8333333333333334,8,2,7,3
2017-18,2017-10-17,Tampa Bay Lightning,1,Atlantic,Eastern,11,2,14,0.7857142857142857,8,3,8,3
2017-18,2017-10-19,Tampa Bay Lightning,2,Atlantic,Eastern,13,2,16,0.8125,9,4,8,5
2017-18,2017-10-21,Tampa Bay Lightning,2,Atlantic,Eastern,15,2,18,0.8333333333333334,11,4,9,6
2017-18,2017-10-24,Tampa Bay Lightning,2,Atlantic,Eastern,17,2,20,0.85,12,5,10,7
2017-18,2017-10-26,Tampa Bay Lightning,2,Atlantic,Eastern,19,2,22,0.8636363636363636,14,5,10,9
2017-18,2017-10-28,Tampa Bay Lightning,0,Atlantic,Eastern,19,2,24,0.7916666666666666,14,5,11,8
2017-18,2017-10-30,Tampa Bay Lightning,2,Atlantic,Eastern,21,2,26,0.8076923076923077,14,7,13,8
2017-18,2017-11-02,Tampa Bay Lightning,1,Atlantic,Eastern,22,2,28,0.7857142857142857,16,6,13,9
2017-18,2017-11-04,Tampa Bay Lightning,2,Atlantic,Eastern,24,2,30,0.8,16,8,15,9
2017-18,2017-11-09,Tampa Bay Lightning,2,Atlantic,Eastern,26,2,32,0.8125,17,9,17,9
2017-18,2017-11-10,Tampa Bay Lightning,2,Atlantic,Eastern,28,2,34,0.8235294117647058,17,11,18,10
2017-18,2017-11-13,Tampa Bay Lightning,2,Atlantic,Eastern,30,2,36,0.8333333333333334,21,9,20,10
2017-18,2017-11-17,Tampa Bay Lightning,2,Atlantic,Eastern,32,2,38,0.8421052631578947,21,11,21,11
2017-18,2017-11-19,Tampa Bay Lightning,0,Atlantic,Eastern,32,2,40,0.8,23,9,23,9
2017-18,2017-11-23,Tampa Bay Lightning,2,Atlantic,Eastern,34,2,42,0.8095238095238095,23,11,24,10
2017-18,2017-11-24,Tampa Bay Lightning,0,Atlantic,Eastern,34,2,44,0.7727272727272727,24,10,24,10
2017-18,2017-11-26,Tampa Bay Lightning,0,Atlantic,Eastern,34,2,46,0.7391304347826086,25,9,27,7
2017-18,2017-11-29,Tampa Bay Lightning,2,Atlantic,Eastern,36,2,48,0.75,25,11,28,8
2017-18,2017-11-30,Tampa Bay Lightning,0,Atlantic,Eastern,36,2,50,0.72,26,10,28,8
2017-18,2017-12-03,Tampa Bay Lightning,2,Atlantic,Eastern,38,2,52,0.7307692307692307,29,9,30,8
2017-18,2017-12-06,Tampa Bay Lightning,2,Atlantic,Eastern,40,2,54,0.7407407407407407,29,11,32,8
2017-18,2017-12-08,Tampa Bay Lightning,2,Atlantic,Eastern,42,2,56,0.75,30,12,32,10
2017-18,2017-12-10,Tampa Bay Lightning,2,Atlantic,Eastern,44,2,58,0.7586206896551724,32,12,34,10
2017-18,2017-12-13,Tampa Bay Lightning,2,Atlantic,Eastern,46,2,60,0.7666666666666667,32,14,35,11
2017-18,2017-12-15,Tampa Bay Lightning,2,Atlantic,Eastern,48,2,62,0.7741935483870968,34,14,35,13
2017-18,2017-12-17,Tampa Bay Lightning,2,Atlantic,Eastern,50,2,64,0.78125,35,15,37,13
2017-18,2017-12-20,Tampa Bay Lightning,0,Atlantic,Eastern,50,2,66,0.7575757575757576,39,11,39,11
2017-18,2017-12-22,Tampa Bay Lightning,2,Atlantic,Eastern,52,2,68,0.7647058823529411,41,11,40,12
2017-18,2017-12-24,Tampa Bay Lightning,2,Atlantic,Eastern,54,2,70,0.7714285714285715,43,11,42,12
2017-18,2017-12-29,Tampa Bay Lightning,2,Atlantic,Eastern,56,2,72,0.7777777777777778,46,10,44,12
2017-18,2017-12-30,Tampa Bay Lightning,0,Atlantic,Eastern,56,2,74,0.7567567567567568,46,10,44,12
2017-18,2017-12-31,Tampa Bay Lightning,2,Atlantic,Eastern,58,2,76,0.7631578947368421,48,10,44,14
2017-18,2018-01-03,Tampa Bay Lightning,2,Atlantic,Eastern,60,2,78,0.7692307692307693,48,12,44,16
2017-18,2018-01-05,Tampa Bay Lightning,1,Atlantic,Eastern,61,2,80,0.7625,50,11,46,15
2017-18,2018-01-07,Tampa Bay Lightning,0,Atlantic,Eastern,61,2,82,0.7439024390243902,52,9,46,15
2017-18,2018-01-08,Tampa Bay Lightning,2,Atlantic,Eastern,63,2,84,0.75,52,11,47,16
2017-18,2018-01-10,Tampa Bay Lightning,2,Atlantic,Eastern,65,2,86,0.7558139534883721,53,12,47,18
2017-18,2018-01-12,Tampa Bay Lightning,0,Atlantic,Eastern,65,2,88,0.7386363636363636,53,12,48,17
2017-18,2018-01-19,Tampa Bay Lightning,0,Atlantic,Eastern,65,2,90,0.7222222222222222,55,10,53,12
2017-18,2018-01-21,Tampa Bay Lightning,0,Atlantic,Eastern,65,2,92,0.7065217391304348,57,8,53,12
2017-18,2018-01-23,Tampa Bay Lightning,2,Atlantic,Eastern,67,2,94,0.7127659574468085,57,10,53,14
2017-18,2018-01-24,Tampa Bay Lightning,2,Atlantic,Eastern,69,2,96,0.71875,57,12,55,14
2017-18,2018-01-26,Tampa Bay Lightning,2,Atlantic,Eastern,71,2,98,0.7244897959183674,61,10,56,15
2017-18,2018-01-31,Tampa Bay Lightning,0,Atlantic,Eastern,71,2,100,0.71,61,10,56,15
2017-18,2018-02-02,Tampa Bay Lightning,2,Atlantic,Eastern,73,2,102,0.7156862745098039,65,8,56,17
2017-18,2018-02-04,Tampa Bay Lightning,2,Atlantic,Eastern,75,2,104,0.7211538461538461,65,10,57,18
2017-18,2018-02-06,Tampa Bay Lightning,0,Atlantic,Eastern,75,2,106,0.7075471698113207,67,8,58,17
2017-18,2018-02-09,Tampa Bay Lightning,2,Atlantic,Eastern,77,2,108,0.7129629629629629,69,8,58,19
2017-18,2018-02-11,Tampa Bay Lightning,2,Atlantic,Eastern,79,2,110,0.7181818181818181,71,8,61,18
2017-18,2018-02-13,Tampa Bay Lightning,0,Atlantic,Eastern,79,2,112,0.7053571428571429,73,6,61,18
2017-18,2018-02-14,Tampa Bay Lightning,0,Atlantic,Eastern,79,2,114,0.6929824561403509,73,6,63,16
2017-18,2018-02-16,Tampa Bay Lightning,2,Atlantic,Eastern,81,2,116,0.6982758620689655,75,6,63,18
2017-18,2018-02-18,Tampa Bay Lightning,0,Atlantic,Eastern,81,2,118,0.6864406779661016,75,6,64,17
2017-18,2018-02-21,Tampa Bay Lightning,2,Atlantic,Eastern,83,2,120,0.6916666666666667,79,4,65,18
2017-18,2018-02-23,Tampa Bay Lightning,2,Atlantic,Eastern,85,2,122,0.6967213114754098,81,4,65,20
2017-18,2018-02-25,Tampa Bay Lightning,2,Atlantic,Eastern,87,2,124,0.7016129032258065,82,5,67,20
2017-18,2018-02-27,Tampa Bay Lightning,2,Atlantic,Eastern,89,2,126,0.7063492063492064,82,7,69,20
2017-18,2018-03-01,Tampa Bay Lightning,1,Atlantic,Eastern,90,2,128,0.703125,84,6,69,21
2017-18,2018-03-02,Tampa Bay Lightning,2,Atlantic,Eastern,92,2,130,0.7076923076923077,85,7,69,23
2017-18,2018-03-03,Tampa Bay Lightning,2,Atlantic,Eastern,94,2,132,0.7121212121212122,85,9,69,25
2017-18,2018-03-07,Tampa Bay Lightning,2,Atlantic,Eastern,96,2,134,0.7164179104477612,85,11,73,23
2017-18,2018-03-09,Tampa Bay Lightning,2,Atlantic,Eastern,98,2,136,0.7205882352941176,85,13,75,23
2017-18,2018-03-10,Tampa Bay Lightning,2,Atlantic,Eastern,100,2,138,0.7246376811594203,85,15,76,24
2017-18,2018-03-13,Tampa Bay Lightning,0,Atlantic,Eastern,100,2,140,0.7142857142857143,87,13,78,22
2017-18,2018-03-17,Tampa Bay Lightning,0,Atlantic,Eastern,100,2,142,0.704225352112676,93,7,82,18
2017-18,2018-03-18,Tampa Bay Lightning,2,Atlantic,Eastern,102,2,144,0.7083333333333334,93,9,82,20
2017-18,2018-03-20,Tampa Bay Lightning,2,Atlantic,Eastern,104,2,146,0.7123287671232876,93,11,82,22
2017-18,2018-03-22,Tampa Bay Lightning,2,Atlantic,Eastern,106,2,148,0.7162162162162162,93,13,82,24
2017-18,2018-03-24,Tampa Bay Lightning,0,Atlantic,Eastern,106,2,150,0.7066666666666667,97,9,86,20
2017-18,2018-03-26,Tampa Bay Lightning,0,Atlantic,Eastern,106,2,152,0.6973684210526315,97,9,86,20
2017-18,2018-03-29,Tampa Bay Lightning,0,Atlantic,Eastern,106,2,154,0.6883116883116883,99,7,89,17
2017-18,2018-03-30,Tampa Bay Lightning,2,Atlantic,Eastern,108,2,156,0.6923076923076923,101,7,89,19
2017-18,2018-04-01,Tampa Bay Lightning,0,Atlantic,Eastern,108,2,158,0.6835443037974683,101,7,93,15
2017-18,2018-04-03,Tampa Bay Lightning,2,Atlantic,Eastern,110,2,160,0.6875,103,7,94,16
2017-18,2018-04-06,Tampa Bay Lightning,2,Atlantic,Eastern,112,2,162,0.691358024691358,103,9,96,16
2017-18,2018-04-07,Tampa Bay Lightning,1,Atlantic,Eastern,113,2,164,0.6890243902439024,105,8,97,16
2017-18,2017-10-04,Toronto Maple Leafs,2,Atlantic,Eastern,2,2,2,1.0,0,2,0,2
2017-18,2017-10-07,Toronto Maple Leafs,2,Atlantic,Eastern,4,2,4,1.0,2,2,2,2
2017-18,2017-10-09,Toronto Maple Leafs,2,Atlantic,Eastern,6,2,6,1.0,4,2,3,3
2017-18,2017-10-11,Toronto Maple Leafs,0,Atlantic,Eastern,6,2,8,0.75,4,2,4,2
2017-18,2017-10-14,Toronto Maple Leafs,2,Atlantic,Eastern,8,2,10,0.8,8,0,6,2
2017-18,2017-10-17,Toronto Maple Leafs,2,Atlantic,Eastern,10,2,12,0.8333333333333334,8,2,8,2
2017-18,2017-10-18,Toronto Maple Leafs,2,Atlantic,Eastern,12,2,14,0.8571428571428571,8,4,8,4
2017-18,2017-10-21,Toronto Maple Leafs,0,Atlantic,Eastern,12,2,16,0.75,11,1,9,3
2017-18,2017-10-23,Toronto Maple Leafs,2,Atlantic,Eastern,14,2,18,0.7777777777777778,11,3,9,5
2017-18,2017-10-26,Toronto Maple Leafs,0,Atlantic,Eastern,14,2,20,0.7,14,0,10,4
2017-18,2017-10-28,Toronto Maple Leafs,0,Atlantic,Eastern,14,2,22,0.6363636363636364,14,0,11,3
2017-18,2017-10-31,Toronto Maple Leafs,0,Atlantic,Eastern,14,2,24,0.5833333333333334,14,0,13,1
2017-18,2017-11-02,Toronto Maple Leafs,2,Atlantic,Eastern,16,2,26,0.6153846153846154,16,0,13,3
2017-18,2017-11-03,Toronto Maple Leafs,0,Atlantic,Eastern,16,2,28,0.5714285714285714,16,0,15,1
2017-18,2017-11-04,Toronto Maple Leafs,0,Atlantic,Eastern,16,2,30,0.5333333333333333,16,0,15,1
2017-18,2017-11-07,Toronto Maple Leafs,2,Atlantic,Eastern,18,2,32,0.5625,17,1,17,1
2017-18,2017-11-09,Toronto Maple Leafs,2,Atlantic,Eastern,20,2,34,0.5882352941176471,17,3,17,3
2017-18,2017-11-11,Toronto Maple Leafs,2,Atlantic,Eastern,22,2,36,0.6111111111111112,19,3,19,3
2017-18,2017-11-12,Toronto Maple Leafs,2,Atlantic,Eastern,24,2,38,0.631578947368421,21,3,20,4
2017-18,2017-11-17,Toronto Maple Leafs,2,Atlantic,Eastern,26,2,40,0.65,21,5,21,5
2017-18,2017-11-19,Toronto Maple Leafs,2,Atlantic,Eastern,28,2,42,0.6666666666666666,23,5,23,5
2017-18,2017-11-21,Toronto Maple Leafs,0,Atlantic,Eastern,28,2,44,0.6363636363636364,23,5,23,5
2017-18,2017-11-23,Toronto Maple Leafs,1,Atlantic,Eastern,29,2,46,0.6304347826086957,23,6,24,5
2017-18,2017-11-25,Toronto Maple Leafs,2,Atlantic,Eastern,31,2,48,0.6458333333333334,24,7,25,6
2017-18,2017-11-26,Toronto Maple Leafs,0,Atlantic,Eastern,31,2,50,0.62,25,6,27,4
2017-18,2017-11-29,Toronto Maple Leafs,2,Atlantic,Eastern,33,2,52,0.6346153846153846,25,8,28,5
2017-18,2017-12-01,Toronto Maple Leafs,2,Atlantic,Eastern,35,2,54,0.6481481481481481,27,8,28,7
2017-18,2017-12-03,Toronto Maple Leafs,0,Atlantic,Eastern,35,2,56,0.625,29,6,30,5
2017-18,2017-12-07,Toronto Maple Leafs,2,Atlantic,Eastern,37,2,58,0.6379310344827587,29,8,32,5
2017-18,2017-12-10,Toronto Maple Leafs,2,Atlantic,Eastern,39,2,60,0.65,32,7,34,5
2017-18,2017-12-11,Toronto Maple Leafs,2,Atlantic,Eastern,41,2,62,0.6612903225806451,32,9,34,7
2017-18,2017-12-13,Toronto Maple Leafs,0,Atlantic,Eastern,41,2,64,0.640625,32,9,35,6
2017-18,2017-12-15,Toronto Maple Leafs,0,Atlantic,Eastern,41,2,66,0.6212121212121212,34,7,35,6
2017-18,2017-12-16,Toronto Maple Leafs,0,Atlantic,Eastern,41,2,68,0.6029411764705882,35,6,35,6
2017-18,2017-12-19,Toronto Maple Leafs,2,Atlantic,Eastern,43,2,70,0.6142857142857143,37,6,37,6
2017-18,2017-12-21,Toronto Maple Leafs,0,Atlantic,Eastern,43,2,72,0.5972222222222222,39,4,39,4
2017-18,2017-12-24,Toronto Maple Leafs,2,Atlantic,Eastern,45,2,74,0.6081081081081081,43,2,42,3
2017-18,2017-12-29,Toronto Maple Leafs,2,Atlantic,Eastern,47,2,76,0.618421052631579,46,1,44,3
2017-18,2017-12-30,Toronto Maple Leafs,1,Atlantic,Eastern,48,2,78,0.6153846153846154,46,2,44,4
2017-18,2017-12-31,Toronto Maple Leafs,0,Atlantic,Eastern,48,2,80,0.6,48,0,44,4
2017-18,2018-01-03,Toronto Maple Leafs,0,Atlantic,Eastern,48,2,82,0.5853658536585366,48,0,44,4
2017-18,2018-01-05,Toronto Maple Leafs,2,Atlantic,Eastern,50,2,84,0.5952380952380952,50,0,46,4
2017-18,2018-01-07,Toronto Maple Leafs,2,Atlantic,Eastern,52,2,86,0.6046511627906976,52,0,46,6
2017-18,2018-01-09,Toronto Maple Leafs,1,Atlantic,Eastern,53,2,88,0.6022727272727273,53,0,47,6
2017-18,2018-01-11,Toronto Maple Leafs,0,Atlantic,Eastern,53,2,90,0.5888888888888889,53,0,47,6
2017-18,2018-01-17,Toronto Maple Leafs,1,Atlantic,Eastern,54,2,92,0.5869565217391305,54,0,51,3
2017-18,2018-01-19,Toronto Maple Leafs,1,Atlantic,Eastern,55,2,94,0.5851063829787234,55,0,53,2
2017-18,2018-01-21,Toronto Maple Leafs,2,Atlantic,Eastern,57,2,96,0.59375,57,0,53,4
2017-18,2018-01-23,Toronto Maple Leafs,0,Atlantic,Eastern,57,2,98,0.5816326530612245,57,0,53,4
2017-18,2018-01-25,Toronto Maple Leafs,2,Atlantic,Eastern,59,2,100,0.59,59,0,55,4
2017-18,2018-01-26,Toronto Maple Leafs,2,Atlantic,Eastern,61,2,102,0.5980392156862745,61,0,56,5
2017-18,2018-02-01,Toronto Maple Leafs,2,Atlantic,Eastern,63,2,104,0.6057692307692307,63,0,56,7
2017-18,2018-02-02,Toronto Maple Leafs,2,Atlantic,Eastern,65,2,106,0.6132075471698113,65,0,56,9
2017-18,2018-02-04,Toronto Maple Leafs,0,Atlantic,Eastern,65,2,108,0.6018518518518519,65,0,57,8
2017-18,2018-02-06,Toronto Maple Leafs,2,Atlantic,Eastern,67,2,110,0.6090909090909091,67,0,58,9
2017-18,2018-02-08,Toronto Maple Leafs,2,Atlantic,Eastern,69,2,112,0.6160714285714286,69,0,58,11
2017-18,2018-02-11,Toronto Maple Leafs,2,Atlantic,Eastern,71,2,114,0.6228070175438597,71,0,61,10
2017-18,2018-02-13,Toronto Maple Leafs,2,Atlantic,Eastern,73,2,116,0.6293103448275862,73,0,61,12
2017-18,2018-02-15,Toronto Maple Leafs,2,Atlantic,Eastern,75,2,118,0.635593220338983,75,0,63,12
2017-18,2018-02-18,Toronto Maple Leafs,0,Atlantic,Eastern,75,2,120,0.625,75,0,64,11
2017-18,2018-02-19,Toronto Maple Leafs,2,Atlantic,Eastern,77,2,122,0.6311475409836066,77,0,64,13
2017-18,2018-02-21,Toronto Maple Leafs,2,Atlantic,Eastern,79,2,124,0.6370967741935484,79,0,65,14
2017-18,2018-02-23,Toronto Maple Leafs,2,Atlantic,Eastern,81,2,126,0.6428571428571429,81,0,65,16
2017-18,2018-02-25,Toronto Maple Leafs,2,Atlantic,Eastern,83,2,128,0.6484375,82,1,67,16
2017-18,2018-02-27,Toronto Maple Leafs,1,Atlantic,Eastern,84,2,130,0.6461538461538462,82,2,69,15
2017-18,2018-02-28,Toronto Maple Leafs,1,Atlantic,Eastern,85,2,132,0.6439393939393939,84,1,69,16
2017-18,2018-03-04,Toronto Maple Leafs,0,Atlantic,Eastern,85,2,134,0.6343283582089553,85,0,70,15
2017-18,2018-03-06,Toronto Maple Leafs,0,Atlantic,Eastern,85,2,136,0.625,85,0,71,14
2017-18,2018-03-11,Toronto Maple Leafs,2,Atlantic,Eastern,87,2,138,0.6304347826086957,87,0,77,10
2017-18,2018-03-14,Toronto Maple Leafs,2,Atlantic,Eastern,89,2,140,0.6357142857142857,89,0,78,11
2017-18,2018-03-15,Toronto Maple Leafs,2,Atlantic,Eastern,91,2,142,0.6408450704225352,91,0,80,11
2017-18,2018-03-17,Toronto Maple Leafs,2,Atlantic,Eastern,93,2,144,0.6458333333333334,93,0,82,11
2017-18,2018-03-20,Toronto Maple Leafs,0,Atlantic,Eastern,93,2,146,0.636986301369863,93,0,82,11
2017-18,2018-03-23,Toronto Maple Leafs,2,Atlantic,Eastern,95,2,148,0.6418918918918919,95,0,84,11
2017-18,2018-03-24,Toronto Maple Leafs,2,Atlantic,Eastern,97,2,150,0.6466666666666666,97,0,86,11
2017-18,2018-03-26,Toronto Maple Leafs,0,Atlantic,Eastern,97,2,152,0.6381578947368421,97,0,86,11
2017-18,2018-03-28,Toronto Maple Leafs,2,Atlantic,Eastern,99,2,154,0.6428571428571429,99,0,88,11
2017-18,2018-03-30,Toronto Maple Leafs,2,Atlantic,Eastern,101,2,156,0.6474358974358975,101,0,89,12
2017-18,2018-03-31,Toronto Maple Leafs,0,Atlantic,Eastern,101,2,158,0.6392405063291139,101,0,91,10
2017-18,2018-04-02,Toronto Maple Leafs,2,Atlantic,Eastern,103,2,160,0.64375,103,0,93,10
2017-18,2018-04-05,Toronto Maple Leafs,0,Atlantic,Eastern,103,2,162,0.6358024691358025,103,0,96,7
2017-18,2018-04-07,Toronto Maple Leafs,2,Atlantic,Eastern,105,2,164,0.6402439024390244,105,0,97,8
2017-18,2017-10-08,Vancouver Canucks,2,Pacific,Western,2,2,2,1.0,3,-1,2,0
2017-18,2017-10-11,Vancouver Canucks,1,Pacific,Western,3,2,4,0.75,4,-1,3,0
2017-18,2017-10-13,Vancouver Canucks,0,Pacific,Western,3,2,6,0.5,5,-2,4,-1
2017-18,2017-10-15,Vancouver Canucks,0,Pacific,Western,3,2,8,0.375,7,-4,5,-2
2017-18,2017-10-17,Vancouver Canucks,2,Pacific,Western,5,2,10,0.5,8,-3,5,0
2017-18,2017-10-19,Vancouver Canucks,0,Pacific,Western,5,2,12,0.4166666666666667,8,-3,6,-1
2017-18,2017-10-20,Vancouver Canucks,2,Pacific,Western,7,2,14,0.5,8,-1,8,-1
2017-18,2017-10-22,Vancouver Canucks,2,Pacific,Western,9,2,16,0.5625,9,0,8,1
2017-18,2017-10-25,Vancouver Canucks,2,Pacific,Western,11,2,18,0.6111111111111112,11,0,10,1
2017-18,2017-10-27,Vancouver Canucks,2,Pacific,Western,13,2,20,0.65,13,0,10,3
2017-18,2017-10-31,Vancouver Canucks,1,Pacific,Western,14,2,22,0.6363636363636364,14,0,12,2
2017-18,2017-11-02,Vancouver Canucks,0,Pacific,Western,14,2,24,0.5833333333333334,14,0,14,0
2017-18,2017-11-05,Vancouver Canucks,2,Pacific,Western,16,2,26,0.6153846153846154,16,0,16,0
2017-18,2017-11-07,Vancouver Canucks,0,Pacific,Western,16,2,28,0.5714285714285714,16,0,16,0
2017-18,2017-11-08,Vancouver Canucks,2,Pacific,Western,18,2,30,0.6,18,0,16,2
2017-18,2017-11-10,Vancouver Canucks,0,Pacific,Western,18,2,32,0.5625,18,0,17,1
2017-18,2017-11-12,Vancouver Canucks,0,Pacific,Western,18,2,34,0.5294117647058824,18,0,18,0
2017-18,2017-11-15,Vancouver Canucks,2,Pacific,Western,20,2,36,0.5555555555555556,20,0,20,0
2017-18,2017-11-17,Vancouver Canucks,0,Pacific,Western,20,2,38,0.5263157894736842,20,0,20,0
2017-18,2017-11-19,Vancouver Canucks,1,Pacific,Western,21,2,40,0.525,22,-1,21,0
2017-18,2017-11-22,Vancouver Canucks,2,Pacific,Western,23,2,42,0.5476190476190477,24,-1,23,0
2017-18,2017-11-23,Vancouver Canucks,2,Pacific,Western,25,2,44,0.5681818181818182,25,0,23,2
2017-18,2017-11-25,Vancouver Canucks,0,Pacific,Western,25,2,46,0.5434782608695652,25,0,25,0
2017-18,2017-11-26,Vancouver Canucks,1,Pacific,Western,26,2,48,0.5416666666666666,27,-1,26,0
2017-18,2017-11-29,Vancouver Canucks,0,Pacific,Western,26,2,50,0.52,28,-2,27,-1
2017-18,2017-12-01,Vancouver Canucks,2,Pacific,Western,28,2,52,0.5384615384615384,29,-1,28,0
2017-18,2017-12-03,Vancouver Canucks,2,Pacific,Western,30,2,54,0.5555555555555556,30,0,30,0
2017-18,2017-12-06,Vancouver Canucks,2,Pacific,Western,32,2,56,0.5714285714285714,32,0,30,2
2017-18,2017-12-08,Vancouver Canucks,0,Pacific,Western,32,2,58,0.5517241379310345,32,0,32,0
2017-18,2017-12-10,Vancouver Canucks,0,Pacific,Western,32,2,60,0.5333333333333333,34,-2,33,-1
2017-18,2017-12-12,Vancouver Canucks,0,Pacific,Western,32,2,62,0.5161290322580645,35,-3,34,-2
2017-18,2017-12-14,Vancouver Canucks,0,Pacific,Western,32,2,64,0.5,35,-3,35,-3
2017-18,2017-12-16,Vancouver Canucks,2,Pacific,Western,34,2,66,0.5151515151515151,38,-4,37,-3
2017-18,2017-12-18,Vancouver Canucks,0,Pacific,Western,34,2,68,0.5,38,-4,38,-4
2017-18,2017-12-20,Vancouver Canucks,0,Pacific,Western,34,2,70,0.4857142857142857,38,-4,39,-5
2017-18,2017-12-22,Vancouver Canucks,1,Pacific,Western,35,2,72,0.4861111111111111,40,-5,39,-4
2017-18,2017-12-24,Vancouver Canucks,0,Pacific,Western,35,2,74,0.47297297297297297,42,-7,40,-5
2017-18,2017-12-29,Vancouver Canucks,2,Pacific,Western,37,2,76,0.4868421052631579,44,-7,41,-4
2017-18,2017-12-31,Vancouver Canucks,0,Pacific,Western,37,2,78,0.47435897435897434,44,-7,44,-7
2017-18,2018-01-03,Vancouver Canucks,0,Pacific,Western,37,2,80,0.4625,46,-9,46,-9
2017-18,2018-01-07,Vancouver Canucks,1,Pacific,Western,38,2,82,0.4634146341463415,48,-10,47,-9
2017-18,2018-01-08,Vancouver Canucks,0,Pacific,Western,38,2,84,0.4523809523809524,48,-10,47,-9
2017-18,2018-01-10,Vancouver Canucks,0,Pacific,Western,38,2,86,0.4418604651162791,48,-10,48,-10
2017-18,2018-01-13,Vancouver Canucks,2,Pacific,Western,40,2,88,0.45454545454545453,52,-12,50,-10
2017-18,2018-01-15,Vancouver Canucks,2,Pacific,Western,42,2,90,0.4666666666666667,53,-11,53,-11
2017-18,2018-01-21,Vancouver Canucks,0,Pacific,Western,42,2,92,0.45652173913043476,55,-13,55,-13
2017-18,2018-01-22,Vancouver Canucks,0,Pacific,Western,42,2,94,0.44680851063829785,55,-13,55,-13
2017-18,2018-01-24,Vancouver Canucks,2,Pacific,Western,44,2,96,0.4583333333333333,56,-12,57,-13
2017-18,2018-01-26,Vancouver Canucks,0,Pacific,Western,44,2,98,0.4489795918367347,58,-14,57,-13
2017-18,2018-01-31,Vancouver Canucks,2,Pacific,Western,46,2,100,0.46,59,-13,59,-13
2017-18,2018-02-02,Vancouver Canucks,2,Pacific,Western,48,2,102,0.47058823529411764,60,-12,60,-12
2017-18,2018-02-04,Vancouver Canucks,0,Pacific,Western,48,2,104,0.46153846153846156,61,-13,61,-13
2017-18,2018-02-07,Vancouver Canucks,0,Pacific,Western,48,2,106,0.4528301886792453,62,-14,62,-14
2017-18,2018-02-09,Vancouver Canucks,0,Pacific,Western,48,2,108,0.4444444444444444,64,-16,64,-16
2017-18,2018-02-10,Vancouver Canucks,0,Pacific,Western,48,2,110,0.43636363636363634,64,-16,64,-16
2017-18,2018-02-11,Vancouver Canucks,2,Pacific,Western,50,2,112,0.44642857142857145,65,-15,65,-15
2017-18,2018-02-15,Vancouver Canucks,0,Pacific,Western,50,2,114,0.43859649122807015,66,-16,66,-16
2017-18,2018-02-16,Vancouver Canucks,0,Pacific,Western,50,2,116,0.43103448275862066,68,-18,68,-18
2017-18,2018-02-18,Vancouver Canucks,2,Pacific,Western,52,2,118,0.4406779661016949,69,-17,69,-17
2017-18,2018-02-21,Vancouver Canucks,1,Pacific,Western,53,2,120,0.44166666666666665,71,-18,71,-18
2017-18,2018-02-24,Vancouver Canucks,0,Pacific,Western,53,2,122,0.4344262295081967,73,-20,73,-20
2017-18,2018-02-26,Vancouver Canucks,2,Pacific,Western,55,2,124,0.4435483870967742,74,-19,73,-18
2017-18,2018-02-27,Vancouver Canucks,0,Pacific,Western,55,2,126,0.4365079365079365,74,-19,73,-18
2017-18,2018-03-01,Vancouver Canucks,1,Pacific,Western,56,2,128,0.4375,75,-19,74,-18
2017-18,2018-03-03,Vancouver Canucks,1,Pacific,Western,57,2,130,0.43846153846153846,77,-20,76,-19
2017-18,2018-03-06,Vancouver Canucks,2,Pacific,Western,59,2,132,0.44696969696969696,78,-19,77,-18
2017-18,2018-03-08,Vancouver Canucks,0,Pacific,Western,59,2,134,0.44029850746268656,79,-20,77,-18
2017-18,2018-03-10,Vancouver Canucks,0,Pacific,Western,59,2,136,0.4338235294117647,80,-21,80,-21
2017-18,2018-03-12,Vancouver Canucks,0,Pacific,Western,59,2,138,0.427536231884058,80,-21,80,-21
2017-18,2018-03-13,Vancouver Canucks,0,Pacific,Western,59,2,140,0.42142857142857143,81,-22,80,-21
2017-18,2018-03-15,Vancouver Canucks,0,Pacific,Western,59,2,142,0.4154929577464789,82,-23,82,-23
2017-18,2018-03-18,Vancouver Canucks,0,Pacific,Western,59,2,144,0.4097222222222222,84,-25,84,-25
2017-18,2018-03-21,Vancouver Canucks,0,Pacific,Western,59,2,146,0.4041095890410959,87,-28,86,-27
2017-18,2018-03-23,Vancouver Canucks,2,Pacific,Western,61,2,148,0.41216216216216217,89,-28,88,-27
2017-18,2018-03-24,Vancouver Canucks,0,Pacific,Western,61,2,150,0.4066666666666667,89,-28,89,-28
2017-18,2018-03-25,Vancouver Canucks,2,Pacific,Western,63,2,152,0.4144736842105263,89,-26,89,-26
2017-18,2018-03-28,Vancouver Canucks,2,Pacific,Western,65,2,154,0.42207792207792205,91,-26,91,-26
2017-18,2018-03-30,Vancouver Canucks,2,Pacific,Western,67,2,156,0.42948717948717946,93,-26,91,-24
2017-18,2018-03-31,Vancouver Canucks,2,Pacific,Western,69,2,158,0.43670886075949367,94,-25,92,-23
2017-18,2018-04-04,Vancouver Canucks,1,Pacific,Western,70,2,160,0.4375,96,-26,93,-23
2017-18,2018-04-06,Vancouver Canucks,2,Pacific,Western,72,2,162,0.4444444444444444,98,-26,93,-21
2017-18,2018-04-08,Vancouver Canucks,1,Pacific,Western,73,2,164,0.4451219512195122,100,-27,95,-22
2017-18,2017-10-07,Vegas Golden Knights,2,Pacific,Western,2,2,2,1.0,2,0,1,1
2017-18,2017-10-08,Vegas Golden Knights,2,Pacific,Western,4,2,4,1.0,3,1,2,2
2017-18,2017-10-11,Vegas Golden Knights,2,Pacific,Western,6,2,6,1.0,4,2,3,3
2017-18,2017-10-14,Vegas Golden Knights,0,Pacific,Western,6,2,8,0.75,5,1,5,1
2017-18,2017-10-15,Vegas Golden Knights,2,Pacific,Western,8,2,10,0.8,7,1,5,3
2017-18,2017-10-18,Vegas Golden Knights,2,Pacific,Western,10,2,12,0.8333333333333334,8,2,6,4
2017-18,2017-10-22,Vegas Golden Knights,2,Pacific,Western,12,2,14,0.8571428571428571,9,3,8,4
2017-18,2017-10-25,Vegas Golden Knights,2,Pacific,Western,14,2,16,0.875,11,3,10,4
2017-18,2017-10-27,Vegas Golden Knights,2,Pacific,Western,16,2,18,0.8888888888888888,13,3,10,6
2017-18,2017-10-30,Vegas Golden Knights,0,Pacific,Western,16,2,20,0.8,13,3,12,4
2017-18,2017-10-31,Vegas Golden Knights,0,Pacific,Western,16,2,22,0.7272727272727273,14,2,12,4
2017-18,2017-11-02,Vegas Golden Knights,0,Pacific,Western,16,2,24,0.6666666666666666,14,2,14,2
2017-18,2017-11-04,Vegas Golden Knights,2,Pacific,Western,18,2,26,0.6923076923076923,14,4,14,4
2017-18,2017-11-07,Vegas Golden Knights,1,Pacific,Western,19,2,28,0.6785714285714286,16,3,16,3
2017-18,2017-11-08,Vegas Golden Knights,0,Pacific,Western,19,2,30,0.6333333333333333,18,1,16,3
2017-18,2017-11-11,Vegas Golden Knights,2,Pacific,Western,21,2,32,0.65625,18,3,18,3
2017-18,2017-11-15,Vegas Golden Knights,0,Pacific,Western,21,2,34,0.6176470588235294,20,1,20,1
2017-18,2017-11-17,Vegas Golden Knights,2,Pacific,Western,23,2,36,0.6388888888888888,20,3,20,3
2017-18,2017-11-20,Vegas Golden Knights,2,Pacific,Western,25,2,38,0.6578947368421053,22,3,21,4
2017-18,2017-11-23,Vegas Golden Knights,2,Pacific,Western,27,2,40,0.675,25,2,23,4
2017-18,2017-11-24,Vegas Golden Knights,2,Pacific,Western,29,2,42,0.6904761904761905,25,4,25,4
2017-18,2017-11-26,Vegas Golden Knights,2,Pacific,Western,31,2,44,0.7045454545454546,27,4,26,5
2017-18,2017-11-29,Vegas Golden Knights,0,Pacific,Western,31,2,46,0.6739130434782609,28,3,27,4
2017-18,2017-12-01,Vegas Golden Knights,0,Pacific,Western,31,2,48,0.6458333333333334,29,2,28,3
2017-18,2017-12-02,Vegas Golden Knights,0,Pacific,Western,31,2,50,0.62,30,1,29,2
2017-18,2017-12-04,Vegas Golden Knights,2,Pacific,Western,33,2,52,0.6346153846153846,30,3,30,3
2017-18,2017-12-06,Vegas Golden Knights,2,Pacific,Western,35,2,54,0.6481481481481481,32,3,30,5
2017-18,2017-12-09,Vegas Golden Knights,2,Pacific,Western,37,2,56,0.6607142857142857,32,5,32,5
2017-18,2017-12-10,Vegas Golden Knights,2,Pacific,Western,39,2,58,0.6724137931034483,34,5,33,6
2017-18,2017-12-13,Vegas Golden Knights,1,Pacific,Western,40,2,60,0.6666666666666666,35,5,35,5
2017-18,2017-12-15,Vegas Golden Knights,2,Pacific,Western,42,2,62,0.6774193548387096,37,5,37,5
2017-18,2017-12-18,Vegas Golden Knights,2,Pacific,Western,44,2,64,0.6875,38,6,38,6
2017-18,2017-12-20,Vegas Golden Knights,2,Pacific,Western,46,2,66,0.696969696969697,38,8,39,7
2017-18,2017-12-24,Vegas Golden Knights,2,Pacific,Western,48,2,68,0.7058823529411765,42,6,40,8
2017-18,2017-12-28,Vegas Golden Knights,2,Pacific,Western,50,2,70,0.7142857142857143,42,8,41,9
2017-18,2017-12-29,Vegas Golden Knights,2,Pacific,Western,52,2,72,0.7222222222222222,44,8,41,11
2017-18,2017-12-31,Vegas Golden Knights,2,Pacific,Western,54,2,74,0.7297297297297297,44,10,44,10
2017-18,2018-01-03,Vegas Golden Knights,2,Pacific,Western,56,2,76,0.7368421052631579,46,10,46,10
2017-18,2018-01-05,Vegas Golden Knights,0,Pacific,Western,56,2,78,0.717948717948718,47,9,47,9
2017-18,2018-01-06,Vegas Golden Knights,2,Pacific,Western,58,2,80,0.725,48,10,47,11
2017-18,2018-01-08,Vegas Golden Knights,2,Pacific,Western,60,2,82,0.7317073170731707,48,12,47,13
2017-18,2018-01-14,Vegas Golden Knights,1,Pacific,Western,61,2,84,0.7261904761904762,53,8,51,10
2017-18,2018-01-17,Vegas Golden Knights,0,Pacific,Western,61,2,86,0.7093023255813954,54,7,53,8
2017-18,2018-01-19,Vegas Golden Knights,2,Pacific,Western,63,2,88,0.7159090909090909,54,9,53,10
2017-18,2018-01-20,Vegas Golden Knights,1,Pacific,Western,64,2,90,0.7111111111111111,54,10,54,10
2017-18,2018-01-21,Vegas Golden Knights,2,Pacific,Western,66,2,92,0.717391304347826,55,11,55,11
2017-18,2018-01-24,Vegas Golden Knights,2,Pacific,Western,68,2,94,0.723404255319149,56,12,57,11
2017-18,2018-01-26,Vegas Golden Knights,0,Pacific,Western,68,2,96,0.7083333333333334,58,10,57,11
2017-18,2018-01-31,Vegas Golden Knights,2,Pacific,Western,70,2,98,0.7142857142857143,59,11,59,11
2017-18,2018-02-02,Vegas Golden Knights,2,Pacific,Western,72,2,100,0.72,60,12,60,12
2017-18,2018-02-03,Vegas Golden Knights,0,Pacific,Western,72,2,102,0.7058823529411765,60,12,60,12
2017-18,2018-02-04,Vegas Golden Knights,2,Pacific,Western,74,2,104,0.7115384615384616,61,13,61,13
2017-18,2018-02-07,Vegas Golden Knights,0,Pacific,Western,74,2,106,0.6981132075471698,62,12,62,12
2017-18,2018-02-09,Vegas Golden Knights,2,Pacific,Western,76,2,108,0.7037037037037037,64,12,64,12
2017-18,2018-02-12,Vegas Golden Knights,0,Pacific,Western,76,2,110,0.6909090909090909,66,10,66,10
2017-18,2018-02-14,Vegas Golden Knights,2,Pacific,Western,78,2,112,0.6964285714285714,66,12,66,12
2017-18,2018-02-16,Vegas Golden Knights,2,Pacific,Western,80,2,114,0.7017543859649122,68,12,68,12
2017-18,2018-02-18,Vegas Golden Knights,2,Pacific,Western,82,2,116,0.7068965517241379,69,13,69,13
2017-18,2018-02-20,Vegas Golden Knights,0,Pacific,Western,82,2,118,0.6949152542372882,71,11,71,11
2017-18,2018-02-22,Vegas Golden Knights,2,Pacific,Western,84,2,120,0.7,73,11,71,13
2017-18,2018-02-24,Vegas Golden Knights,2,Pacific,Western,86,2,122,0.7049180327868853,73,13,73,13
2017-18,2018-02-27,Vegas Golden Knights,1,Pacific,Western,87,2,124,0.7016129032258065,74,13,73,14
2017-18,2018-02-28,Vegas Golden Knights,0,Pacific,Western,87,2,126,0.6904761904761905,75,12,74,13
2017-18,2018-03-03,Vegas Golden Knights,0,Pacific,Western,87,2,128,0.6796875,77,10,76,11
2017-18,2018-03-04,Vegas Golden Knights,2,Pacific,Western,89,2,130,0.6846153846153846,78,11,77,12
2017-18,2018-03-07,Vegas Golden Knights,0,Pacific,Western,89,2,132,0.6742424242424242,79,10,77,12
2017-18,2018-03-09,Vegas Golden Knights,2,Pacific,Western,91,2,134,0.6791044776119403,80,11,79,12
2017-18,2018-03-10,Vegas Golden Knights,2,Pacific,Western,93,2,136,0.6838235294117647,80,13,80,13
2017-18,2018-03-12,Vegas Golden Knights,2,Pacific,Western,95,2,138,0.6884057971014492,80,15,80,15
2017-18,2018-03-15,Vegas Golden Knights,0,Pacific,Western,95,2,140,0.6785714285714286,82,13,82,13
2017-18,2018-03-17,Vegas Golden Knights,0,Pacific,Western,95,2,142,0.6690140845070423,84,11,84,11
2017-18,2018-03-18,Vegas Golden Knights,2,Pacific,Western,97,2,144,0.6736111111111112,84,13,84,13
2017-18,2018-03-21,Vegas Golden Knights,2,Pacific,Western,99,2,146,0.678082191780822,87,12,86,13
2017-18,2018-03-23,Vegas Golden Knights,1,Pacific,Western,100,2,148,0.6756756756756757,89,11,88,12
2017-18,2018-03-24,Vegas Golden Knights,1,Pacific,Western,101,2,150,0.6733333333333333,89,12,89,12
2017-18,2018-03-27,Vegas Golden Knights,2,Pacific,Western,103,2,152,0.6776315789473685,91,12,90,13
2017-18,2018-03-29,Vegas Golden Knights,0,Pacific,Western,103,2,154,0.6688311688311688,91,12,91,12
2017-18,2018-03-31,Vegas Golden Knights,2,Pacific,Western,105,2,156,0.6730769230769231,94,11,92,13
2017-18,2018-04-01,Vegas Golden Knights,2,Pacific,Western,107,2,158,0.6772151898734177,94,13,92,15
2017-18,2018-04-04,Vegas Golden Knights,2,Pacific,Western,109,2,160,0.68125,96,13,93,16
2017-18,2018-04-06,Vegas Golden Knights,0,Pacific,Western,109,2,162,0.6728395061728395,98,11,93,16
2017-18,2018-04-08,Vegas Golden Knights,0,Pacific,Western,109,2,164,0.6646341463414634,100,9,95,14
2017-18,2017-10-05,Washington Capitals,2,Metropolitan,Eastern,2,2,2,1.0,1,1,1,1
2017-18,2017-10-07,Washington Capitals,2,Metropolitan,Eastern,4,2,4,1.0,2,2,2,2
2017-18,2017-10-09,Washington Capitals,1,Metropolitan,Eastern,5,2,6,0.8333333333333334,4,1,3,2
2017-18,2017-10-11,Washington Capitals,0,Metropolitan,Eastern,5,2,8,0.625,5,0,4,1
2017-18,2017-10-13,Washington Capitals,2,Metropolitan,Eastern,7,2,10,0.7,6,1,4,3
2017-18,2017-10-14,Washington Capitals,0,Metropolitan,Eastern,7,2,12,0.5833333333333334,7,0,6,1
2017-18,2017-10-17,Washington Capitals,0,Metropolitan,Eastern,7,2,14,0.5,8,-1,8,-1
2017-18,2017-10-20,Washington Capitals,2,Metropolitan,Eastern,9,2,16,0.5625,10,-1,9,0
2017-18,2017-10-21,Washington Capitals,0,Metropolitan,Eastern,9,2,18,0.5,10,-1,9,0
2017-18,2017-10-27,Washington Capitals,0,Metropolitan,Eastern,9,2,20,0.45,14,-5,10,-1
2017-18,2017-10-29,Washington Capitals,2,Metropolitan,Eastern,11,2,22,0.5,14,-3,12,-1
2017-18,2017-10-30,Washington Capitals,0,Metropolitan,Eastern,11,2,24,0.4583333333333333,15,-4,13,-2
2017-18,2017-11-02,Washington Capitals,2,Metropolitan,Eastern,13,2,26,0.5,17,-4,13,0
2017-18,2017-11-04,Washington Capitals,2,Metropolitan,Eastern,15,2,28,0.5357142857142857,18,-3,15,0
2017-18,2017-11-07,Washington Capitals,2,Metropolitan,Eastern,17,2,30,0.5666666666666667,18,-1,17,0
2017-18,2017-11-08,Washington Capitals,0,Metropolitan,Eastern,17,2,32,0.53125,19,-2,17,0
2017-18,2017-11-11,Washington Capitals,2,Metropolitan,Eastern,19,2,34,0.5588235294117647,20,-1,19,0
2017-18,2017-11-13,Washington Capitals,2,Metropolitan,Eastern,21,2,36,0.5833333333333334,21,0,20,1
2017-18,2017-11-15,Washington Capitals,0,Metropolitan,Eastern,21,2,38,0.5526315789473685,23,-2,20,1
2017-18,2017-11-17,Washington Capitals,0,Metropolitan,Eastern,21,2,40,0.525,23,-2,21,0
2017-18,2017-11-19,Washington Capitals,2,Metropolitan,Eastern,23,2,42,0.5476190476190477,25,-2,23,0
2017-18,2017-11-21,Washington Capitals,0,Metropolitan,Eastern,23,2,44,0.5227272727272727,25,-2,23,0
2017-18,2017-11-23,Washington Capitals,2,Metropolitan,Eastern,25,2,46,0.5434782608695652,26,-1,24,1
2017-18,2017-11-24,Washington Capitals,2,Metropolitan,Eastern,27,2,48,0.5625,28,-1,24,3
2017-18,2017-11-26,Washington Capitals,2,Metropolitan,Eastern,29,2,50,0.58,30,-1,27,2
2017-18,2017-12-01,Washington Capitals,0,Metropolitan,Eastern,29,2,52,0.5576923076923077,32,-3,28,1
2017-18,2017-12-03,Washington Capitals,2,Metropolitan,Eastern,31,2,54,0.5740740740740741,33,-2,30,1
2017-18,2017-12-05,Washington Capitals,2,Metropolitan,Eastern,33,2,56,0.5892857142857143,34,-1,30,3
2017-18,2017-12-07,Washington Capitals,2,Metropolitan,Eastern,35,2,58,0.603448275862069,35,0,32,3
2017-18,2017-12-09,Washington Capitals,2,Metropolitan,Eastern,37,2,60,0.6166666666666667,36,1,32,5
2017-18,2017-12-12,Washington Capitals,0,Metropolitan,Eastern,37,2,62,0.5967741935483871,37,0,35,2
2017-18,2017-12-13,Washington Capitals,2,Metropolitan,Eastern,39,2,64,0.609375,38,1,35,4
2017-18,2017-12-15,Washington Capitals,2,Metropolitan,Eastern,41,2,66,0.6212121212121212,39,2,35,6
2017-18,2017-12-17,Washington Capitals,2,Metropolitan,Eastern,43,2,68,0.6323529411764706,41,2,37,6
2017-18,2017-12-20,Washington Capitals,2,Metropolitan,Eastern,45,2,70,0.6428571428571429,41,4,39,6
2017-18,2017-12-23,Washington Capitals,1,Metropolitan,Eastern,46,2,72,0.6388888888888888,44,2,42,4
2017-18,2017-12-24,Washington Capitals,0,Metropolitan,Eastern,46,2,74,0.6216216216216216,46,0,42,4
2017-18,2017-12-28,Washington Capitals,1,Metropolitan,Eastern,47,2,76,0.618421052631579,47,0,44,3
2017-18,2017-12-29,Washington Capitals,2,Metropolitan,Eastern,49,2,78,0.6282051282051282,47,2,44,5
2017-18,2017-12-31,Washington Capitals,2,Metropolitan,Eastern,51,2,80,0.6375,47,4,44,7
2017-18,2018-01-03,Washington Capitals,2,Metropolitan,Eastern,53,2,82,0.6463414634146342,49,4,44,9
2017-18,2018-01-07,Washington Capitals,2,Metropolitan,Eastern,55,2,84,0.6547619047619048,51,4,46,9
2017-18,2018-01-10,Washington Capitals,2,Metropolitan,Eastern,57,2,86,0.6627906976744186,52,5,47,10
2017-18,2018-01-12,Washington Capitals,0,Metropolitan,Eastern,57,2,88,0.6477272727272727,52,5,48,9
2017-18,2018-01-13,Washington Capitals,2,Metropolitan,Eastern,59,2,90,0.6555555555555556,52,7,49,10
2017-18,2018-01-19,Washington Capitals,1,Metropolitan,Eastern,60,2,92,0.6521739130434783,55,5,53,7
2017-18,2018-01-20,Washington Capitals,0,Metropolitan,Eastern,60,2,94,0.6382978723404256,55,5,53,7
2017-18,2018-01-21,Washington Capitals,1,Metropolitan,Eastern,61,2,96,0.6354166666666666,55,6,53,8
2017-18,2018-01-26,Washington Capitals,2,Metropolitan,Eastern,63,2,98,0.6428571428571429,57,6,56,7
2017-18,2018-02-01,Washington Capitals,2,Metropolitan,Eastern,65,2,100,0.65,58,7,56,9
2017-18,2018-02-03,Washington Capitals,0,Metropolitan,Eastern,65,2,102,0.6372549019607843,60,5,57,8
2017-18,2018-02-04,Washington Capitals,0,Metropolitan,Eastern,65,2,104,0.625,61,4,57,8
2017-18,2018-02-07,Washington Capitals,2,Metropolitan,Eastern,67,2,106,0.6320754716981132,62,5,58,9
2017-18,2018-02-10,Washington Capitals,2,Metropolitan,Eastern,69,2,108,0.6388888888888888,62,7,60,9
2017-18,2018-02-11,Washington Capitals,1,Metropolitan,Eastern,70,2,110,0.6363636363636364,63,7,61,9
2017-18,2018-02-14,Washington Capitals,1,Metropolitan,Eastern,71,2,112,0.6339285714285714,66,5,63,8
2017-18,2018-02-16,Washington Capitals,2,Metropolitan,Eastern,73,2,114,0.6403508771929824,66,7,63,10
2017-18,2018-02-18,Washington Capitals,0,Metropolitan,Eastern,73,2,116,0.6293103448275862,70,3,64,9
2017-18,2018-02-19,Washington Capitals,2,Metropolitan,Eastern,75,2,118,0.635593220338983,70,5,64,11
2017-18,2018-02-21,Washington Capitals,0,Metropolitan,Eastern,75,2,120,0.625,72,3,65,10
2017-18,2018-02-23,Washington Capitals,0,Metropolitan,Eastern,75,2,122,0.6147540983606558,72,3,65,10
2017-18,2018-02-25,Washington Capitals,2,Metropolitan,Eastern,77,2,124,0.6209677419354839,76,1,67,10
2017-18,2018-02-27,Washington Capitals,0,Metropolitan,Eastern,77,2,126,0.6111111111111112,76,1,69,8
2017-18,2018-02-28,Washington Capitals,2,Metropolitan,Eastern,79,2,128,0.6171875,76,3,69,10
2017-18,2018-03-04,Washington Capitals,2,Metropolitan,Eastern,81,2,130,0.6230769230769231,78,3,70,11
2017-18,2018-03-07,Washington Capitals,0,Metropolitan,Eastern,81,2,132,0.6136363636363636,79,2,73,8
2017-18,2018-03-09,Washington Capitals,0,Metropolitan,Eastern,81,2,134,0.6044776119402985,79,2,75,6
2017-18,2018-03-10,Washington Capitals,2,Metropolitan,Eastern,83,2,136,0.6102941176470589,81,2,76,7
2017-18,2018-03-12,Washington Capitals,2,Metropolitan,Eastern,85,2,138,0.6159420289855072,81,4,78,7
2017-18,2018-03-15,Washington Capitals,2,Metropolitan,Eastern,87,2,140,0.6214285714285714,81,6,80,7
2017-18,2018-03-16,Washington Capitals,2,Metropolitan,Eastern,89,2,142,0.6267605633802817,81,8,80,9
2017-18,2018-03-18,Washington Capitals,0,Metropolitan,Eastern,89,2,144,0.6180555555555556,85,4,82,7
2017-18,2018-03-20,Washington Capitals,2,Metropolitan,Eastern,91,2,146,0.6232876712328768,87,4,82,9
2017-18,2018-03-22,Washington Capitals,2,Metropolitan,Eastern,93,2,148,0.6283783783783784,89,4,82,11
2017-18,2018-03-24,Washington Capitals,2,Metropolitan,Eastern,95,2,150,0.6333333333333333,89,6,86,9
2017-18,2018-03-26,Washington Capitals,2,Metropolitan,Eastern,97,2,152,0.6381578947368421,89,8,86,11
2017-18,2018-03-29,Washington Capitals,2,Metropolitan,Eastern,99,2,154,0.6428571428571429,92,7,89,10
2017-18,2018-03-30,Washington Capitals,0,Metropolitan,Eastern,99,2,156,0.6346153846153846,93,6,89,10
2017-18,2018-04-01,Washington Capitals,2,Metropolitan,Eastern,101,2,158,0.6392405063291139,94,7,93,8
2017-18,2018-04-03,Washington Capitals,2,Metropolitan,Eastern,103,2,160,0.64375,96,7,94,9
2017-18,2018-04-05,Washington Capitals,0,Metropolitan,Eastern,103,2,162,0.6358024691358025,97,6,96,7
2017-18,2018-04-07,Washington Capitals,2,Metropolitan,Eastern,105,2,164,0.6402439024390244,98,7,97,8
2017-18,2017-10-04,Winnipeg Jets,0,Central,Western,0,2,2,0.0,0,0,0,0
2017-18,2017-10-08,Winnipeg Jets,0,Central,Western,0,2,4,0.0,2,-2,2,-2
2017-18,2017-10-10,Winnipeg Jets,2,Central,Western,2,2,6,0.3333333333333333,4,-2,2,0
2017-18,2017-10-13,Winnipeg Jets,2,Central,Western,4,2,8,0.5,6,-2,4,0
2017-18,2017-10-14,Winnipeg Jets,2,Central,Western,6,2,10,0.6,7,-1,5,1
2017-18,2017-10-18,Winnipeg Jets,0,Central,Western,6,2,12,0.5,8,-2,6,0
2017-18,2017-10-21,Winnipeg Jets,2,Central,Western,8,2,14,0.5714285714285714,9,-1,8,0
2017-18,2017-10-26,Winnipeg Jets,1,Central,Western,9,2,16,0.5625,10,-1,10,-1
2017-18,2017-10-27,Winnipeg Jets,1,Central,Western,10,2,18,0.5555555555555556,10,0,10,0
2017-18,2017-10-29,Winnipeg Jets,2,Central,Western,12,2,20,0.6,12,0,12,0
2017-18,2017-11-01,Winnipeg Jets,2,Central,Western,14,2,22,0.6363636363636364,14,0,12,2
2017-18,2017-11-03,Winnipeg Jets,2,Central,Western,16,2,24,0.6666666666666666,14,2,14,2
2017-18,2017-11-04,Winnipeg Jets,1,Central,Western,17,2,26,0.6538461538461539,16,1,14,3
2017-18,2017-11-07,Winnipeg Jets,2,Central,Western,19,2,28,0.6785714285714286,16,3,16,3
2017-18,2017-11-11,Winnipeg Jets,0,Central,Western,19,2,30,0.6333333333333333,18,1,18,1
2017-18,2017-11-12,Winnipeg Jets,2,Central,Western,21,2,32,0.65625,20,1,18,3
2017-18,2017-11-15,Winnipeg Jets,2,Central,Western,23,2,34,0.6764705882352942,22,1,20,3
2017-18,2017-11-17,Winnipeg Jets,2,Central,Western,25,2,36,0.6944444444444444,22,3,20,5
2017-18,2017-11-18,Winnipeg Jets,2,Central,Western,27,2,38,0.7105263157894737,22,5,20,7
2017-18,2017-11-21,Winnipeg Jets,0,Central,Western,27,2,40,0.675,26,1,22,5
2017-18,2017-11-23,Winnipeg Jets,2,Central,Western,29,2,42,0.6904761904761905,28,1,23,6
2017-18,2017-11-24,Winnipeg Jets,2,Central,Western,31,2,44,0.7045454545454546,28,3,25,6
2017-18,2017-11-26,Winnipeg Jets,0,Central,Western,31,2,46,0.6739130434782609,31,0,26,5
2017-18,2017-11-28,Winnipeg Jets,2,Central,Western,33,2,48,0.6875,31,2,26,7
2017-18,2017-11-30,Winnipeg Jets,1,Central,Western,34,2,50,0.68,33,1,27,7
2017-18,2017-12-02,Winnipeg Jets,2,Central,Western,36,2,52,0.6923076923076923,33,3,29,7
2017-18,2017-12-04,Winnipeg Jets,2,Central,Western,38,2,54,0.7037037037037037,35,3,30,8
2017-18,2017-12-06,Winnipeg Jets,0,Central,Western,38,2,56,0.6785714285714286,38,0,30,8
2017-18,2017-12-08,Winnipeg Jets,0,Central,Western,38,2,58,0.6551724137931034,38,0,32,6
2017-18,2017-12-10,Winnipeg Jets,1,Central,Western,39,2,60,0.65,39,0,33,6
2017-18,2017-12-12,Winnipeg Jets,2,Central,Western,41,2,62,0.6612903225806451,40,1,34,7
2017-18,2017-12-15,Winnipeg Jets,0,Central,Western,41,2,64,0.640625,41,0,37,4
2017-18,2017-12-17,Winnipeg Jets,2,Central,Western,43,2,66,0.6515151515151515,43,0,37,6
2017-18,2017-12-17,Winnipeg Jets,0,Central,Western,43,2,68,0.6323529411764706,43,0,37,6
2017-18,2017-12-20,Winnipeg Jets,2,Central,Western,45,2,70,0.6428571428571429,45,0,39,6
2017-18,2017-12-22,Winnipeg Jets,1,Central,Western,46,2,72,0.6388888888888888,46,0,39,7
2017-18,2017-12-23,Winnipeg Jets,0,Central,Western,46,2,74,0.6216216216216216,46,0,39,7
2017-18,2017-12-28,Winnipeg Jets,2,Central,Western,48,2,76,0.631578947368421,48,0,41,7
2017-18,2017-12-30,Winnipeg Jets,2,Central,Western,50,2,78,0.6410256410256411,48,2,43,7
2017-18,2018-01-01,Winnipeg Jets,2,Central,Western,52,2,80,0.65,50,2,44,8
2017-18,2018-01-03,Winnipeg Jets,1,Central,Western,53,2,82,0.6463414634146342,51,2,46,7
2017-18,2018-01-06,Winnipeg Jets,2,Central,Western,55,2,84,0.6547619047619048,52,3,47,8
2017-18,2018-01-07,Winnipeg Jets,2,Central,Western,57,2,86,0.6627906976744186,54,3,47,10
2017-18,2018-01-10,Winnipeg Jets,2,Central,Western,59,2,88,0.6704545454545454,55,4,48,11
2017-18,2018-01-13,Winnipeg Jets,0,Central,Western,59,2,90,0.6555555555555556,55,4,50,9
2017-18,2018-01-14,Winnipeg Jets,0,Central,Western,59,2,92,0.6413043478260869,55,4,51,8
2017-18,2018-01-20,Winnipeg Jets,2,Central,Western,61,2,94,0.648936170212766,59,2,54,7
2017-18,2018-01-22,Winnipeg Jets,2,Central,Western,63,2,96,0.65625,59,4,55,8
2017-18,2018-01-24,Winnipeg Jets,2,Central,Western,65,2,98,0.6632653061224489,61,4,57,8
2017-18,2018-01-26,Winnipeg Jets,1,Central,Western,66,2,100,0.66,63,3,57,9
2017-18,2018-01-31,Winnipeg Jets,2,Central,Western,68,2,102,0.6666666666666666,65,3,59,9
2017-18,2018-02-02,Winnipeg Jets,1,Central,Western,69,2,104,0.6634615384615384,65,4,60,9
2017-18,2018-02-04,Winnipeg Jets,2,Central,Western,71,2,106,0.6698113207547169,67,4,61,10
2017-18,2018-02-07,Winnipeg Jets,2,Central,Western,73,2,108,0.6759259259259259,67,6,62,11
2017-18,2018-02-10,Winnipeg Jets,0,Central,Western,73,2,110,0.6636363636363637,71,2,64,9
2017-18,2018-02-11,Winnipeg Jets,0,Central,Western,73,2,112,0.6517857142857143,71,2,65,8
2017-18,2018-02-14,Winnipeg Jets,2,Central,Western,75,2,114,0.6578947368421053,72,3,66,9
2017-18,2018-02-17,Winnipeg Jets,2,Central,Western,77,2,116,0.6637931034482759,72,5,69,8
2017-18,2018-02-19,Winnipeg Jets,2,Central,Western,79,2,118,0.6694915254237288,72,7,69,10
2017-18,2018-02-21,Winnipeg Jets,0,Central,Western,79,2,120,0.6583333333333333,72,7,71,8
2017-18,2018-02-24,Winnipeg Jets,2,Central,Western,81,2,122,0.6639344262295082,75,6,73,8
2017-18,2018-02-25,Winnipeg Jets,2,Central,Western,83,2,124,0.6693548387096774,75,8,73,10
2017-18,2018-02-28,Winnipeg Jets,0,Central,Western,83,2,126,0.6587301587301587,79,4,74,9
2017-18,2018-03-03,Winnipeg Jets,2,Central,Western,85,2,128,0.6640625,79,6,76,9
2017-18,2018-03-05,Winnipeg Jets,2,Central,Western,87,2,130,0.6692307692307692,81,6,77,10
2017-18,2018-03-07,Winnipeg Jets,2,Central,Western,89,2,132,0.6742424242424242,83,6,77,12
2017-18,2018-03-09,Winnipeg Jets,2,Central,Western,91,2,134,0.6791044776119403,83,8,79,12
2017-18,2018-03-10,Winnipeg Jets,0,Central,Western,91,2,136,0.6691176470588235,85,6,80,11
2017-18,2018-03-12,Winnipeg Jets,1,Central,Western,92,2,138,0.6666666666666666,85,7,80,12
2017-18,2018-03-14,Winnipeg Jets,0,Central,Western,92,2,140,0.6571428571428571,85,7,82,10
2017-18,2018-03-16,Winnipeg Jets,2,Central,Western,94,2,142,0.6619718309859155,85,9,84,10
2017-18,2018-03-18,Winnipeg Jets,2,Central,Western,96,2,144,0.6666666666666666,89,7,84,12
2017-18,2018-03-21,Winnipeg Jets,2,Central,Western,98,2,146,0.6712328767123288,90,8,86,12
2017-18,2018-03-24,Winnipeg Jets,2,Central,Western,100,2,148,0.6756756756756757,90,10,89,11
2017-18,2018-03-25,Winnipeg Jets,2,Central,Western,102,2,150,0.68,93,9,89,13
2017-18,2018-03-28,Winnipeg Jets,2,Central,Western,104,2,152,0.6842105263157895,94,10,91,13
2017-18,2018-03-30,Winnipeg Jets,0,Central,Western,104,2,154,0.6753246753246753,96,8,91,13
2017-18,2018-03-31,Winnipeg Jets,2,Central,Western,106,2,156,0.6794871794871795,96,10,92,14
2017-18,2018-04-02,Winnipeg Jets,2,Central,Western,108,2,158,0.6835443037974683,96,12,93,15
2017-18,2018-04-03,Winnipeg Jets,2,Central,Western,110,2,160,0.6875,98,12,93,17
2017-18,2018-04-06,Winnipeg Jets,2,Central,Western,112,2,162,0.691358024691358,99,13,93,19
2017-18,2018-04-07,Winnipeg Jets,2,Central,Western,114,2,164,0.6951219512195121,99,15,94,20
2018-19,2018-10-04,Anaheim Ducks,2,Pacific,Western,2,2,2,1.0,0,2,0,2
2018-19,2018-10-07,Anaheim Ducks,2,Pacific,Western,4,2,4,1.0,2,2,2,2
2018-19,2018-10-09,Anaheim Ducks,2,Pacific,Western,6,2,6,1.0,3,3,2,4
2018-19,2018-10-11,Anaheim Ducks,1,Pacific,Western,7,2,8,0.875,5,2,4,3
2018-19,2018-10-14,Anaheim Ducks,0,Pacific,Western,7,2,10,0.7,6,1,6,1
2018-19,2018-10-14,Anaheim Ducks,2,Pacific,Western,9,2,12,0.75,6,3,6,3
2018-19,2018-10-18,Anaheim Ducks,2,Pacific,Western,11,2,14,0.7857142857142857,8,3,6,5
2018-19,2018-10-21,Anaheim Ducks,0,Pacific,Western,11,2,16,0.6875,10,1,10,1
2018-19,2018-10-22,Anaheim Ducks,0,Pacific,Western,11,2,18,0.6111111111111112,10,1,10,1
2018-19,2018-10-24,Anaheim Ducks,0,Pacific,Western,11,2,20,0.55,10,1,10,1
2018-19,2018-10-26,Anaheim Ducks,0,Pacific,Western,11,2,22,0.5,11,0,11,0
2018-19,2018-10-29,Anaheim Ducks,1,Pacific,Western,12,2,24,0.5,13,-1,13,-1
2018-19,2018-10-31,Anaheim Ducks,0,Pacific,Western,12,2,26,0.46153846153846156,14,-2,14,-2
2018-19,2018-11-02,Anaheim Ducks,1,Pacific,Western,13,2,28,0.4642857142857143,15,-2,15,-2
2018-19,2018-11-05,Anaheim Ducks,2,Pacific,Western,15,2,30,0.5,17,-2,17,-2
2018-19,2018-11-07,Anaheim Ducks,0,Pacific,Western,15,2,32,0.46875,19,-4,17,-2
2018-19,2018-11-08,Anaheim Ducks,2,Pacific,Western,17,2,34,0.5,19,-2,17,0
2018-19,2018-11-10,Anaheim Ducks,0,Pacific,Western,17,2,36,0.4722222222222222,19,-2,17,0
2018-19,2018-11-13,Anaheim Ducks,2,Pacific,Western,19,2,38,0.5,21,-2,19,0
2018-19,2018-11-15,Anaheim Ducks,0,Pacific,Western,19,2,40,0.475,21,-2,20,-1
2018-19,2018-11-17,Anaheim Ducks,1,Pacific,Western,20,2,42,0.47619047619047616,21,-1,21,-1
2018-19,2018-11-19,Anaheim Ducks,1,Pacific,Western,21,2,44,0.4772727272727273,22,-1,22,-1
2018-19,2018-11-22,Anaheim Ducks,2,Pacific,Western,23,2,46,0.5,23,0,23,0
2018-19,2018-11-23,Anaheim Ducks,2,Pacific,Western,25,2,48,0.5208333333333334,25,0,24,1
2018-19,2018-11-26,Anaheim Ducks,0,Pacific,Western,25,2,50,0.5,25,0,25,0
2018-19,2018-11-28,Anaheim Ducks,2,Pacific,Western,27,2,52,0.5192307692307693,27,0,27,0
2018-19,2018-11-29,Anaheim Ducks,2,Pacific,Western,29,2,54,0.5370370370370371,29,0,28,1
2018-19,2018-12-01,Anaheim Ducks,2,Pacific,Western,31,2,56,0.5535714285714286,29,2,29,2
2018-19,2018-12-02,Anaheim Ducks,2,Pacific,Western,33,2,58,0.5689655172413793,29,4,29,4
2018-19,2018-12-06,Anaheim Ducks,2,Pacific,Western,35,2,60,0.5833333333333334,33,2,32,3
2018-19,2018-12-08,Anaheim Ducks,0,Pacific,Western,35,2,62,0.5645161290322581,33,2,33,2
2018-19,2018-12-10,Anaheim Ducks,2,Pacific,Western,37,2,64,0.578125,35,2,35,2
2018-19,2018-12-13,Anaheim Ducks,2,Pacific,Western,39,2,66,0.5909090909090909,37,2,36,3
2018-19,2018-12-16,Anaheim Ducks,2,Pacific,Western,41,2,68,0.6029411764705882,40,1,39,2
2018-19,2018-12-18,Anaheim Ducks,2,Pacific,Western,43,2,70,0.6142857142857143,41,2,39,4
2018-19,2018-12-19,Anaheim Ducks,0,Pacific,Western,43,2,72,0.5972222222222222,43,0,39,4
2018-19,2018-12-21,Anaheim Ducks,0,Pacific,Western,43,2,74,0.581081081081081,43,0,39,4
2018-19,2018-12-23,Anaheim Ducks,0,Pacific,Western,43,2,76,0.5657894736842105,43,0,39,4
2018-19,2018-12-28,Anaheim Ducks,0,Pacific,Western,43,2,78,0.5512820512820513,46,-3,41,2
2018-19,2018-12-30,Anaheim Ducks,1,Pacific,Western,44,2,80,0.55,48,-4,43,1
2018-19,2019-01-01,Anaheim Ducks,1,Pacific,Western,45,2,82,0.5487804878048781,49,-4,44,1
2018-19,2019-01-05,Anaheim Ducks,0,Pacific,Western,45,2,84,0.5357142857142857,51,-6,45,0
2018-19,2019-01-07,Anaheim Ducks,0,Pacific,Western,45,2,86,0.5232558139534884,53,-8,45,0
2018-19,2019-01-10,Anaheim Ducks,1,Pacific,Western,46,2,88,0.5227272727272727,57,-11,46,0
2018-19,2019-01-12,Anaheim Ducks,0,Pacific,Western,46,2,90,0.5111111111111111,58,-12,47,-1
2018-19,2019-01-13,Anaheim Ducks,1,Pacific,Western,47,2,92,0.5108695652173914,60,-13,47,0
2018-19,2019-01-16,Anaheim Ducks,0,Pacific,Western,47,2,94,0.5,60,-13,49,-2
2018-19,2019-01-18,Anaheim Ducks,2,Pacific,Western,49,2,96,0.5104166666666666,60,-11,49,0
2018-19,2019-01-19,Anaheim Ducks,2,Pacific,Western,51,2,98,0.5204081632653061,60,-9,50,1
2018-19,2019-01-20,Anaheim Ducks,0,Pacific,Western,51,2,100,0.51,62,-11,52,-1
2018-19,2019-01-24,Anaheim Ducks,0,Pacific,Western,51,2,102,0.5,62,-11,52,-1
2018-19,2019-02-03,Anaheim Ducks,0,Pacific,Western,51,2,104,0.49038461538461536,62,-11,54,-3
2018-19,2019-02-05,Anaheim Ducks,0,Pacific,Western,51,2,106,0.4811320754716981,62,-11,54,-3
2018-19,2019-02-06,Anaheim Ducks,0,Pacific,Western,51,2,108,0.4722222222222222,64,-13,54,-3
2018-19,2019-02-08,Anaheim Ducks,0,Pacific,Western,51,2,110,0.4636363636363636,66,-15,55,-4
2018-19,2019-02-09,Anaheim Ducks,0,Pacific,Western,51,2,112,0.45535714285714285,66,-15,57,-6
2018-19,2019-02-14,Anaheim Ducks,2,Pacific,Western,53,2,114,0.4649122807017544,66,-13,59,-6
2018-19,2019-02-16,Anaheim Ducks,0,Pacific,Western,53,2,116,0.45689655172413796,66,-13,60,-7
2018-19,2019-02-18,Anaheim Ducks,2,Pacific,Western,55,2,118,0.4661016949152542,68,-13,60,-5
2018-19,2019-02-20,Anaheim Ducks,2,Pacific,Western,57,2,120,0.475,68,-11,60,-3
2018-19,2019-02-23,Anaheim Ducks,0,Pacific,Western,57,2,122,0.4672131147540984,69,-12,64,-7
2018-19,2019-02-24,Anaheim Ducks,0,Pacific,Western,57,2,124,0.4596774193548387,69,-12,65,-8
2018-19,2019-02-26,Anaheim Ducks,0,Pacific,Western,57,2,126,0.4523809523809524,69,-12,66,-9
2018-19,2019-02-28,Anaheim Ducks,0,Pacific,Western,57,2,128,0.4453125,71,-14,68,-11
2018-19,2019-03-02,Anaheim Ducks,0,Pacific,Western,57,2,130,0.43846153846153846,75,-18,68,-11
2018-19,2019-03-03,Anaheim Ducks,2,Pacific,Western,59,2,132,0.44696969696969696,77,-18,70,-11
2018-19,2019-03-06,Anaheim Ducks,2,Pacific,Western,61,2,134,0.4552238805970149,77,-16,72,-11
2018-19,2019-03-07,Anaheim Ducks,0,Pacific,Western,61,2,136,0.4485294117647059,79,-18,72,-11
2018-19,2019-03-09,Anaheim Ducks,2,Pacific,Western,63,2,138,0.45652173913043476,79,-16,74,-11
2018-19,2019-03-11,Anaheim Ducks,0,Pacific,Western,63,2,140,0.45,81,-18,74,-11
2018-19,2019-03-13,Anaheim Ducks,2,Pacific,Western,65,2,142,0.45774647887323944,81,-16,75,-10
2018-19,2019-03-15,Anaheim Ducks,0,Pacific,Western,65,2,144,0.4513888888888889,81,-16,77,-12
2018-19,2019-03-16,Anaheim Ducks,2,Pacific,Western,67,2,146,0.4589041095890411,83,-16,77,-10
2018-19,2019-03-18,Anaheim Ducks,2,Pacific,Western,69,2,148,0.46621621621621623,85,-16,78,-9
2018-19,2019-03-21,Anaheim Ducks,0,Pacific,Western,69,2,150,0.46,87,-18,78,-9
2018-19,2019-03-23,Anaheim Ducks,2,Pacific,Western,71,2,152,0.46710526315789475,89,-18,80,-9
2018-19,2019-03-24,Anaheim Ducks,1,Pacific,Western,72,2,154,0.4675324675324675,90,-18,80,-8
2018-19,2019-03-27,Anaheim Ducks,2,Pacific,Western,74,2,156,0.47435897435897434,90,-16,81,-7
2018-19,2019-03-30,Anaheim Ducks,0,Pacific,Western,74,2,158,0.46835443037974683,90,-16,85,-11
2018-19,2019-03-31,Anaheim Ducks,2,Pacific,Western,76,2,160,0.475,91,-15,85,-9
2018-19,2019-04-04,Anaheim Ducks,2,Pacific,Western,78,2,162,0.48148148148148145,93,-15,88,-10
2018-19,2019-04-06,Anaheim Ducks,2,Pacific,Western,80,2,164,0.4878048780487805,93,-13,90,-10
2018-19,2018-10-05,Arizona Coyotes,0,Pacific,Western,0,2,2,0.0,0,0,0,0
2018-19,2018-10-07,Arizona Coyotes,0,Pacific,Western,0,2,4,0.0,2,-2,2,-2
2018-19,2018-10-11,Arizona Coyotes,2,Pacific,Western,2,2,6,0.3333333333333333,5,-3,4,-2
2018-19,2018-10-14,Arizona Coyotes,0,Pacific,Western,2,2,8,0.25,6,-4,6,-4
2018-19,2018-10-17,Arizona Coyotes,0,Pacific,Western,2,2,10,0.2,6,-4,6,-4
2018-19,2018-10-19,Arizona Coyotes,2,Pacific,Western,4,2,12,0.3333333333333333,8,-4,7,-3
2018-19,2018-10-20,Arizona Coyotes,0,Pacific,Western,4,2,14,0.2857142857142857,8,-4,8,-4
2018-19,2018-10-23,Arizona Coyotes,2,Pacific,Western,6,2,16,0.375,10,-4,10,-4
2018-19,2018-10-26,Arizona Coyotes,2,Pacific,Western,8,2,18,0.4444444444444444,11,-3,11,-3
2018-19,2018-10-28,Arizona Coyotes,2,Pacific,Western,10,2,20,0.5,12,-2,12,-2
2018-19,2018-10-31,Arizona Coyotes,2,Pacific,Western,12,2,22,0.5454545454545454,14,-2,14,-2
2018-19,2018-11-03,Arizona Coyotes,2,Pacific,Western,14,2,24,0.5833333333333334,17,-3,16,-2
2018-19,2018-11-06,Arizona Coyotes,0,Pacific,Western,14,2,26,0.5384615384615384,17,-3,17,-3
2018-19,2018-11-09,Arizona Coyotes,1,Pacific,Western,15,2,28,0.5357142857142857,19,-4,17,-2
2018-19,2018-11-11,Arizona Coyotes,2,Pacific,Western,17,2,30,0.5666666666666667,19,-2,17,0
2018-19,2018-11-11,Arizona Coyotes,0,Pacific,Western,17,2,32,0.53125,19,-2,17,0
2018-19,2018-11-14,Arizona Coyotes,0,Pacific,Western,17,2,34,0.5,21,-4,19,-2
2018-19,2018-11-16,Arizona Coyotes,2,Pacific,Western,19,2,36,0.5277777777777778,21,-2,20,-1
2018-19,2018-11-18,Arizona Coyotes,0,Pacific,Western,19,2,38,0.5,22,-3,22,-3
2018-19,2018-11-22,Arizona Coyotes,1,Pacific,Western,20,2,40,0.5,23,-3,23,-3
2018-19,2018-11-24,Arizona Coyotes,0,Pacific,Western,20,2,42,0.47619047619047616,25,-5,25,-5
2018-19,2018-11-25,Arizona Coyotes,0,Pacific,Western,20,2,44,0.45454545454545453,25,-5,25,-5
2018-19,2018-11-28,Arizona Coyotes,2,Pacific,Western,22,2,46,0.4782608695652174,27,-5,27,-5
2018-19,2018-11-30,Arizona Coyotes,2,Pacific,Western,24,2,48,0.5,29,-5,29,-5
2018-19,2018-12-02,Arizona Coyotes,2,Pacific,Western,26,2,50,0.52,29,-3,29,-3
2018-19,2018-12-05,Arizona Coyotes,2,Pacific,Western,28,2,52,0.5384615384615384,31,-3,31,-3
2018-19,2018-12-07,Arizona Coyotes,0,Pacific,Western,28,2,54,0.5185185185185185,33,-5,33,-5
2018-19,2018-12-09,Arizona Coyotes,0,Pacific,Western,28,2,56,0.5,35,-7,33,-5
2018-19,2018-12-12,Arizona Coyotes,0,Pacific,Western,28,2,58,0.4827586206896552,37,-9,35,-7
2018-19,2018-12-14,Arizona Coyotes,0,Pacific,Western,28,2,60,0.4666666666666667,39,-11,37,-9
2018-19,2018-12-15,Arizona Coyotes,2,Pacific,Western,30,2,62,0.4838709677419355,39,-9,38,-8
2018-19,2018-12-16,Arizona Coyotes,0,Pacific,Western,30,2,64,0.46875,40,-10,39,-9
2018-19,2018-12-19,Arizona Coyotes,0,Pacific,Western,30,2,66,0.45454545454545453,43,-13,39,-9
2018-19,2018-12-21,Arizona Coyotes,0,Pacific,Western,30,2,68,0.4411764705882353,43,-13,39,-9
2018-19,2018-12-23,Arizona Coyotes,2,Pacific,Western,32,2,70,0.45714285714285713,43,-11,39,-7
2018-19,2018-12-24,Arizona Coyotes,2,Pacific,Western,34,2,72,0.4722222222222222,44,-10,39,-5
2018-19,2018-12-28,Arizona Coyotes,0,Pacific,Western,34,2,74,0.4594594594594595,46,-12,41,-7
2018-19,2018-12-30,Arizona Coyotes,2,Pacific,Western,36,2,76,0.47368421052631576,48,-12,43,-7
2018-19,2018-12-31,Arizona Coyotes,0,Pacific,Western,36,2,78,0.46153846153846156,49,-13,43,-7
2018-19,2019-01-03,Arizona Coyotes,0,Pacific,Western,36,2,80,0.45,51,-15,45,-9
2018-19,2019-01-05,Arizona Coyotes,1,Pacific,Western,37,2,82,0.45121951219512196,51,-14,45,-8
2018-19,2019-01-06,Arizona Coyotes,2,Pacific,Western,39,2,84,0.4642857142857143,53,-14,45,-6
2018-19,2019-01-11,Arizona Coyotes,2,Pacific,Western,41,2,86,0.47674418604651164,58,-17,47,-6
2018-19,2019-01-13,Arizona Coyotes,2,Pacific,Western,43,2,88,0.48863636363636365,60,-17,47,-4
2018-19,2019-01-14,Arizona Coyotes,0,Pacific,Western,43,2,90,0.4777777777777778,60,-17,47,-4
2018-19,2019-01-17,Arizona Coyotes,2,Pacific,Western,45,2,92,0.4891304347826087,60,-15,49,-4
2018-19,2019-01-19,Arizona Coyotes,1,Pacific,Western,46,2,94,0.48936170212765956,60,-14,50,-4
2018-19,2019-01-21,Arizona Coyotes,2,Pacific,Western,48,2,96,0.5,62,-14,52,-4
2018-19,2019-01-23,Arizona Coyotes,2,Pacific,Western,50,2,98,0.5102040816326531,62,-12,52,-2
2018-19,2019-01-24,Arizona Coyotes,0,Pacific,Western,50,2,100,0.5,62,-12,52,-2
2018-19,2019-02-03,Arizona Coyotes,1,Pacific,Western,51,2,102,0.5,62,-11,54,-3
2018-19,2019-02-05,Arizona Coyotes,0,Pacific,Western,51,2,104,0.49038461538461536,62,-11,54,-3
2018-19,2019-02-06,Arizona Coyotes,0,Pacific,Western,51,2,106,0.4811320754716981,64,-13,54,-3
2018-19,2019-02-08,Arizona Coyotes,0,Pacific,Western,51,2,108,0.4722222222222222,66,-15,55,-4
2018-19,2019-02-09,Arizona Coyotes,2,Pacific,Western,53,2,110,0.4818181818181818,66,-13,57,-4
2018-19,2019-02-13,Arizona Coyotes,2,Pacific,Western,55,2,112,0.49107142857142855,66,-11,59,-4
2018-19,2019-02-15,Arizona Coyotes,0,Pacific,Western,55,2,114,0.4824561403508772,66,-11,59,-4
2018-19,2019-02-17,Arizona Coyotes,2,Pacific,Western,57,2,116,0.49137931034482757,68,-11,60,-3
2018-19,2019-02-18,Arizona Coyotes,0,Pacific,Western,57,2,118,0.4830508474576271,68,-11,60,-3
2018-19,2019-02-20,Arizona Coyotes,2,Pacific,Western,59,2,120,0.49166666666666664,68,-9,60,-1
2018-19,2019-02-22,Arizona Coyotes,2,Pacific,Western,61,2,122,0.5,69,-8,62,-1
2018-19,2019-02-25,Arizona Coyotes,2,Pacific,Western,63,2,124,0.5080645161290323,69,-6,66,-3
2018-19,2019-02-27,Arizona Coyotes,2,Pacific,Western,65,2,126,0.5158730158730159,71,-6,67,-2
2018-19,2019-03-01,Arizona Coyotes,2,Pacific,Western,67,2,128,0.5234375,73,-6,68,-1
2018-19,2019-03-03,Arizona Coyotes,2,Pacific,Western,69,2,130,0.5307692307692308,77,-8,70,-1
2018-19,2019-03-06,Arizona Coyotes,0,Pacific,Western,69,2,132,0.5227272727272727,77,-8,72,-3
2018-19,2019-03-08,Arizona Coyotes,2,Pacific,Western,71,2,134,0.5298507462686567,79,-8,74,-3
2018-19,2019-03-10,Arizona Coyotes,2,Pacific,Western,73,2,136,0.5367647058823529,81,-8,74,-1
2018-19,2019-03-12,Arizona Coyotes,0,Pacific,Western,73,2,138,0.5289855072463768,81,-8,74,-1
2018-19,2019-03-13,Arizona Coyotes,2,Pacific,Western,75,2,140,0.5357142857142857,81,-6,75,0
2018-19,2019-03-15,Arizona Coyotes,2,Pacific,Western,77,2,142,0.5422535211267606,81,-4,77,0
2018-19,2019-03-17,Arizona Coyotes,1,Pacific,Western,78,2,144,0.5416666666666666,83,-5,78,0
2018-19,2019-03-18,Arizona Coyotes,0,Pacific,Western,78,2,146,0.5342465753424658,85,-7,78,0
2018-19,2019-03-21,Arizona Coyotes,0,Pacific,Western,78,2,148,0.527027027027027,87,-9,78,0
2018-19,2019-03-23,Arizona Coyotes,1,Pacific,Western,79,2,150,0.5266666666666666,89,-10,80,-1
2018-19,2019-03-24,Arizona Coyotes,0,Pacific,Western,79,2,152,0.5197368421052632,90,-11,80,-1
2018-19,2019-03-27,Arizona Coyotes,2,Pacific,Western,81,2,154,0.525974025974026,90,-9,81,0
2018-19,2019-03-30,Arizona Coyotes,1,Pacific,Western,82,2,156,0.5256410256410257,90,-8,85,-3
2018-19,2019-03-31,Arizona Coyotes,2,Pacific,Western,84,2,158,0.5316455696202531,91,-7,85,-1
2018-19,2019-04-03,Arizona Coyotes,0,Pacific,Western,84,2,160,0.525,93,-9,88,-4
2018-19,2019-04-05,Arizona Coyotes,2,Pacific,Western,86,2,162,0.5308641975308642,93,-7,90,-4
2018-19,2019-04-07,Arizona Coyotes,0,Pacific,Western,86,2,164,0.524390243902439,93,-7,90,-4
2018-19,2018-10-03,Boston Bruins,0,Atlantic,Eastern,0,2,2,0.0,0,0,0,0
2018-19,2018-10-04,Boston Bruins,2,Atlantic,Eastern,2,2,4,0.5,1,1,1,1
2018-19,2018-10-08,Boston Bruins,2,Atlantic,Eastern,4,2,6,0.6666666666666666,4,0,3,1
2018-19,2018-10-11,Boston Bruins,2,Atlantic,Eastern,6,2,8,0.75,4,2,4,2
2018-19,2018-10-13,Boston Bruins,2,Atlantic,Eastern,8,2,10,0.8,5,3,5,3
2018-19,2018-10-18,Boston Bruins,0,Atlantic,Eastern,8,2,12,0.6666666666666666,8,0,8,0
2018-19,2018-10-19,Boston Bruins,1,Atlantic,Eastern,9,2,14,0.6428571428571429,9,0,8,1
2018-19,2018-10-21,Boston Bruins,1,Atlantic,Eastern,10,2,16,0.625,10,0,8,2
2018-19,2018-10-23,Boston Bruins,2,Atlantic,Eastern,12,2,18,0.6666666666666666,12,0,9,3
2018-19,2018-10-25,Boston Bruins,2,Atlantic,Eastern,14,2,20,0.7,13,1,10,4
2018-19,2018-10-27,Boston Bruins,0,Atlantic,Eastern,14,2,22,0.6363636363636364,14,0,12,2
2018-19,2018-10-30,Boston Bruins,2,Atlantic,Eastern,16,2,24,0.6666666666666666,16,0,13,3
2018-19,2018-11-04,Boston Bruins,0,Atlantic,Eastern,16,2,26,0.6153846153846154,16,0,14,2
2018-19,2018-11-06,Boston Bruins,2,Atlantic,Eastern,18,2,28,0.6428571428571429,18,0,15,3
2018-19,2018-11-09,Boston Bruins,0,Atlantic,Eastern,18,2,30,0.6,19,-1,17,1
2018-19,2018-11-11,Boston Bruins,2,Atlantic,Eastern,20,2,32,0.625,21,-1,18,2
2018-19,2018-11-12,Boston Bruins,2,Atlantic,Eastern,22,2,34,0.6470588235294118,22,0,18,4
2018-19,2018-11-15,Boston Bruins,0,Atlantic,Eastern,22,2,36,0.6111111111111112,22,0,20,2
2018-19,2018-11-17,Boston Bruins,1,Atlantic,Eastern,23,2,38,0.6052631578947368,24,-1,21,2
2018-19,2018-11-18,Boston Bruins,2,Atlantic,Eastern,25,2,40,0.625,26,-1,22,3
2018-19,2018-11-22,Boston Bruins,1,Atlantic,Eastern,26,2,42,0.6190476190476191,30,-4,25,1
2018-19,2018-11-24,Boston Bruins,2,Atlantic,Eastern,28,2,44,0.6363636363636364,30,-2,26,2
2018-19,2018-11-25,Boston Bruins,2,Atlantic,Eastern,30,2,46,0.6521739130434783,32,-2,26,4
2018-19,2018-11-27,Boston Bruins,0,Atlantic,Eastern,30,2,48,0.625,34,-4,27,3
2018-19,2018-11-30,Boston Bruins,2,Atlantic,Eastern,32,2,50,0.64,36,-4,27,5
2018-19,2018-12-02,Boston Bruins,0,Atlantic,Eastern,32,2,52,0.6153846153846154,37,-5,29,3
2018-19,2018-12-05,Boston Bruins,0,Atlantic,Eastern,32,2,54,0.5925925925925926,38,-6,29,3
2018-19,2018-12-07,Boston Bruins,0,Atlantic,Eastern,32,2,56,0.5714285714285714,38,-6,30,2
2018-19,2018-12-09,Boston Bruins,2,Atlantic,Eastern,34,2,58,0.5862068965517241,38,-4,31,3
2018-19,2018-12-09,Boston Bruins,2,Atlantic,Eastern,36,2,60,0.6,38,-2,31,5
2018-19,2018-12-12,Boston Bruins,2,Atlantic,Eastern,38,2,62,0.6129032258064516,40,-2,32,6
2018-19,2018-12-15,Boston Bruins,0,Atlantic,Eastern,38,2,64,0.59375,42,-4,34,4
2018-19,2018-12-16,Boston Bruins,0,Atlantic,Eastern,38,2,66,0.5757575757575758,44,-6,36,2
2018-19,2018-12-18,Boston Bruins,2,Atlantic,Eastern,40,2,68,0.5882352941176471,43,-3,36,4
2018-19,2018-12-21,Boston Bruins,2,Atlantic,Eastern,42,2,70,0.6,45,-3,40,2
2018-19,2018-12-22,Boston Bruins,2,Atlantic,Eastern,44,2,72,0.6111111111111112,45,-1,40,4
2018-19,2018-12-23,Boston Bruins,0,Atlantic,Eastern,44,2,74,0.5945945945945946,47,-3,42,2
2018-19,2018-12-28,Boston Bruins,0,Atlantic,Eastern,44,2,76,0.5789473684210527,47,-3,43,1
2018-19,2018-12-30,Boston Bruins,2,Atlantic,Eastern,46,2,78,0.5897435897435898,48,-2,45,1
2018-19,2019-01-01,Boston Bruins,2,Atlantic,Eastern,48,2,80,0.6,48,0,47,1
2018-19,2019-01-04,Boston Bruins,2,Atlantic,Eastern,50,2,82,0.6097560975609756,50,0,49,1
2018-19,2019-01-06,Boston Bruins,2,Atlantic,Eastern,52,2,84,0.6190476190476191,52,0,50,2
2018-19,2019-01-09,Boston Bruins,2,Atlantic,Eastern,54,2,86,0.627906976744186,54,0,51,3
2018-19,2019-01-11,Boston Bruins,0,Atlantic,Eastern,54,2,88,0.6136363636363636,54,0,52,2
2018-19,2019-01-13,Boston Bruins,2,Atlantic,Eastern,56,2,90,0.6222222222222222,56,0,52,4
2018-19,2019-01-15,Boston Bruins,1,Atlantic,Eastern,57,2,92,0.6195652173913043,57,0,54,3
2018-19,2019-01-17,Boston Bruins,0,Atlantic,Eastern,57,2,94,0.6063829787234043,57,0,56,1
2018-19,2019-01-18,Boston Bruins,2,Atlantic,Eastern,59,2,96,0.6145833333333334,59,0,56,3
2018-19,2019-01-20,Boston Bruins,0,Atlantic,Eastern,59,2,98,0.6020408163265306,59,0,58,1
2018-19,2019-01-30,Boston Bruins,1,Atlantic,Eastern,60,2,100,0.6,61,-1,58,2
2018-19,2019-02-01,Boston Bruins,1,Atlantic,Eastern,61,2,102,0.5980392156862745,61,0,59,2
2018-19,2019-02-03,Boston Bruins,2,Atlantic,Eastern,63,2,104,0.6057692307692307,64,-1,59,4
2018-19,2019-02-06,Boston Bruins,2,Atlantic,Eastern,65,2,106,0.6132075471698113,66,-1,61,4
2018-19,2019-02-07,Boston Bruins,1,Atlantic,Eastern,66,2,108,0.6111111111111112,66,0,61,5
2018-19,2019-02-09,Boston Bruins,2,Atlantic,Eastern,68,2,110,0.6181818181818182,68,0,63,5
2018-19,2019-02-10,Boston Bruins,2,Atlantic,Eastern,70,2,112,0.625,70,0,63,7
2018-19,2019-02-13,Boston Bruins,2,Atlantic,Eastern,72,2,114,0.631578947368421,72,0,65,7
2018-19,2019-02-16,Boston Bruins,2,Atlantic,Eastern,74,2,116,0.6379310344827587,74,0,67,7
2018-19,2019-02-17,Boston Bruins,2,Atlantic,Eastern,76,2,118,0.6440677966101694,75,1,69,7
2018-19,2019-02-19,Boston Bruins,2,Atlantic,Eastern,78,2,120,0.65,75,3,69,9
2018-19,2019-02-21,Boston Bruins,2,Atlantic,Eastern,80,2,122,0.6557377049180327,76,4,69,11
2018-19,2019-02-23,Boston Bruins,1,Atlantic,Eastern,81,2,124,0.6532258064516129,76,5,71,10
2018-19,2019-02-27,Boston Bruins,2,Atlantic,Eastern,83,2,126,0.6587301587301587,80,3,74,9
2018-19,2019-03-01,Boston Bruins,2,Atlantic,Eastern,85,2,128,0.6640625,82,3,74,11
2018-19,2019-03-03,Boston Bruins,2,Atlantic,Eastern,87,2,130,0.6692307692307692,84,3,77,10
2018-19,2019-03-06,Boston Bruins,2,Atlantic,Eastern,89,2,132,0.6742424242424242,86,3,79,10
2018-19,2019-03-08,Boston Bruins,2,Atlantic,Eastern,91,2,134,0.6791044776119403,87,4,79,12
2018-19,2019-03-10,Boston Bruins,2,Atlantic,Eastern,93,2,136,0.6838235294117647,89,4,79,14
2018-19,2019-03-10,Boston Bruins,0,Atlantic,Eastern,93,2,138,0.6739130434782609,89,4,79,14
2018-19,2019-03-12,Boston Bruins,0,Atlantic,Eastern,93,2,140,0.6642857142857143,89,4,81,12
2018-19,2019-03-15,Boston Bruins,0,Atlantic,Eastern,93,2,142,0.6549295774647887,91,2,83,10
2018-19,2019-03-16,Boston Bruins,2,Atlantic,Eastern,95,2,144,0.6597222222222222,91,4,84,11
2018-19,2019-03-19,Boston Bruins,2,Atlantic,Eastern,97,2,146,0.6643835616438356,91,6,84,13
2018-19,2019-03-21,Boston Bruins,2,Atlantic,Eastern,99,2,148,0.668918918918919,93,6,85,14
2018-19,2019-03-23,Boston Bruins,2,Atlantic,Eastern,101,2,150,0.6733333333333333,94,7,87,14
2018-19,2019-03-25,Boston Bruins,0,Atlantic,Eastern,101,2,152,0.6644736842105263,96,5,88,13
2018-19,2019-03-27,Boston Bruins,2,Atlantic,Eastern,103,2,154,0.6688311688311688,97,6,90,13
2018-19,2019-03-30,Boston Bruins,0,Atlantic,Eastern,103,2,156,0.6602564102564102,97,6,92,11
2018-19,2019-03-31,Boston Bruins,0,Atlantic,Eastern,103,2,158,0.6518987341772152,97,6,92,11
2018-19,2019-04-02,Boston Bruins,2,Atlantic,Eastern,105,2,160,0.65625,99,6,94,11
2018-19,2019-04-05,Boston Bruins,2,Atlantic,Eastern,107,2,162,0.6604938271604939,99,8,96,11
2018-19,2019-04-06,Boston Bruins,0,Atlantic,Eastern,107,2,164,0.6524390243902439,100,7,98,9
2018-19,2018-10-04,Buffalo Sabres,0,Atlantic,Eastern,0,2,2,0.0,1,-1,1,-1
2018-19,2018-10-06,Buffalo Sabres,2,Atlantic,Eastern,2,2,4,0.5,2,0,2,0
2018-19,2018-10-08,Buffalo Sabres,2,Atlantic,Eastern,4,2,6,0.6666666666666666,4,0,3,1
2018-19,2018-10-11,Buffalo Sabres,0,Atlantic,Eastern,4,2,8,0.5,4,0,4,0
2018-19,2018-10-14,Buffalo Sabres,2,Atlantic,Eastern,6,2,10,0.6,6,0,5,1
2018-19,2018-10-17,Buffalo Sabres,0,Atlantic,Eastern,6,2,12,0.5,8,-2,6,0
2018-19,2018-10-19,Buffalo Sabres,0,Atlantic,Eastern,6,2,14,0.42857142857142855,9,-3,8,-2
2018-19,2018-10-20,Buffalo Sabres,2,Atlantic,Eastern,8,2,16,0.5,9,-1,8,0
2018-19,2018-10-22,Buffalo Sabres,2,Atlantic,Eastern,10,2,18,0.5555555555555556,10,0,8,2
2018-19,2018-10-25,Buffalo Sabres,2,Atlantic,Eastern,12,2,20,0.6,13,-1,10,2
2018-19,2018-10-27,Buffalo Sabres,1,Atlantic,Eastern,13,2,22,0.5909090909090909,14,-1,12,1
2018-19,2018-10-30,Buffalo Sabres,1,Atlantic,Eastern,14,2,24,0.5833333333333334,16,-2,13,1
2018-19,2018-11-01,Buffalo Sabres,0,Atlantic,Eastern,14,2,26,0.5384615384615384,16,-2,13,1
2018-19,2018-11-03,Buffalo Sabres,2,Atlantic,Eastern,16,2,28,0.5714285714285714,16,0,14,2
2018-19,2018-11-05,Buffalo Sabres,0,Atlantic,Eastern,16,2,30,0.5333333333333333,16,0,15,1
2018-19,2018-11-09,Buffalo Sabres,2,Atlantic,Eastern,18,2,32,0.5625,19,-1,17,1
2018-19,2018-11-10,Buffalo Sabres,2,Atlantic,Eastern,20,2,34,0.5882352941176471,20,0,18,2
2018-19,2018-11-14,Buffalo Sabres,2,Atlantic,Eastern,22,2,36,0.6111111111111112,22,0,20,2
2018-19,2018-11-17,Buffalo Sabres,2,Atlantic,Eastern,24,2,38,0.631578947368421,24,0,21,3
2018-19,2018-11-17,Buffalo Sabres,2,Atlantic,Eastern,26,2,40,0.65,24,2,21,5
2018-19,2018-11-20,Buffalo Sabres,2,Atlantic,Eastern,28,2,42,0.6666666666666666,28,0,23,5
2018-19,2018-11-22,Buffalo Sabres,2,Atlantic,Eastern,30,2,44,0.6818181818181818,30,0,25,5
2018-19,2018-11-23,Buffalo Sabres,2,Atlantic,Eastern,32,2,46,0.6956521739130435,30,2,26,6
2018-19,2018-11-25,Buffalo Sabres,2,Atlantic,Eastern,34,2,48,0.7083333333333334,32,2,26,8
2018-19,2018-11-28,Buffalo Sabres,2,Atlantic,Eastern,36,2,50,0.72,34,2,27,9
2018-19,2018-11-30,Buffalo Sabres,0,Atlantic,Eastern,36,2,52,0.6923076923076923,36,0,27,9
2018-19,2018-12-01,Buffalo Sabres,1,Atlantic,Eastern,37,2,54,0.6851851851851852,36,1,28,9
2018-19,2018-12-04,Buffalo Sabres,0,Atlantic,Eastern,37,2,56,0.6607142857142857,37,0,29,8
2018-19,2018-12-05,Buffalo Sabres,1,Atlantic,Eastern,38,2,58,0.6551724137931034,38,0,29,9
2018-19,2018-12-08,Buffalo Sabres,0,Atlantic,Eastern,38,2,60,0.6333333333333333,38,0,30,8
2018-19,2018-12-12,Buffalo Sabres,2,Atlantic,Eastern,40,2,62,0.6451612903225806,40,0,32,8
2018-19,2018-12-14,Buffalo Sabres,2,Atlantic,Eastern,42,2,64,0.65625,42,0,32,10
2018-19,2018-12-16,Buffalo Sabres,1,Atlantic,Eastern,43,2,66,0.6515151515151515,44,-1,36,7
2018-19,2018-12-16,Buffalo Sabres,2,Atlantic,Eastern,45,2,68,0.6617647058823529,44,1,36,9
2018-19,2018-12-19,Buffalo Sabres,0,Atlantic,Eastern,45,2,70,0.6428571428571429,45,0,38,7
2018-19,2018-12-22,Buffalo Sabres,0,Atlantic,Eastern,45,2,72,0.625,45,0,40,5
2018-19,2018-12-23,Buffalo Sabres,2,Atlantic,Eastern,47,2,74,0.6351351351351351,47,0,42,5
2018-19,2018-12-28,Buffalo Sabres,0,Atlantic,Eastern,47,2,76,0.618421052631579,47,0,43,4
2018-19,2018-12-30,Buffalo Sabres,1,Atlantic,Eastern,48,2,78,0.6153846153846154,48,0,45,3
2018-19,2018-12-31,Buffalo Sabres,0,Atlantic,Eastern,48,2,80,0.6,48,0,46,2
2018-19,2019-01-04,Buffalo Sabres,2,Atlantic,Eastern,50,2,82,0.6097560975609756,50,0,49,1
2018-19,2019-01-06,Buffalo Sabres,0,Atlantic,Eastern,50,2,84,0.5952380952380952,52,-2,50,0
2018-19,2019-01-09,Buffalo Sabres,2,Atlantic,Eastern,52,2,86,0.6046511627906976,54,-2,51,1
2018-19,2019-01-12,Buffalo Sabres,0,Atlantic,Eastern,52,2,88,0.5909090909090909,54,-2,52,0
2018-19,2019-01-13,Buffalo Sabres,0,Atlantic,Eastern,52,2,90,0.5777777777777777,56,-4,52,0
2018-19,2019-01-15,Buffalo Sabres,0,Atlantic,Eastern,52,2,92,0.5652173913043478,57,-5,54,-2
2018-19,2019-01-17,Buffalo Sabres,2,Atlantic,Eastern,54,2,94,0.574468085106383,57,-3,56,-2
2018-19,2019-01-19,Buffalo Sabres,0,Atlantic,Eastern,54,2,96,0.5625,59,-5,58,-4
2018-19,2019-01-30,Buffalo Sabres,2,Atlantic,Eastern,56,2,98,0.5714285714285714,61,-5,58,-2
2018-19,2019-01-31,Buffalo Sabres,0,Atlantic,Eastern,56,2,100,0.56,61,-5,59,-3
2018-19,2019-02-02,Buffalo Sabres,0,Atlantic,Eastern,56,2,102,0.5490196078431373,62,-6,59,-3
2018-19,2019-02-06,Buffalo Sabres,2,Atlantic,Eastern,58,2,104,0.5576923076923077,66,-8,61,-3
2018-19,2019-02-08,Buffalo Sabres,1,Atlantic,Eastern,59,2,106,0.5566037735849056,68,-9,63,-4
2018-19,2019-02-09,Buffalo Sabres,2,Atlantic,Eastern,61,2,108,0.5648148148148148,68,-7,63,-2
2018-19,2019-02-10,Buffalo Sabres,0,Atlantic,Eastern,61,2,110,0.5545454545454546,70,-9,63,-2
2018-19,2019-02-13,Buffalo Sabres,2,Atlantic,Eastern,63,2,112,0.5625,72,-9,65,-2
2018-19,2019-02-16,Buffalo Sabres,0,Atlantic,Eastern,63,2,114,0.5526315789473685,74,-11,67,-4
2018-19,2019-02-17,Buffalo Sabres,0,Atlantic,Eastern,63,2,116,0.5431034482758621,75,-12,69,-6
2018-19,2019-02-20,Buffalo Sabres,0,Atlantic,Eastern,63,2,118,0.5338983050847458,76,-13,69,-6
2018-19,2019-02-22,Buffalo Sabres,1,Atlantic,Eastern,64,2,120,0.5333333333333333,76,-12,70,-6
2018-19,2019-02-23,Buffalo Sabres,2,Atlantic,Eastern,66,2,122,0.5409836065573771,76,-10,71,-5
2018-19,2019-02-26,Buffalo Sabres,0,Atlantic,Eastern,66,2,124,0.532258064516129,80,-14,72,-6
2018-19,2019-02-27,Buffalo Sabres,0,Atlantic,Eastern,66,2,126,0.5238095238095238,80,-14,74,-8
2018-19,2019-03-02,Buffalo Sabres,2,Atlantic,Eastern,68,2,128,0.53125,82,-14,75,-7
2018-19,2019-03-03,Buffalo Sabres,0,Atlantic,Eastern,68,2,130,0.5230769230769231,84,-16,77,-9
2018-19,2019-03-05,Buffalo Sabres,0,Atlantic,Eastern,68,2,132,0.5151515151515151,86,-18,77,-9
2018-19,2019-03-08,Buffalo Sabres,1,Atlantic,Eastern,69,2,134,0.5149253731343284,87,-18,79,-10
2018-19,2019-03-09,Buffalo Sabres,0,Atlantic,Eastern,69,2,136,0.5073529411764706,87,-18,79,-10
2018-19,2019-03-12,Buffalo Sabres,0,Atlantic,Eastern,69,2,138,0.5,89,-20,81,-12
2018-19,2019-03-14,Buffalo Sabres,0,Atlantic,Eastern,69,2,140,0.4928571428571429,89,-20,81,-12
2018-19,2019-03-16,Buffalo Sabres,0,Atlantic,Eastern,69,2,142,0.4859154929577465,91,-22,84,-15
2018-19,2019-03-17,Buffalo Sabres,2,Atlantic,Eastern,71,2,144,0.4930555555555556,91,-20,84,-13
2018-19,2019-03-20,Buffalo Sabres,0,Atlantic,Eastern,71,2,146,0.4863013698630137,93,-22,84,-13
2018-19,2019-03-23,Buffalo Sabres,0,Atlantic,Eastern,71,2,148,0.4797297297297297,94,-23,87,-16
2018-19,2019-03-25,Buffalo Sabres,0,Atlantic,Eastern,71,2,150,0.47333333333333333,96,-25,88,-17
2018-19,2019-03-26,Buffalo Sabres,0,Atlantic,Eastern,71,2,152,0.46710526315789475,96,-25,90,-19
2018-19,2019-03-28,Buffalo Sabres,1,Atlantic,Eastern,72,2,154,0.4675324675324675,97,-25,90,-18
2018-19,2019-03-30,Buffalo Sabres,0,Atlantic,Eastern,72,2,156,0.46153846153846156,97,-25,92,-20
2018-19,2019-03-31,Buffalo Sabres,0,Atlantic,Eastern,72,2,158,0.45569620253164556,97,-25,92,-20
2018-19,2019-04-02,Buffalo Sabres,0,Atlantic,Eastern,72,2,160,0.45,99,-27,94,-22
2018-19,2019-04-04,Buffalo Sabres,2,Atlantic,Eastern,74,2,162,0.4567901234567901,99,-25,94,-20
2018-19,2019-04-06,Buffalo Sabres,2,Atlantic,Eastern,76,2,164,0.4634146341463415,100,-24,98,-22
2018-19,2018-10-04,Calgary Flames,0,Pacific,Western,0,2,2,0.0,0,0,0,0
2018-19,2018-10-07,Calgary Flames,2,Pacific,Western,2,2,4,0.5,2,0,2,0
2018-19,2018-10-10,Calgary Flames,2,Pacific,Western,4,2,6,0.6666666666666666,4,0,4,0
2018-19,2018-10-12,Calgary Flames,0,Pacific,Western,4,2,8,0.5,5,-1,4,0
2018-19,2018-10-14,Calgary Flames,2,Pacific,Western,6,2,10,0.6,6,0,6,0
2018-19,2018-10-18,Calgary Flames,2,Pacific,Western,8,2,12,0.6666666666666666,8,0,6,2
2018-19,2018-10-20,Calgary Flames,0,Pacific,Western,8,2,14,0.5714285714285714,8,0,8,0
2018-19,2018-10-21,Calgary Flames,2,Pacific,Western,10,2,16,0.625,10,0,10,0
2018-19,2018-10-23,Calgary Flames,0,Pacific,Western,10,2,18,0.5555555555555556,10,0,10,0
2018-19,2018-10-26,Calgary Flames,0,Pacific,Western,10,2,20,0.5,11,-1,11,-1
2018-19,2018-10-27,Calgary Flames,1,Pacific,Western,11,2,22,0.5,11,0,11,0
2018-19,2018-10-29,Calgary Flames,2,Pacific,Western,13,2,24,0.5416666666666666,13,0,13,0
2018-19,2018-10-30,Calgary Flames,2,Pacific,Western,15,2,26,0.5769230769230769,14,1,14,1
2018-19,2018-11-02,Calgary Flames,2,Pacific,Western,17,2,28,0.6071428571428571,15,2,15,2
2018-19,2018-11-04,Calgary Flames,2,Pacific,Western,19,2,30,0.6333333333333333,17,2,17,2
2018-19,2018-11-08,Calgary Flames,0,Pacific,Western,19,2,32,0.59375,19,0,17,2
2018-19,2018-11-11,Calgary Flames,2,Pacific,Western,21,2,34,0.6176470588235294,19,2,17,4
2018-19,2018-11-12,Calgary Flames,0,Pacific,Western,21,2,36,0.5833333333333334,21,0,19,2
2018-19,2018-11-16,Calgary Flames,0,Pacific,Western,21,2,38,0.5526315789473685,21,0,20,1
2018-19,2018-11-18,Calgary Flames,2,Pacific,Western,23,2,40,0.575,22,1,22,1
2018-19,2018-11-20,Calgary Flames,2,Pacific,Western,25,2,42,0.5952380952380952,22,3,22,3
2018-19,2018-11-22,Calgary Flames,2,Pacific,Western,27,2,44,0.6136363636363636,23,4,23,4
2018-19,2018-11-23,Calgary Flames,0,Pacific,Western,27,2,46,0.5869565217391305,25,2,24,3
2018-19,2018-11-25,Calgary Flames,2,Pacific,Western,29,2,48,0.6041666666666666,25,4,25,4
2018-19,2018-11-29,Calgary Flames,1,Pacific,Western,30,2,50,0.6,29,1,28,2
2018-19,2018-12-01,Calgary Flames,2,Pacific,Western,32,2,52,0.6153846153846154,29,3,29,3
2018-19,2018-12-03,Calgary Flames,2,Pacific,Western,34,2,54,0.6296296296296297,31,3,30,4
2018-19,2018-12-05,Calgary Flames,2,Pacific,Western,36,2,56,0.6428571428571429,31,5,31,5
2018-19,2018-12-07,Calgary Flames,2,Pacific,Western,38,2,58,0.6551724137931034,33,5,33,5
2018-19,2018-12-09,Calgary Flames,2,Pacific,Western,40,2,60,0.6666666666666666,35,5,33,7
2018-19,2018-12-10,Calgary Flames,0,Pacific,Western,40,2,62,0.6451612903225806,35,5,35,5
2018-19,2018-12-13,Calgary Flames,2,Pacific,Western,42,2,64,0.65625,37,5,36,6
2018-19,2018-12-15,Calgary Flames,2,Pacific,Western,44,2,66,0.6666666666666666,39,5,38,6
2018-19,2018-12-16,Calgary Flames,2,Pacific,Western,46,2,68,0.6764705882352942,40,6,39,7
2018-19,2018-12-19,Calgary Flames,0,Pacific,Western,46,2,70,0.6571428571428571,43,3,39,7
2018-19,2018-12-21,Calgary Flames,1,Pacific,Western,47,2,72,0.6527777777777778,43,4,39,8
2018-19,2018-12-22,Calgary Flames,0,Pacific,Western,47,2,74,0.6351351351351351,43,4,39,8
2018-19,2018-12-28,Calgary Flames,2,Pacific,Western,49,2,76,0.6447368421052632,46,3,41,8
2018-19,2018-12-30,Calgary Flames,1,Pacific,Western,50,2,78,0.6410256410256411,48,2,43,7
2018-19,2019-01-01,Calgary Flames,2,Pacific,Western,52,2,80,0.65,49,3,44,8
2018-19,2019-01-03,Calgary Flames,2,Pacific,Western,54,2,82,0.6585365853658537,51,3,45,9
2018-19,2019-01-04,Calgary Flames,0,Pacific,Western,54,2,84,0.6428571428571429,51,3,45,9
2018-19,2019-01-05,Calgary Flames,2,Pacific,Western,56,2,86,0.6511627906976745,51,5,45,11
2018-19,2019-01-08,Calgary Flames,2,Pacific,Western,58,2,88,0.6590909090909091,55,3,45,13
2018-19,2019-01-10,Calgary Flames,2,Pacific,Western,60,2,90,0.6666666666666666,57,3,46,14
2018-19,2019-01-12,Calgary Flames,2,Pacific,Western,62,2,92,0.6739130434782609,58,4,47,15
2018-19,2019-01-14,Calgary Flames,2,Pacific,Western,64,2,94,0.6808510638297872,60,4,47,17
2018-19,2019-01-17,Calgary Flames,1,Pacific,Western,65,2,96,0.6770833333333334,60,5,49,16
2018-19,2019-01-19,Calgary Flames,2,Pacific,Western,67,2,98,0.6836734693877551,60,7,50,17
2018-19,2019-01-20,Calgary Flames,2,Pacific,Western,69,2,100,0.69,62,7,52,17
2018-19,2019-01-23,Calgary Flames,2,Pacific,Western,71,2,102,0.696078431372549,62,9,52,19
2018-19,2019-02-02,Calgary Flames,0,Pacific,Western,71,2,104,0.6826923076923077,62,9,52,19
2018-19,2019-02-03,Calgary Flames,2,Pacific,Western,73,2,106,0.6886792452830188,62,11,54,19
2018-19,2019-02-08,Calgary Flames,0,Pacific,Western,73,2,108,0.6759259259259259,66,7,55,18
2018-19,2019-02-10,Calgary Flames,1,Pacific,Western,74,2,110,0.6727272727272727,66,8,59,15
2018-19,2019-02-13,Calgary Flames,0,Pacific,Western,74,2,112,0.6607142857142857,66,8,59,15
2018-19,2019-02-15,Calgary Flames,1,Pacific,Western,75,2,114,0.6578947368421053,66,9,59,16
2018-19,2019-02-16,Calgary Flames,2,Pacific,Western,77,2,116,0.6637931034482759,66,11,60,17
2018-19,2019-02-18,Calgary Flames,2,Pacific,Western,79,2,118,0.6694915254237288,68,11,60,19
2018-19,2019-02-21,Calgary Flames,2,Pacific,Western,81,2,120,0.675,69,12,61,20
2018-19,2019-02-23,Calgary Flames,2,Pacific,Western,83,2,122,0.680327868852459,69,14,64,19
2018-19,2019-02-25,Calgary Flames,2,Pacific,Western,85,2,124,0.6854838709677419,69,16,66,19
2018-19,2019-02-27,Calgary Flames,2,Pacific,Western,87,2,126,0.6904761904761905,71,16,67,20
2018-19,2019-02-28,Calgary Flames,2,Pacific,Western,89,2,128,0.6953125,71,18,68,21
2018-19,2019-03-03,Calgary Flames,0,Pacific,Western,89,2,130,0.6846153846153846,77,12,70,19
2018-19,2019-03-05,Calgary Flames,0,Pacific,Western,89,2,132,0.6742424242424242,77,12,71,18
2018-19,2019-03-07,Calgary Flames,0,Pacific,Western,89,2,134,0.664179104477612,79,10,72,17
2018-19,2019-03-08,Calgary Flames,0,Pacific,Western,89,2,136,0.6544117647058824,79,10,74,15
2018-19,2019-03-11,Calgary Flames,2,Pacific,Western,91,2,138,0.6594202898550725,81,10,74,17
2018-19,2019-03-13,Calgary Flames,2,Pacific,Western,93,2,140,0.6642857142857143,81,12,75,18
2018-19,2019-03-16,Calgary Flames,0,Pacific,Western,93,2,142,0.6549295774647887,83,10,77,16
2018-19,2019-03-16,Calgary Flames,2,Pacific,Western,95,2,144,0.6597222222222222,83,12,77,18
2018-19,2019-03-20,Calgary Flames,2,Pacific,Western,97,2,146,0.6643835616438356,87,10,78,19
2018-19,2019-03-22,Calgary Flames,2,Pacific,Western,99,2,148,0.668918918918919,89,10,79,20
2018-19,2019-03-24,Calgary Flames,2,Pacific,Western,101,2,150,0.6733333333333333,90,11,80,21
2018-19,2019-03-26,Calgary Flames,0,Pacific,Western,101,2,152,0.6644736842105263,90,11,81,20
2018-19,2019-03-28,Calgary Flames,0,Pacific,Western,101,2,154,0.6558441558441559,90,11,83,18
2018-19,2019-03-30,Calgary Flames,2,Pacific,Western,103,2,156,0.6602564102564102,90,13,85,18
2018-19,2019-04-01,Calgary Flames,2,Pacific,Western,105,2,158,0.6645569620253164,91,14,85,20
2018-19,2019-04-02,Calgary Flames,2,Pacific,Western,107,2,160,0.66875,93,14,86,21
2018-19,2019-04-04,Calgary Flames,0,Pacific,Western,107,2,162,0.6604938271604939,93,14,88,19
2018-19,2019-04-07,Calgary Flames,0,Pacific,Western,107,2,164,0.6524390243902439,93,14,90,17
2018-19,2018-10-04,Carolina Hurricanes,1,Metropolitan,Eastern,1,2,2,0.5,2,-1,1,0
2018-19,2018-10-05,Carolina Hurricanes,2,Metropolitan,Eastern,3,2,4,0.75,2,1,2,1
2018-19,2018-10-07,Carolina Hurricanes,2,Metropolitan,Eastern,5,2,6,0.8333333333333334,2,3,2,3
2018-19,2018-10-09,Carolina Hurricanes,2,Metropolitan,Eastern,7,2,8,0.875,4,3,3,4
2018-19,2018-10-13,Carolina Hurricanes,2,Metropolitan,Eastern,9,2,10,0.9,5,4,5,4
2018-19,2018-10-14,Carolina Hurricanes,0,Metropolitan,Eastern,9,2,12,0.75,6,3,5,4
2018-19,2018-10-16,Carolina Hurricanes,0,Metropolitan,Eastern,9,2,14,0.6428571428571429,6,3,6,3
2018-19,2018-10-20,Carolina Hurricanes,0,Metropolitan,Eastern,9,2,16,0.5625,8,1,8,1
2018-19,2018-10-22,Carolina Hurricanes,2,Metropolitan,Eastern,11,2,18,0.6111111111111112,8,3,8,3
2018-19,2018-10-26,Carolina Hurricanes,2,Metropolitan,Eastern,13,2,20,0.65,10,3,10,3
2018-19,2018-10-28,Carolina Hurricanes,0,Metropolitan,Eastern,13,2,22,0.5909090909090909,12,1,12,1
2018-19,2018-10-30,Carolina Hurricanes,0,Metropolitan,Eastern,13,2,24,0.5416666666666666,13,0,13,0
2018-19,2018-11-03,Carolina Hurricanes,1,Metropolitan,Eastern,14,2,26,0.5384615384615384,14,0,14,0
2018-19,2018-11-04,Carolina Hurricanes,0,Metropolitan,Eastern,14,2,28,0.5,14,0,14,0
2018-19,2018-11-07,Carolina Hurricanes,0,Metropolitan,Eastern,14,2,30,0.4666666666666667,15,-1,15,-1
2018-19,2018-11-09,Carolina Hurricanes,2,Metropolitan,Eastern,16,2,32,0.5,17,-1,17,-1
2018-19,2018-11-11,Carolina Hurricanes,1,Metropolitan,Eastern,17,2,34,0.5,18,-1,18,-1
2018-19,2018-11-13,Carolina Hurricanes,2,Metropolitan,Eastern,19,2,36,0.5277777777777778,19,0,19,0
2018-19,2018-11-18,Carolina Hurricanes,2,Metropolitan,Eastern,21,2,38,0.5526315789473685,22,-1,22,-1
2018-19,2018-11-18,Carolina Hurricanes,0,Metropolitan,Eastern,21,2,40,0.525,22,-1,22,-1
2018-19,2018-11-22,Carolina Hurricanes,2,Metropolitan,Eastern,23,2,42,0.5476190476190477,25,-2,25,-2
2018-19,2018-11-24,Carolina Hurricanes,2,Metropolitan,Eastern,25,2,44,0.5681818181818182,26,-1,26,-1
2018-19,2018-11-25,Carolina Hurricanes,0,Metropolitan,Eastern,25,2,46,0.5434782608695652,26,-1,26,-1
2018-19,2018-11-28,Carolina Hurricanes,2,Metropolitan,Eastern,27,2,48,0.5625,28,-1,27,0
2018-19,2018-12-01,Carolina Hurricanes,1,Metropolitan,Eastern,28,2,50,0.56,28,0,28,0
2018-19,2018-12-03,Carolina Hurricanes,0,Metropolitan,Eastern,28,2,52,0.5384615384615384,29,-1,29,-1
2018-19,2018-12-06,Carolina Hurricanes,0,Metropolitan,Eastern,28,2,54,0.5185185185185185,29,-1,29,-1
2018-19,2018-12-08,Carolina Hurricanes,2,Metropolitan,Eastern,30,2,56,0.5357142857142857,30,0,30,0
2018-19,2018-12-12,Carolina Hurricanes,0,Metropolitan,Eastern,30,2,58,0.5172413793103449,32,-2,32,-2
2018-19,2018-12-14,Carolina Hurricanes,0,Metropolitan,Eastern,30,2,60,0.5,32,-2,32,-2
2018-19,2018-12-15,Carolina Hurricanes,1,Metropolitan,Eastern,31,2,62,0.5,34,-3,34,-3
2018-19,2018-12-16,Carolina Hurricanes,2,Metropolitan,Eastern,33,2,64,0.515625,36,-3,36,-3
2018-19,2018-12-21,Carolina Hurricanes,0,Metropolitan,Eastern,33,2,66,0.5,40,-7,40,-7
2018-19,2018-12-23,Carolina Hurricanes,0,Metropolitan,Eastern,33,2,68,0.4852941176470588,42,-9,42,-9
2018-19,2018-12-23,Carolina Hurricanes,2,Metropolitan,Eastern,35,2,70,0.5,42,-7,42,-7
2018-19,2018-12-28,Carolina Hurricanes,0,Metropolitan,Eastern,35,2,72,0.4861111111111111,44,-9,43,-8
2018-19,2018-12-29,Carolina Hurricanes,0,Metropolitan,Eastern,35,2,74,0.47297297297297297,44,-9,44,-9
2018-19,2018-12-31,Carolina Hurricanes,2,Metropolitan,Eastern,37,2,76,0.4868421052631579,47,-10,46,-9
2018-19,2019-01-04,Carolina Hurricanes,2,Metropolitan,Eastern,39,2,78,0.5,49,-10,49,-10
2018-19,2019-01-05,Carolina Hurricanes,2,Metropolitan,Eastern,41,2,80,0.5125,49,-8,49,-8
2018-19,2019-01-06,Carolina Hurricanes,2,Metropolitan,Eastern,43,2,82,0.524390243902439,51,-8,50,-7
2018-19,2019-01-09,Carolina Hurricanes,2,Metropolitan,Eastern,45,2,84,0.5357142857142857,51,-6,51,-6
2018-19,2019-01-11,Carolina Hurricanes,0,Metropolitan,Eastern,45,2,86,0.5232558139534884,53,-8,52,-7
2018-19,2019-01-12,Carolina Hurricanes,2,Metropolitan,Eastern,47,2,88,0.5340909090909091,53,-6,52,-5
2018-19,2019-01-13,Carolina Hurricanes,2,Metropolitan,Eastern,49,2,90,0.5444444444444444,55,-6,52,-3
2018-19,2019-01-16,Carolina Hurricanes,0,Metropolitan,Eastern,49,2,92,0.532608695652174,56,-7,56,-7
2018-19,2019-01-19,Carolina Hurricanes,0,Metropolitan,Eastern,49,2,94,0.5212765957446809,59,-10,58,-9
2018-19,2019-01-21,Carolina Hurricanes,2,Metropolitan,Eastern,51,2,96,0.53125,59,-8,58,-7
2018-19,2019-01-23,Carolina Hurricanes,1,Metropolitan,Eastern,52,2,98,0.5306122448979592,59,-7,58,-6
2018-19,2019-01-24,Carolina Hurricanes,2,Metropolitan,Eastern,54,2,100,0.54,59,-5,58,-4
2018-19,2019-02-02,Carolina Hurricanes,2,Metropolitan,Eastern,56,2,102,0.5490196078431373,62,-6,59,-3
2018-19,2019-02-03,Carolina Hurricanes,0,Metropolitan,Eastern,56,2,104,0.5384615384615384,62,-6,59,-3
2018-19,2019-02-06,Carolina Hurricanes,2,Metropolitan,Eastern,58,2,106,0.5471698113207547,62,-4,61,-3
2018-19,2019-02-08,Carolina Hurricanes,2,Metropolitan,Eastern,60,2,108,0.5555555555555556,63,-3,63,-3
2018-19,2019-02-09,Carolina Hurricanes,2,Metropolitan,Eastern,62,2,110,0.5636363636363636,63,-1,63,-1
2018-19,2019-02-10,Carolina Hurricanes,0,Metropolitan,Eastern,62,2,112,0.5535714285714286,65,-3,63,-1
2018-19,2019-02-13,Carolina Hurricanes,2,Metropolitan,Eastern,64,2,114,0.5614035087719298,67,-3,65,-1
2018-19,2019-02-16,Carolina Hurricanes,2,Metropolitan,Eastern,66,2,116,0.5689655172413793,67,-1,67,-1
2018-19,2019-02-17,Carolina Hurricanes,2,Metropolitan,Eastern,68,2,118,0.576271186440678,69,-1,69,-1
2018-19,2019-02-20,Carolina Hurricanes,0,Metropolitan,Eastern,68,2,120,0.5666666666666667,71,-3,69,-1
2018-19,2019-02-22,Carolina Hurricanes,2,Metropolitan,Eastern,70,2,122,0.5737704918032787,71,-1,70,0
2018-19,2019-02-23,Carolina Hurricanes,2,Metropolitan,Eastern,72,2,124,0.5806451612903226,72,0,71,1
2018-19,2019-02-27,Carolina Hurricanes,2,Metropolitan,Eastern,74,2,126,0.5873015873015873,74,0,74,0
2018-19,2019-03-02,Carolina Hurricanes,2,Metropolitan,Eastern,76,2,128,0.59375,76,0,75,1
2018-19,2019-03-03,Carolina Hurricanes,2,Metropolitan,Eastern,78,2,130,0.6,78,0,77,1
2018-19,2019-03-06,Carolina Hurricanes,1,Metropolitan,Eastern,79,2,132,0.5984848484848485,79,0,79,0
2018-19,2019-03-09,Carolina Hurricanes,0,Metropolitan,Eastern,79,2,134,0.5895522388059702,81,-2,79,0
2018-19,2019-03-10,Carolina Hurricanes,2,Metropolitan,Eastern,81,2,136,0.5955882352941176,81,0,79,2
2018-19,2019-03-12,Carolina Hurricanes,2,Metropolitan,Eastern,83,2,138,0.6014492753623188,85,-2,81,2
2018-19,2019-03-15,Carolina Hurricanes,0,Metropolitan,Eastern,83,2,140,0.5928571428571429,87,-4,83,0
2018-19,2019-03-16,Carolina Hurricanes,2,Metropolitan,Eastern,85,2,142,0.5985915492957746,87,-2,84,1
2018-19,2019-03-19,Carolina Hurricanes,2,Metropolitan,Eastern,87,2,144,0.6041666666666666,89,-2,84,3
2018-19,2019-03-21,Carolina Hurricanes,0,Metropolitan,Eastern,87,2,146,0.5958904109589042,89,-2,85,2
2018-19,2019-03-23,Carolina Hurricanes,2,Metropolitan,Eastern,89,2,148,0.6013513513513513,91,-2,87,2
2018-19,2019-03-24,Carolina Hurricanes,2,Metropolitan,Eastern,91,2,150,0.6066666666666667,93,-2,88,3
2018-19,2019-03-26,Carolina Hurricanes,0,Metropolitan,Eastern,91,2,152,0.5986842105263158,95,-4,90,1
2018-19,2019-03-28,Carolina Hurricanes,0,Metropolitan,Eastern,91,2,154,0.5909090909090909,95,-4,90,1
2018-19,2019-03-30,Carolina Hurricanes,2,Metropolitan,Eastern,93,2,156,0.5961538461538461,95,-2,92,1
2018-19,2019-03-31,Carolina Hurricanes,0,Metropolitan,Eastern,93,2,158,0.5886075949367089,97,-4,92,1
2018-19,2019-04-02,Carolina Hurricanes,2,Metropolitan,Eastern,95,2,160,0.59375,97,-2,94,1
2018-19,2019-04-04,Carolina Hurricanes,2,Metropolitan,Eastern,97,2,162,0.5987654320987654,99,-2,94,3
2018-19,2019-04-06,Carolina Hurricanes,2,Metropolitan,Eastern,99,2,164,0.6036585365853658,100,-1,98,1
2018-19,2018-10-04,Chicago Blackhawks,2,Central,Western,2,2,2,1.0,0,2,0,2
2018-19,2018-10-07,Chicago Blackhawks,2,Central,Western,4,2,4,1.0,4,0,2,2
2018-19,2018-10-07,Chicago Blackhawks,1,Central,Western,5,2,6,0.8333333333333334,4,1,2,3
2018-19,2018-10-12,Chicago Blackhawks,1,Central,Western,6,2,8,0.75,6,0,4,2
2018-19,2018-10-14,Chicago Blackhawks,2,Central,Western,8,2,10,0.8,7,1,6,2
2018-19,2018-10-19,Chicago Blackhawks,0,Central,Western,8,2,12,0.6666666666666666,9,-1,7,1
2018-19,2018-10-20,Chicago Blackhawks,2,Central,Western,10,2,14,0.7142857142857143,11,-1,8,2
2018-19,2018-10-21,Chicago Blackhawks,0,Central,Western,10,2,16,0.625,11,-1,10,0
2018-19,2018-10-24,Chicago Blackhawks,2,Central,Western,12,2,18,0.6666666666666666,13,-1,10,2
2018-19,2018-10-26,Chicago Blackhawks,2,Central,Western,14,2,20,0.7,14,0,11,3
2018-19,2018-10-28,Chicago Blackhawks,0,Central,Western,14,2,22,0.6363636363636364,15,-1,12,2
2018-19,2018-10-28,Chicago Blackhawks,1,Central,Western,15,2,24,0.625,15,0,12,3
2018-19,2018-11-01,Chicago Blackhawks,0,Central,Western,15,2,26,0.5769230769230769,16,-1,15,0
2018-19,2018-11-02,Chicago Blackhawks,0,Central,Western,15,2,28,0.5357142857142857,16,-1,15,0
2018-19,2018-11-04,Chicago Blackhawks,0,Central,Western,15,2,30,0.5,17,-2,17,-2
2018-19,2018-11-09,Chicago Blackhawks,0,Central,Western,15,2,32,0.46875,19,-4,17,-2
2018-19,2018-11-10,Chicago Blackhawks,0,Central,Western,15,2,34,0.4411764705882353,20,-5,17,-2
2018-19,2018-11-13,Chicago Blackhawks,1,Central,Western,16,2,36,0.4444444444444444,21,-5,19,-3
2018-19,2018-11-15,Chicago Blackhawks,2,Central,Western,18,2,38,0.47368421052631576,23,-5,20,-2
2018-19,2018-11-17,Chicago Blackhawks,1,Central,Western,19,2,40,0.475,24,-5,21,-2
2018-19,2018-11-18,Chicago Blackhawks,2,Central,Western,21,2,42,0.5,24,-3,22,-1
2018-19,2018-11-22,Chicago Blackhawks,0,Central,Western,21,2,44,0.4772727272727273,26,-5,23,-2
2018-19,2018-11-24,Chicago Blackhawks,0,Central,Western,21,2,46,0.45652173913043476,28,-7,25,-4
2018-19,2018-11-25,Chicago Blackhawks,2,Central,Western,23,2,48,0.4791666666666667,30,-7,25,-2
2018-19,2018-11-28,Chicago Blackhawks,0,Central,Western,23,2,50,0.46,30,-7,27,-4
2018-19,2018-11-30,Chicago Blackhawks,0,Central,Western,23,2,52,0.4423076923076923,30,-7,29,-6
2018-19,2018-12-02,Chicago Blackhawks,0,Central,Western,23,2,54,0.42592592592592593,34,-11,29,-6
2018-19,2018-12-03,Chicago Blackhawks,0,Central,Western,23,2,56,0.4107142857142857,34,-11,30,-7
2018-19,2018-12-06,Chicago Blackhawks,0,Central,Western,23,2,58,0.39655172413793105,36,-13,32,-9
2018-19,2018-12-07,Chicago Blackhawks,0,Central,Western,23,2,60,0.38333333333333336,36,-13,33,-10
2018-19,2018-12-09,Chicago Blackhawks,0,Central,Western,23,2,62,0.3709677419354839,38,-15,33,-10
2018-19,2018-12-12,Chicago Blackhawks,0,Central,Western,23,2,64,0.359375,39,-16,35,-12
2018-19,2018-12-13,Chicago Blackhawks,2,Central,Western,25,2,66,0.3787878787878788,39,-14,36,-11
2018-19,2018-12-15,Chicago Blackhawks,1,Central,Western,26,2,68,0.38235294117647056,40,-14,38,-12
2018-19,2018-12-17,Chicago Blackhawks,0,Central,Western,26,2,70,0.37142857142857144,42,-16,39,-13
2018-19,2018-12-19,Chicago Blackhawks,2,Central,Western,28,2,72,0.3888888888888889,42,-14,39,-11
2018-19,2018-12-21,Chicago Blackhawks,2,Central,Western,30,2,74,0.40540540540540543,44,-14,39,-9
2018-19,2018-12-22,Chicago Blackhawks,2,Central,Western,32,2,76,0.42105263157894735,44,-12,39,-7
2018-19,2018-12-24,Chicago Blackhawks,0,Central,Western,32,2,78,0.41025641025641024,44,-12,39,-7
2018-19,2018-12-28,Chicago Blackhawks,2,Central,Western,34,2,80,0.425,44,-10,41,-7
2018-19,2018-12-30,Chicago Blackhawks,2,Central,Western,36,2,82,0.43902439024390244,45,-9,43,-7
2018-19,2019-01-01,Chicago Blackhawks,0,Central,Western,36,2,84,0.42857142857142855,46,-10,44,-8
2018-19,2019-01-04,Chicago Blackhawks,1,Central,Western,37,2,86,0.43023255813953487,46,-9,45,-8
2018-19,2019-01-07,Chicago Blackhawks,2,Central,Western,39,2,88,0.4431818181818182,48,-9,45,-6
2018-19,2019-01-08,Chicago Blackhawks,0,Central,Western,39,2,90,0.43333333333333335,48,-9,45,-6
2018-19,2019-01-10,Chicago Blackhawks,1,Central,Western,40,2,92,0.43478260869565216,50,-10,46,-6
2018-19,2019-01-13,Chicago Blackhawks,1,Central,Western,41,2,94,0.43617021276595747,50,-9,47,-6
2018-19,2019-01-15,Chicago Blackhawks,0,Central,Western,41,2,96,0.4270833333333333,50,-9,47,-6
2018-19,2019-01-18,Chicago Blackhawks,0,Central,Western,41,2,98,0.41836734693877553,50,-9,49,-8
2018-19,2019-01-20,Chicago Blackhawks,2,Central,Western,43,2,100,0.43,52,-9,52,-9
2018-19,2019-01-23,Chicago Blackhawks,2,Central,Western,45,2,102,0.4411764705882353,53,-8,52,-7
2018-19,2019-02-02,Chicago Blackhawks,2,Central,Western,47,2,104,0.4519230769230769,56,-9,52,-5
2018-19,2019-02-03,Chicago Blackhawks,2,Central,Western,49,2,106,0.46226415094339623,58,-9,54,-5
2018-19,2019-02-06,Chicago Blackhawks,2,Central,Western,51,2,108,0.4722222222222222,60,-9,54,-3
2018-19,2019-02-08,Chicago Blackhawks,2,Central,Western,53,2,110,0.4818181818181818,61,-8,55,-2
2018-19,2019-02-10,Chicago Blackhawks,2,Central,Western,55,2,112,0.49107142857142855,61,-6,59,-4
2018-19,2019-02-13,Chicago Blackhawks,0,Central,Western,55,2,114,0.4824561403508772,63,-8,59,-4
2018-19,2019-02-15,Chicago Blackhawks,2,Central,Western,57,2,116,0.49137931034482757,63,-6,59,-2
2018-19,2019-02-17,Chicago Blackhawks,0,Central,Western,57,2,118,0.4830508474576271,67,-10,60,-3
2018-19,2019-02-19,Chicago Blackhawks,2,Central,Western,59,2,120,0.49166666666666664,67,-8,60,-1
2018-19,2019-02-21,Chicago Blackhawks,2,Central,Western,61,2,122,0.5,69,-8,61,0
2018-19,2019-02-23,Chicago Blackhawks,0,Central,Western,61,2,124,0.49193548387096775,71,-10,64,-3
2018-19,2019-02-24,Chicago Blackhawks,0,Central,Western,61,2,126,0.48412698412698413,71,-10,65,-4
2018-19,2019-02-28,Chicago Blackhawks,2,Central,Western,63,2,128,0.4921875,74,-11,68,-5
2018-19,2019-03-02,Chicago Blackhawks,0,Central,Western,63,2,130,0.4846153846153846,74,-11,68,-5
2018-19,2019-03-04,Chicago Blackhawks,0,Central,Western,63,2,132,0.4772727272727273,74,-11,71,-8
2018-19,2019-03-08,Chicago Blackhawks,2,Central,Western,65,2,134,0.48507462686567165,78,-13,74,-9
2018-19,2019-03-10,Chicago Blackhawks,2,Central,Western,67,2,136,0.49264705882352944,79,-12,74,-7
2018-19,2019-03-12,Chicago Blackhawks,2,Central,Western,69,2,138,0.5,79,-10,74,-5
2018-19,2019-03-13,Chicago Blackhawks,2,Central,Western,71,2,140,0.5071428571428571,79,-8,75,-4
2018-19,2019-03-16,Chicago Blackhawks,2,Central,Western,73,2,142,0.5140845070422535,81,-8,77,-4
2018-19,2019-03-19,Chicago Blackhawks,1,Central,Western,74,2,144,0.5138888888888888,82,-8,78,-4
2018-19,2019-03-22,Chicago Blackhawks,0,Central,Western,74,2,146,0.5068493150684932,86,-12,79,-5
2018-19,2019-03-23,Chicago Blackhawks,0,Central,Western,74,2,148,0.5,86,-12,80,-6
2018-19,2019-03-25,Chicago Blackhawks,2,Central,Western,76,2,150,0.5066666666666667,88,-12,81,-5
2018-19,2019-03-27,Chicago Blackhawks,0,Central,Western,76,2,152,0.5,90,-14,81,-5
2018-19,2019-03-29,Chicago Blackhawks,2,Central,Western,78,2,154,0.5064935064935064,90,-12,83,-5
2018-19,2019-03-31,Chicago Blackhawks,1,Central,Western,79,2,156,0.5064102564102564,92,-13,85,-6
2018-19,2019-04-02,Chicago Blackhawks,1,Central,Western,80,2,158,0.5063291139240507,94,-14,86,-6
2018-19,2019-04-04,Chicago Blackhawks,2,Central,Western,82,2,160,0.5125,95,-13,88,-6
2018-19,2019-04-06,Chicago Blackhawks,2,Central,Western,84,2,162,0.5185185185185185,97,-13,90,-6
2018-19,2019-04-07,Chicago Blackhawks,0,Central,Western,84,2,164,0.5121951219512195,99,-15,90,-6
2018-19,2018-10-05,Colorado Avalanche,2,Central,Western,2,2,2,1.0,2,0,0,2
2018-19,2018-10-07,Colorado Avalanche,2,Central,Western,4,2,4,1.0,4,0,2,2
2018-19,2018-10-09,Colorado Avalanche,0,Central,Western,4,2,6,0.6666666666666666,4,0,2,2
2018-19,2018-10-11,Colorado Avalanche,2,Central,Western,6,2,8,0.75,4,2,4,2
2018-19,2018-10-14,Colorado Avalanche,1,Central,Western,7,2,10,0.7,7,0,6,1
2018-19,2018-10-16,Colorado Avalanche,1,Central,Western,8,2,12,0.6666666666666666,8,0,6,2
2018-19,2018-10-18,Colorado Avalanche,2,Central,Western,10,2,14,0.7142857142857143,8,2,6,4
2018-19,2018-10-20,Colorado Avalanche,2,Central,Western,12,2,16,0.75,11,1,8,4
2018-19,2018-10-22,Colorado Avalanche,2,Central,Western,14,2,18,0.7777777777777778,11,3,10,4
2018-19,2018-10-25,Colorado Avalanche,0,Central,Western,14,2,20,0.7,13,1,10,4
2018-19,2018-10-27,Colorado Avalanche,2,Central,Western,16,2,22,0.7272727272727273,15,1,11,5
2018-19,2018-10-28,Colorado Avalanche,0,Central,Western,16,2,24,0.6666666666666666,15,1,12,4
2018-19,2018-11-02,Colorado Avalanche,0,Central,Western,16,2,26,0.6153846153846154,16,0,15,1
2018-19,2018-11-03,Colorado Avalanche,1,Central,Western,17,2,28,0.6071428571428571,17,0,16,1
2018-19,2018-11-08,Colorado Avalanche,0,Central,Western,17,2,30,0.5666666666666667,17,0,17,0
2018-19,2018-11-10,Colorado Avalanche,0,Central,Western,17,2,32,0.53125,20,-3,17,0
2018-19,2018-11-12,Colorado Avalanche,2,Central,Western,19,2,34,0.5588235294117647,21,-2,19,0
2018-19,2018-11-15,Colorado Avalanche,2,Central,Western,21,2,36,0.5833333333333334,23,-2,20,1
2018-19,2018-11-17,Colorado Avalanche,1,Central,Western,22,2,38,0.5789473684210527,24,-2,21,1
2018-19,2018-11-19,Colorado Avalanche,2,Central,Western,24,2,40,0.6,24,0,22,2
2018-19,2018-11-22,Colorado Avalanche,2,Central,Western,26,2,42,0.6190476190476191,26,0,23,3
2018-19,2018-11-24,Colorado Avalanche,2,Central,Western,28,2,44,0.6363636363636364,28,0,25,3
2018-19,2018-11-25,Colorado Avalanche,2,Central,Western,30,2,46,0.6521739130434783,30,0,25,5
2018-19,2018-11-28,Colorado Avalanche,2,Central,Western,32,2,48,0.6666666666666666,30,2,27,5
2018-19,2018-11-29,Colorado Avalanche,2,Central,Western,34,2,50,0.68,30,4,28,6
2018-19,2018-12-01,Colorado Avalanche,1,Central,Western,35,2,52,0.6730769230769231,31,4,29,6
2018-19,2018-12-03,Colorado Avalanche,2,Central,Western,37,2,54,0.6851851851851852,34,3,30,7
2018-19,2018-12-05,Colorado Avalanche,0,Central,Western,37,2,56,0.6607142857142857,36,1,31,6
2018-19,2018-12-07,Colorado Avalanche,2,Central,Western,39,2,58,0.6724137931034483,36,3,33,6
2018-19,2018-12-09,Colorado Avalanche,0,Central,Western,39,2,60,0.65,38,1,33,6
2018-19,2018-12-12,Colorado Avalanche,0,Central,Western,39,2,62,0.6290322580645161,39,0,35,4
2018-19,2018-12-15,Colorado Avalanche,1,Central,Western,40,2,64,0.625,40,0,38,2
2018-19,2018-12-16,Colorado Avalanche,2,Central,Western,42,2,66,0.6363636363636364,42,0,39,3
2018-19,2018-12-18,Colorado Avalanche,0,Central,Western,42,2,68,0.6176470588235294,42,0,39,3
2018-19,2018-12-20,Colorado Avalanche,2,Central,Western,44,2,70,0.6285714285714286,44,0,39,5
2018-19,2018-12-22,Colorado Avalanche,0,Central,Western,44,2,72,0.6111111111111112,44,0,39,5
2018-19,2018-12-23,Colorado Avalanche,0,Central,Western,44,2,74,0.5945945945945946,44,0,39,5
2018-19,2018-12-28,Colorado Avalanche,0,Central,Western,44,2,76,0.5789473684210527,44,0,41,3
2018-19,2018-12-30,Colorado Avalanche,1,Central,Western,45,2,78,0.5769230769230769,45,0,43,2
2018-19,2019-01-01,Colorado Avalanche,1,Central,Western,46,2,80,0.575,46,0,44,2
2018-19,2019-01-03,Colorado Avalanche,0,Central,Western,46,2,82,0.5609756097560976,46,0,45,1
2018-19,2019-01-05,Colorado Avalanche,2,Central,Western,48,2,84,0.5714285714285714,48,0,45,3
2018-19,2019-01-09,Colorado Avalanche,0,Central,Western,48,2,86,0.5581395348837209,50,-2,45,3
2018-19,2019-01-10,Colorado Avalanche,0,Central,Western,48,2,88,0.5454545454545454,50,-2,46,2
2018-19,2019-01-13,Colorado Avalanche,0,Central,Western,48,2,90,0.5333333333333333,50,-2,47,1
2018-19,2019-01-15,Colorado Avalanche,2,Central,Western,50,2,92,0.5434782608695652,50,0,47,3
2018-19,2019-01-17,Colorado Avalanche,0,Central,Western,50,2,94,0.5319148936170213,50,0,49,1
2018-19,2019-01-19,Colorado Avalanche,2,Central,Western,52,2,96,0.5416666666666666,52,0,50,2
2018-19,2019-01-21,Colorado Avalanche,0,Central,Western,52,2,98,0.5306122448979592,53,-1,52,0
2018-19,2019-01-24,Colorado Avalanche,0,Central,Western,52,2,100,0.52,55,-3,52,0
2018-19,2019-02-03,Colorado Avalanche,0,Central,Western,52,2,102,0.5098039215686274,58,-6,54,-2
2018-19,2019-02-06,Colorado Avalanche,0,Central,Western,52,2,104,0.5,60,-8,54,-2
2018-19,2019-02-08,Colorado Avalanche,1,Central,Western,53,2,106,0.5,61,-8,55,-2
2018-19,2019-02-09,Colorado Avalanche,1,Central,Western,54,2,108,0.5,61,-7,57,-3
2018-19,2019-02-10,Colorado Avalanche,1,Central,Western,55,2,110,0.5,61,-6,59,-4
2018-19,2019-02-13,Colorado Avalanche,0,Central,Western,55,2,112,0.49107142857142855,63,-8,59,-4
2018-19,2019-02-15,Colorado Avalanche,2,Central,Western,57,2,114,0.5,63,-6,59,-2
2018-19,2019-02-16,Colorado Avalanche,0,Central,Western,57,2,116,0.49137931034482757,65,-8,60,-3
2018-19,2019-02-19,Colorado Avalanche,2,Central,Western,59,2,118,0.5,67,-8,60,-1
2018-19,2019-02-21,Colorado Avalanche,2,Central,Western,61,2,120,0.5083333333333333,69,-8,61,0
2018-19,2019-02-23,Colorado Avalanche,2,Central,Western,63,2,122,0.5163934426229508,71,-8,64,-1
2018-19,2019-02-23,Colorado Avalanche,2,Central,Western,65,2,124,0.5241935483870968,71,-6,64,1
2018-19,2019-02-26,Colorado Avalanche,1,Central,Western,66,2,126,0.5238095238095238,72,-6,66,0
2018-19,2019-02-28,Colorado Avalanche,2,Central,Western,68,2,128,0.53125,74,-6,68,0
2018-19,2019-03-02,Colorado Avalanche,0,Central,Western,68,2,130,0.5230769230769231,74,-6,68,0
2018-19,2019-03-03,Colorado Avalanche,0,Central,Western,68,2,132,0.5151515151515151,74,-6,70,-2
2018-19,2019-03-06,Colorado Avalanche,2,Central,Western,70,2,134,0.5223880597014925,74,-4,72,-2
2018-19,2019-03-08,Colorado Avalanche,0,Central,Western,70,2,136,0.5147058823529411,78,-8,74,-4
2018-19,2019-03-09,Colorado Avalanche,2,Central,Western,72,2,138,0.5217391304347826,79,-7,74,-2
2018-19,2019-03-12,Colorado Avalanche,0,Central,Western,72,2,140,0.5142857142857142,79,-7,74,-2
2018-19,2019-03-16,Colorado Avalanche,0,Central,Western,72,2,142,0.5070422535211268,81,-9,77,-5
2018-19,2019-03-17,Colorado Avalanche,2,Central,Western,74,2,144,0.5138888888888888,82,-8,78,-4
2018-19,2019-03-20,Colorado Avalanche,2,Central,Western,76,2,146,0.5205479452054794,84,-8,78,-2
2018-19,2019-03-22,Colorado Avalanche,2,Central,Western,78,2,148,0.527027027027027,86,-8,79,-1
2018-19,2019-03-23,Colorado Avalanche,2,Central,Western,80,2,150,0.5333333333333333,86,-6,80,0
2018-19,2019-03-25,Colorado Avalanche,1,Central,Western,81,2,152,0.5328947368421053,88,-7,81,0
2018-19,2019-03-28,Colorado Avalanche,2,Central,Western,83,2,154,0.538961038961039,90,-7,83,0
2018-19,2019-03-30,Colorado Avalanche,2,Central,Western,85,2,156,0.5448717948717948,92,-7,85,0
2018-19,2019-04-02,Colorado Avalanche,1,Central,Western,86,2,158,0.5443037974683544,94,-8,86,0
2018-19,2019-04-03,Colorado Avalanche,2,Central,Western,88,2,160,0.55,94,-6,88,0
2018-19,2019-04-05,Colorado Avalanche,2,Central,Western,90,2,162,0.5555555555555556,97,-7,90,0
2018-19,2019-04-07,Colorado Avalanche,0,Central,Western,90,2,164,0.5487804878048781,99,-9,90,0
2018-19,2018-10-04,Columbus Blue Jackets,2,Metropolitan,Eastern,2,2,2,1.0,2,0,1,1
2018-19,2018-10-05,Columbus Blue Jackets,0,Metropolitan,Eastern,2,2,4,0.5,2,0,2,0
2018-19,2018-10-09,Columbus Blue Jackets,2,Metropolitan,Eastern,4,2,6,0.6666666666666666,4,0,3,1
2018-19,2018-10-11,Columbus Blue Jackets,2,Metropolitan,Eastern,6,2,8,0.75,5,1,4,2
2018-19,2018-10-13,Columbus Blue Jackets,0,Metropolitan,Eastern,6,2,10,0.6,5,1,5,1
2018-19,2018-10-18,Columbus Blue Jackets,2,Metropolitan,Eastern,8,2,12,0.6666666666666666,8,0,8,0
2018-19,2018-10-20,Columbus Blue Jackets,0,Metropolitan,Eastern,8,2,14,0.5714285714285714,8,0,8,0
2018-19,2018-10-23,Columbus Blue Jackets,0,Metropolitan,Eastern,8,2,16,0.5,8,0,9,-1
2018-19,2018-10-26,Columbus Blue Jackets,2,Metropolitan,Eastern,10,2,18,0.5555555555555556,10,0,10,0
2018-19,2018-10-27,Columbus Blue Jackets,2,Metropolitan,Eastern,12,2,20,0.6,12,0,12,0
2018-19,2018-10-30,Columbus Blue Jackets,0,Metropolitan,Eastern,12,2,22,0.5454545454545454,13,-1,13,-1
2018-19,2018-11-02,Columbus Blue Jackets,2,Metropolitan,Eastern,14,2,24,0.5833333333333334,14,0,14,0
2018-19,2018-11-04,Columbus Blue Jackets,0,Metropolitan,Eastern,14,2,26,0.5384615384615384,14,0,14,0
2018-19,2018-11-05,Columbus Blue Jackets,1,Metropolitan,Eastern,15,2,28,0.5357142857142857,15,0,15,0
2018-19,2018-11-07,Columbus Blue Jackets,2,Metropolitan,Eastern,17,2,30,0.5666666666666667,15,2,15,2
2018-19,2018-11-10,Columbus Blue Jackets,2,Metropolitan,Eastern,19,2,32,0.59375,18,1,18,1
2018-19,2018-11-11,Columbus Blue Jackets,1,Metropolitan,Eastern,20,2,34,0.5882352941176471,18,2,18,2
2018-19,2018-11-13,Columbus Blue Jackets,2,Metropolitan,Eastern,22,2,36,0.6111111111111112,19,3,19,3
2018-19,2018-11-16,Columbus Blue Jackets,2,Metropolitan,Eastern,24,2,38,0.631578947368421,20,4,20,4
2018-19,2018-11-18,Columbus Blue Jackets,2,Metropolitan,Eastern,26,2,40,0.65,22,4,22,4
2018-19,2018-11-20,Columbus Blue Jackets,0,Metropolitan,Eastern,26,2,42,0.6190476190476191,23,3,23,3
2018-19,2018-11-24,Columbus Blue Jackets,2,Metropolitan,Eastern,28,2,44,0.6363636363636364,26,2,26,2
2018-19,2018-11-25,Columbus Blue Jackets,0,Metropolitan,Eastern,28,2,46,0.6086956521739131,26,2,26,2
2018-19,2018-11-27,Columbus Blue Jackets,2,Metropolitan,Eastern,30,2,48,0.625,28,2,27,3
2018-19,2018-11-30,Columbus Blue Jackets,2,Metropolitan,Eastern,32,2,50,0.64,28,4,27,5
2018-19,2018-12-02,Columbus Blue Jackets,0,Metropolitan,Eastern,32,2,52,0.6153846153846154,29,3,29,3
2018-19,2018-12-05,Columbus Blue Jackets,0,Metropolitan,Eastern,32,2,54,0.5925925925925926,29,3,29,3
2018-19,2018-12-07,Columbus Blue Jackets,2,Metropolitan,Eastern,34,2,56,0.6071428571428571,29,5,30,4
2018-19,2018-12-09,Columbus Blue Jackets,0,Metropolitan,Eastern,34,2,58,0.5862068965517241,31,3,31,3
2018-19,2018-12-12,Columbus Blue Jackets,0,Metropolitan,Eastern,34,2,60,0.5666666666666667,32,2,32,2
2018-19,2018-12-14,Columbus Blue Jackets,2,Metropolitan,Eastern,36,2,62,0.5806451612903226,32,4,32,4
2018-19,2018-12-16,Columbus Blue Jackets,1,Metropolitan,Eastern,37,2,64,0.578125,36,1,36,1
2018-19,2018-12-18,Columbus Blue Jackets,2,Metropolitan,Eastern,39,2,66,0.5909090909090909,36,3,36,3
2018-19,2018-12-21,Columbus Blue Jackets,2,Metropolitan,Eastern,41,2,68,0.6029411764705882,40,1,40,1
2018-19,2018-12-22,Columbus Blue Jackets,2,Metropolitan,Eastern,43,2,70,0.6142857142857143,40,3,40,3
2018-19,2018-12-23,Columbus Blue Jackets,2,Metropolitan,Eastern,45,2,72,0.625,42,3,42,3
2018-19,2018-12-28,Columbus Blue Jackets,2,Metropolitan,Eastern,47,2,74,0.6351351351351351,44,3,43,4
2018-19,2018-12-29,Columbus Blue Jackets,0,Metropolitan,Eastern,47,2,76,0.618421052631579,44,3,44,3
2018-19,2019-01-01,Columbus Blue Jackets,2,Metropolitan,Eastern,49,2,78,0.6282051282051282,48,1,47,2
2018-19,2019-01-05,Columbus Blue Jackets,0,Metropolitan,Eastern,49,2,80,0.6125,49,0,49,0
2018-19,2019-01-06,Columbus Blue Jackets,2,Metropolitan,Eastern,51,2,82,0.6219512195121951,51,0,50,1
2018-19,2019-01-09,Columbus Blue Jackets,0,Metropolitan,Eastern,51,2,84,0.6071428571428571,51,0,51,0
2018-19,2019-01-11,Columbus Blue Jackets,2,Metropolitan,Eastern,53,2,86,0.6162790697674418,53,0,52,1
2018-19,2019-01-13,Columbus Blue Jackets,2,Metropolitan,Eastern,55,2,88,0.625,55,0,52,3
2018-19,2019-01-13,Columbus Blue Jackets,2,Metropolitan,Eastern,57,2,90,0.6333333333333333,55,2,52,5
2018-19,2019-01-16,Columbus Blue Jackets,2,Metropolitan,Eastern,59,2,92,0.6413043478260869,56,3,56,3
2018-19,2019-01-19,Columbus Blue Jackets,0,Metropolitan,Eastern,59,2,94,0.6276595744680851,59,0,58,1
2018-19,2019-01-20,Columbus Blue Jackets,0,Metropolitan,Eastern,59,2,96,0.6145833333333334,59,0,58,1
2018-19,2019-01-30,Columbus Blue Jackets,0,Metropolitan,Eastern,59,2,98,0.6020408163265306,59,0,58,1
2018-19,2019-02-01,Columbus Blue Jackets,0,Metropolitan,Eastern,59,2,100,0.59,60,-1,59,0
2018-19,2019-02-03,Columbus Blue Jackets,0,Metropolitan,Eastern,59,2,102,0.5784313725490197,62,-3,59,0
2018-19,2019-02-06,Columbus Blue Jackets,2,Metropolitan,Eastern,61,2,104,0.5865384615384616,62,-1,61,0
2018-19,2019-02-08,Columbus Blue Jackets,2,Metropolitan,Eastern,63,2,106,0.5943396226415094,63,0,63,0
2018-19,2019-02-10,Columbus Blue Jackets,2,Metropolitan,Eastern,65,2,108,0.6018518518518519,65,0,63,2
2018-19,2019-02-13,Columbus Blue Jackets,2,Metropolitan,Eastern,67,2,110,0.6090909090909091,67,0,65,2
2018-19,2019-02-15,Columbus Blue Jackets,0,Metropolitan,Eastern,67,2,112,0.5982142857142857,67,0,67,0
2018-19,2019-02-17,Columbus Blue Jackets,2,Metropolitan,Eastern,69,2,114,0.6052631578947368,69,0,69,0
2018-19,2019-02-19,Columbus Blue Jackets,0,Metropolitan,Eastern,69,2,116,0.5948275862068966,69,0,69,0
2018-19,2019-02-20,Columbus Blue Jackets,0,Metropolitan,Eastern,69,2,118,0.5847457627118644,71,-2,69,0
2018-19,2019-02-23,Columbus Blue Jackets,2,Metropolitan,Eastern,71,2,120,0.5916666666666667,72,-1,71,0
2018-19,2019-02-23,Columbus Blue Jackets,2,Metropolitan,Eastern,73,2,122,0.5983606557377049,72,1,71,2
2018-19,2019-02-27,Columbus Blue Jackets,0,Metropolitan,Eastern,73,2,124,0.5887096774193549,74,-1,74,-1
2018-19,2019-03-01,Columbus Blue Jackets,2,Metropolitan,Eastern,75,2,126,0.5952380952380952,75,0,74,1
2018-19,2019-03-02,Columbus Blue Jackets,0,Metropolitan,Eastern,75,2,128,0.5859375,76,-1,75,0
2018-19,2019-03-04,Columbus Blue Jackets,0,Metropolitan,Eastern,75,2,130,0.5769230769230769,78,-3,77,-2
2018-19,2019-03-06,Columbus Blue Jackets,2,Metropolitan,Eastern,77,2,132,0.5833333333333334,79,-2,79,-2
2018-19,2019-03-08,Columbus Blue Jackets,0,Metropolitan,Eastern,77,2,134,0.5746268656716418,81,-4,79,-2
2018-19,2019-03-10,Columbus Blue Jackets,2,Metropolitan,Eastern,79,2,136,0.5808823529411765,81,-2,79,0
2018-19,2019-03-11,Columbus Blue Jackets,0,Metropolitan,Eastern,79,2,138,0.572463768115942,81,-2,79,0
2018-19,2019-03-12,Columbus Blue Jackets,2,Metropolitan,Eastern,81,2,140,0.5785714285714286,85,-4,81,0
2018-19,2019-03-15,Columbus Blue Jackets,2,Metropolitan,Eastern,83,2,142,0.5845070422535211,87,-4,83,0
2018-19,2019-03-16,Columbus Blue Jackets,1,Metropolitan,Eastern,84,2,144,0.5833333333333334,87,-3,84,0
2018-19,2019-03-20,Columbus Blue Jackets,0,Metropolitan,Eastern,84,2,146,0.5753424657534246,89,-5,84,0
2018-19,2019-03-22,Columbus Blue Jackets,0,Metropolitan,Eastern,84,2,148,0.5675675675675675,91,-7,85,-1
2018-19,2019-03-25,Columbus Blue Jackets,2,Metropolitan,Eastern,86,2,150,0.5733333333333334,95,-9,88,-2
2018-19,2019-03-26,Columbus Blue Jackets,2,Metropolitan,Eastern,88,2,152,0.5789473684210527,95,-7,90,-2
2018-19,2019-03-28,Columbus Blue Jackets,2,Metropolitan,Eastern,90,2,154,0.5844155844155844,95,-5,90,0
2018-19,2019-03-31,Columbus Blue Jackets,2,Metropolitan,Eastern,92,2,156,0.5897435897435898,97,-5,92,0
2018-19,2019-03-31,Columbus Blue Jackets,2,Metropolitan,Eastern,94,2,158,0.5949367088607594,97,-3,92,2
2018-19,2019-04-02,Columbus Blue Jackets,0,Metropolitan,Eastern,94,2,160,0.5875,97,-3,94,0
2018-19,2019-04-05,Columbus Blue Jackets,2,Metropolitan,Eastern,96,2,162,0.5925925925925926,99,-3,96,0
2018-19,2019-04-06,Columbus Blue Jackets,2,Metropolitan,Eastern,98,2,164,0.5975609756097561,100,-2,98,0
2018-19,2018-10-05,Dallas Stars,2,Central,Western,2,2,2,1.0,2,0,0,2
2018-19,2018-10-06,Dallas Stars,2,Central,Western,4,2,4,1.0,2,2,2,2
2018-19,2018-10-10,Dallas Stars,0,Central,Western,4,2,6,0.6666666666666666,4,0,4,0
2018-19,2018-10-14,Dallas Stars,2,Central,Western,6,2,8,0.75,7,-1,6,0
2018-19,2018-10-15,Dallas Stars,0,Central,Western,6,2,10,0.6,7,-1,6,0
2018-19,2018-10-16,Dallas Stars,0,Central,Western,6,2,12,0.5,8,-2,6,0
2018-19,2018-10-20,Dallas Stars,0,Central,Western,6,2,14,0.42857142857142855,11,-5,8,-2
2018-19,2018-10-24,Dallas Stars,2,Central,Western,8,2,16,0.5,13,-5,10,-2
2018-19,2018-10-26,Dallas Stars,2,Central,Western,10,2,18,0.5555555555555556,14,-4,11,-1
2018-19,2018-10-28,Dallas Stars,0,Central,Western,10,2,20,0.5,15,-5,12,-2
2018-19,2018-10-30,Dallas Stars,2,Central,Western,12,2,22,0.5454545454545454,15,-3,14,-2
2018-19,2018-11-01,Dallas Stars,2,Central,Western,14,2,24,0.5833333333333334,16,-2,15,-1
2018-19,2018-11-03,Dallas Stars,2,Central,Western,16,2,26,0.6153846153846154,17,-1,16,0
2018-19,2018-11-06,Dallas Stars,1,Central,Western,17,2,28,0.6071428571428571,17,0,17,0
2018-19,2018-11-07,Dallas Stars,0,Central,Western,17,2,30,0.5666666666666667,17,0,17,0
2018-19,2018-11-09,Dallas Stars,2,Central,Western,19,2,32,0.59375,19,0,17,2
2018-19,2018-11-10,Dallas Stars,1,Central,Western,20,2,34,0.5882352941176471,20,0,17,3
2018-19,2018-11-13,Dallas Stars,0,Central,Western,20,2,36,0.5555555555555556,21,-1,19,1
2018-19,2018-11-17,Dallas Stars,2,Central,Western,22,2,38,0.5789473684210527,24,-2,21,1
2018-19,2018-11-18,Dallas Stars,2,Central,Western,24,2,40,0.6,24,0,22,2
2018-19,2018-11-20,Dallas Stars,0,Central,Western,24,2,42,0.5714285714285714,26,-2,22,2
2018-19,2018-11-22,Dallas Stars,0,Central,Western,24,2,44,0.5454545454545454,26,-2,23,1
2018-19,2018-11-24,Dallas Stars,2,Central,Western,26,2,46,0.5652173913043478,28,-2,25,1
2018-19,2018-11-25,Dallas Stars,0,Central,Western,26,2,48,0.5416666666666666,30,-4,25,1
2018-19,2018-11-28,Dallas Stars,1,Central,Western,27,2,50,0.54,30,-3,27,0
2018-19,2018-11-29,Dallas Stars,2,Central,Western,29,2,52,0.5576923076923077,30,-1,28,1
2018-19,2018-12-01,Dallas Stars,2,Central,Western,31,2,54,0.5740740740740741,31,0,29,2
2018-19,2018-12-04,Dallas Stars,2,Central,Western,33,2,56,0.5892857142857143,34,-1,30,3
2018-19,2018-12-08,Dallas Stars,2,Central,Western,35,2,58,0.603448275862069,36,-1,33,2
2018-19,2018-12-10,Dallas Stars,0,Central,Western,35,2,60,0.5833333333333334,38,-3,35,0
2018-19,2018-12-13,Dallas Stars,0,Central,Western,35,2,62,0.5645161290322581,39,-4,36,-1
2018-19,2018-12-14,Dallas Stars,0,Central,Western,35,2,64,0.546875,39,-4,37,-2
2018-19,2018-12-16,Dallas Stars,0,Central,Western,35,2,66,0.5303030303030303,42,-7,39,-4
2018-19,2018-12-19,Dallas Stars,2,Central,Western,37,2,68,0.5441176470588235,42,-5,39,-2
2018-19,2018-12-21,Dallas Stars,0,Central,Western,37,2,70,0.5285714285714286,44,-7,39,-2
2018-19,2018-12-23,Dallas Stars,2,Central,Western,39,2,72,0.5416666666666666,44,-5,39,0
2018-19,2018-12-24,Dallas Stars,0,Central,Western,39,2,74,0.527027027027027,44,-5,39,0
2018-19,2018-12-28,Dallas Stars,2,Central,Western,41,2,76,0.5394736842105263,44,-3,41,0
2018-19,2018-12-30,Dallas Stars,2,Central,Western,43,2,78,0.5512820512820513,45,-2,43,0
2018-19,2019-01-01,Dallas Stars,1,Central,Western,44,2,80,0.55,46,-2,44,0
2018-19,2019-01-03,Dallas Stars,2,Central,Western,46,2,82,0.5609756097560976,46,0,45,1
2018-19,2019-01-05,Dallas Stars,2,Central,Western,48,2,84,0.5714285714285714,48,0,45,3
2018-19,2019-01-06,Dallas Stars,0,Central,Western,48,2,86,0.5581395348837209,48,0,45,3
2018-19,2019-01-09,Dallas Stars,2,Central,Western,50,2,88,0.5681818181818182,50,0,45,5
2018-19,2019-01-11,Dallas Stars,0,Central,Western,50,2,90,0.5555555555555556,50,0,47,3
2018-19,2019-01-13,Dallas Stars,0,Central,Western,50,2,92,0.5434782608695652,50,0,47,3
2018-19,2019-01-16,Dallas Stars,0,Central,Western,50,2,94,0.5319148936170213,50,0,49,1
2018-19,2019-01-18,Dallas Stars,0,Central,Western,50,2,96,0.5208333333333334,50,0,49,1
2018-19,2019-01-20,Dallas Stars,2,Central,Western,52,2,98,0.5306122448979592,52,0,52,0
2018-19,2019-01-31,Dallas Stars,2,Central,Western,54,2,100,0.54,55,-1,52,2
2018-19,2019-02-02,Dallas Stars,2,Central,Western,56,2,102,0.5490196078431373,56,0,52,4
2018-19,2019-02-03,Dallas Stars,2,Central,Western,58,2,104,0.5576923076923077,58,0,54,4
2018-19,2019-02-05,Dallas Stars,2,Central,Western,60,2,106,0.5660377358490566,60,0,54,6
2018-19,2019-02-08,Dallas Stars,1,Central,Western,61,2,108,0.5648148148148148,61,0,55,6
2018-19,2019-02-09,Dallas Stars,0,Central,Western,61,2,110,0.5545454545454546,61,0,57,4
2018-19,2019-02-13,Dallas Stars,2,Central,Western,63,2,112,0.5625,63,0,59,4
2018-19,2019-02-15,Dallas Stars,0,Central,Western,63,2,114,0.5526315789473685,63,0,59,4
2018-19,2019-02-17,Dallas Stars,0,Central,Western,63,2,116,0.5431034482758621,67,-4,60,3
2018-19,2019-02-20,Dallas Stars,0,Central,Western,63,2,118,0.5338983050847458,69,-6,60,3
2018-19,2019-02-22,Dallas Stars,2,Central,Western,65,2,120,0.5416666666666666,69,-4,62,3
2018-19,2019-02-23,Dallas Stars,0,Central,Western,65,2,122,0.5327868852459017,71,-6,64,1
2018-19,2019-02-24,Dallas Stars,2,Central,Western,67,2,124,0.5403225806451613,71,-4,65,2
2018-19,2019-02-27,Dallas Stars,0,Central,Western,67,2,126,0.5317460317460317,74,-7,67,0
2018-19,2019-03-01,Dallas Stars,2,Central,Western,69,2,128,0.5390625,74,-5,68,1
2018-19,2019-03-03,Dallas Stars,2,Central,Western,71,2,130,0.5461538461538461,74,-3,70,1
2018-19,2019-03-06,Dallas Stars,2,Central,Western,73,2,132,0.553030303030303,74,-1,72,1
2018-19,2019-03-08,Dallas Stars,2,Central,Western,75,2,134,0.5597014925373134,78,-3,74,1
2018-19,2019-03-10,Dallas Stars,0,Central,Western,75,2,136,0.5514705882352942,79,-4,74,1
2018-19,2019-03-12,Dallas Stars,2,Central,Western,77,2,138,0.5579710144927537,79,-2,74,3
2018-19,2019-03-15,Dallas Stars,2,Central,Western,79,2,140,0.5642857142857143,79,0,77,2
2018-19,2019-03-16,Dallas Stars,0,Central,Western,79,2,142,0.5563380281690141,81,-2,77,2
2018-19,2019-03-17,Dallas Stars,1,Central,Western,80,2,144,0.5555555555555556,82,-2,78,2
2018-19,2019-03-20,Dallas Stars,2,Central,Western,82,2,146,0.5616438356164384,84,-2,78,4
2018-19,2019-03-22,Dallas Stars,0,Central,Western,82,2,148,0.5540540540540541,86,-4,79,3
2018-19,2019-03-24,Dallas Stars,0,Central,Western,82,2,150,0.5466666666666666,88,-6,80,2
2018-19,2019-03-26,Dallas Stars,2,Central,Western,84,2,152,0.5526315789473685,90,-6,81,3
2018-19,2019-03-28,Dallas Stars,2,Central,Western,86,2,154,0.5584415584415584,90,-4,83,3
2018-19,2019-03-29,Dallas Stars,2,Central,Western,88,2,156,0.5641025641025641,90,-2,83,5
2018-19,2019-03-31,Dallas Stars,1,Central,Western,89,2,158,0.5632911392405063,92,-3,85,4
2018-19,2019-04-03,Dallas Stars,2,Central,Western,91,2,160,0.56875,94,-3,88,3
2018-19,2019-04-06,Dallas Stars,0,Central,Western,91,2,162,0.5617283950617284,97,-6,90,1
2018-19,2019-04-07,Dallas Stars,2,Central,Western,93,2,164,0.5670731707317073,99,-6,90,3
2018-19,2018-10-04,Detroit Red Wings,1,Atlantic,Eastern,1,2,2,0.5,1,0,1,0
2018-19,2018-10-08,Detroit Red Wings,0,Atlantic,Eastern,1,2,4,0.25,4,-3,3,-2
2018-19,2018-10-09,Detroit Red Wings,1,Atlantic,Eastern,2,2,6,0.3333333333333333,4,-2,3,-1
2018-19,2018-10-11,Detroit Red Wings,0,Atlantic,Eastern,2,2,8,0.25,4,-2,4,-2
2018-19,2018-10-13,Detroit Red Wings,0,Atlantic,Eastern,2,2,10,0.2,5,-3,5,-3
2018-19,2018-10-15,Detroit Red Wings,0,Atlantic,Eastern,2,2,12,0.16666666666666666,7,-5,6,-4
2018-19,2018-10-18,Detroit Red Wings,0,Atlantic,Eastern,2,2,14,0.14285714285714285,8,-6,8,-6
2018-19,2018-10-20,Detroit Red Wings,2,Atlantic,Eastern,4,2,16,0.25,9,-5,8,-4
2018-19,2018-10-22,Detroit Red Wings,0,Atlantic,Eastern,4,2,18,0.2222222222222222,10,-6,8,-4
2018-19,2018-10-26,Detroit Red Wings,0,Atlantic,Eastern,4,2,20,0.2,14,-10,10,-6
2018-19,2018-10-28,Detroit Red Wings,2,Atlantic,Eastern,6,2,22,0.2727272727272727,14,-8,12,-6
2018-19,2018-10-30,Detroit Red Wings,2,Atlantic,Eastern,8,2,24,0.3333333333333333,16,-8,13,-5
2018-19,2018-11-01,Detroit Red Wings,2,Atlantic,Eastern,10,2,26,0.38461538461538464,16,-6,13,-3
2018-19,2018-11-03,Detroit Red Wings,0,Atlantic,Eastern,10,2,28,0.35714285714285715,16,-6,14,-4
2018-19,2018-11-07,Detroit Red Wings,2,Atlantic,Eastern,12,2,30,0.4,18,-6,15,-3
2018-19,2018-11-10,Detroit Red Wings,2,Atlantic,Eastern,14,2,32,0.4375,20,-6,18,-4
2018-19,2018-11-11,Detroit Red Wings,2,Atlantic,Eastern,16,2,34,0.47058823529411764,21,-5,18,-2
2018-19,2018-11-14,Detroit Red Wings,2,Atlantic,Eastern,18,2,36,0.5,22,-4,20,-2
2018-19,2018-11-16,Detroit Red Wings,0,Atlantic,Eastern,18,2,38,0.47368421052631576,23,-5,20,-2
2018-19,2018-11-17,Detroit Red Wings,2,Atlantic,Eastern,20,2,40,0.5,24,-4,21,-1
2018-19,2018-11-22,Detroit Red Wings,2,Atlantic,Eastern,22,2,42,0.5238095238095238,30,-8,25,-3
2018-19,2018-11-23,Detroit Red Wings,0,Atlantic,Eastern,22,2,44,0.5,30,-8,26,-4
2018-19,2018-11-25,Detroit Red Wings,1,Atlantic,Eastern,23,2,46,0.5,32,-9,26,-3
2018-19,2018-11-27,Detroit Red Wings,0,Atlantic,Eastern,23,2,48,0.4791666666666667,34,-11,27,-4
2018-19,2018-11-29,Detroit Red Wings,2,Atlantic,Eastern,25,2,50,0.5,35,-10,27,-2
2018-19,2018-12-02,Detroit Red Wings,2,Atlantic,Eastern,27,2,52,0.5192307692307693,37,-10,29,-2
2018-19,2018-12-03,Detroit Red Wings,0,Atlantic,Eastern,27,2,54,0.5,37,-10,29,-2
2018-19,2018-12-05,Detroit Red Wings,1,Atlantic,Eastern,28,2,56,0.5,38,-10,29,-1
2018-19,2018-12-07,Detroit Red Wings,2,Atlantic,Eastern,30,2,58,0.5172413793103449,38,-8,30,0
2018-19,2018-12-09,Detroit Red Wings,0,Atlantic,Eastern,30,2,60,0.5,38,-8,31,-1
2018-19,2018-12-11,Detroit Red Wings,2,Atlantic,Eastern,32,2,62,0.5161290322580645,38,-6,32,0
2018-19,2018-12-12,Detroit Red Wings,0,Atlantic,Eastern,32,2,64,0.5,40,-8,32,0
2018-19,2018-12-15,Detroit Red Wings,0,Atlantic,Eastern,32,2,66,0.48484848484848486,42,-10,34,-2
2018-19,2018-12-16,Detroit Red Wings,1,Atlantic,Eastern,33,2,68,0.4852941176470588,44,-11,36,-3
2018-19,2018-12-19,Detroit Red Wings,0,Atlantic,Eastern,33,2,70,0.4714285714285714,45,-12,38,-5
2018-19,2018-12-21,Detroit Red Wings,2,Atlantic,Eastern,35,2,72,0.4861111111111111,45,-10,40,-5
2018-19,2018-12-22,Detroit Red Wings,0,Atlantic,Eastern,35,2,74,0.47297297297297297,45,-10,40,-5
2018-19,2018-12-24,Detroit Red Wings,1,Atlantic,Eastern,36,2,76,0.47368421052631576,47,-11,42,-6
2018-19,2018-12-28,Detroit Red Wings,0,Atlantic,Eastern,36,2,78,0.46153846153846156,47,-11,43,-7
2018-19,2018-12-30,Detroit Red Wings,0,Atlantic,Eastern,36,2,80,0.45,48,-12,45,-9
2018-19,2019-01-01,Detroit Red Wings,1,Atlantic,Eastern,37,2,82,0.45121951219512196,48,-11,47,-10
2018-19,2019-01-03,Detroit Red Wings,0,Atlantic,Eastern,37,2,84,0.44047619047619047,48,-11,47,-10
2018-19,2019-01-05,Detroit Red Wings,2,Atlantic,Eastern,39,2,86,0.45348837209302323,50,-11,49,-10
2018-19,2019-01-06,Detroit Red Wings,0,Atlantic,Eastern,39,2,88,0.4431818181818182,52,-13,50,-11
2018-19,2019-01-09,Detroit Red Wings,0,Atlantic,Eastern,39,2,90,0.43333333333333335,54,-15,51,-12
2018-19,2019-01-12,Detroit Red Wings,0,Atlantic,Eastern,39,2,92,0.42391304347826086,54,-15,52,-13
2018-19,2019-01-13,Detroit Red Wings,2,Atlantic,Eastern,41,2,94,0.43617021276595747,56,-15,52,-11
2018-19,2019-01-16,Detroit Red Wings,2,Atlantic,Eastern,43,2,96,0.4479166666666667,57,-14,56,-13
2018-19,2019-01-19,Detroit Red Wings,0,Atlantic,Eastern,43,2,98,0.4387755102040816,59,-16,58,-15
2018-19,2019-01-20,Detroit Red Wings,0,Atlantic,Eastern,43,2,100,0.43,59,-16,58,-15
2018-19,2019-01-23,Detroit Red Wings,2,Atlantic,Eastern,45,2,102,0.4411764705882353,59,-14,58,-13
2018-19,2019-02-02,Detroit Red Wings,2,Atlantic,Eastern,47,2,104,0.4519230769230769,62,-15,59,-12
2018-19,2019-02-03,Detroit Red Wings,2,Atlantic,Eastern,49,2,106,0.46226415094339623,64,-15,59,-10
2018-19,2019-02-08,Detroit Red Wings,0,Atlantic,Eastern,49,2,108,0.4537037037037037,68,-19,63,-14
2018-19,2019-02-09,Detroit Red Wings,0,Atlantic,Eastern,49,2,110,0.44545454545454544,68,-19,63,-14
2018-19,2019-02-10,Detroit Red Wings,0,Atlantic,Eastern,49,2,112,0.4375,70,-21,63,-14
2018-19,2019-02-13,Detroit Red Wings,2,Atlantic,Eastern,51,2,114,0.4473684210526316,72,-21,65,-14
2018-19,2019-02-15,Detroit Red Wings,2,Atlantic,Eastern,53,2,116,0.45689655172413796,72,-19,67,-14
2018-19,2019-02-16,Detroit Red Wings,1,Atlantic,Eastern,54,2,118,0.4576271186440678,74,-20,67,-13
2018-19,2019-02-17,Detroit Red Wings,0,Atlantic,Eastern,54,2,120,0.45,75,-21,69,-15
2018-19,2019-02-21,Detroit Red Wings,1,Atlantic,Eastern,55,2,122,0.45081967213114754,76,-21,69,-14
2018-19,2019-02-23,Detroit Red Wings,0,Atlantic,Eastern,55,2,124,0.4435483870967742,76,-21,71,-16
2018-19,2019-02-24,Detroit Red Wings,0,Atlantic,Eastern,55,2,126,0.4365079365079365,78,-23,72,-17
2018-19,2019-02-27,Detroit Red Wings,0,Atlantic,Eastern,55,2,128,0.4296875,80,-25,74,-19
2018-19,2019-03-03,Detroit Red Wings,0,Atlantic,Eastern,55,2,130,0.4230769230769231,84,-29,77,-22
2018-19,2019-03-06,Detroit Red Wings,1,Atlantic,Eastern,56,2,132,0.42424242424242425,86,-30,79,-23
2018-19,2019-03-08,Detroit Red Wings,2,Atlantic,Eastern,58,2,134,0.43283582089552236,87,-29,79,-21
2018-19,2019-03-10,Detroit Red Wings,0,Atlantic,Eastern,58,2,136,0.4264705882352941,89,-31,79,-21
2018-19,2019-03-10,Detroit Red Wings,0,Atlantic,Eastern,58,2,138,0.42028985507246375,89,-31,79,-21
2018-19,2019-03-12,Detroit Red Wings,0,Atlantic,Eastern,58,2,140,0.4142857142857143,89,-31,81,-23
2018-19,2019-03-14,Detroit Red Wings,0,Atlantic,Eastern,58,2,142,0.4084507042253521,89,-31,81,-23
2018-19,2019-03-16,Detroit Red Wings,2,Atlantic,Eastern,60,2,144,0.4166666666666667,91,-31,84,-24
2018-19,2019-03-19,Detroit Red Wings,2,Atlantic,Eastern,62,2,146,0.4246575342465753,91,-29,84,-22
2018-19,2019-03-22,Detroit Red Wings,0,Atlantic,Eastern,62,2,148,0.4189189189189189,93,-31,85,-23
2018-19,2019-03-24,Detroit Red Wings,2,Atlantic,Eastern,64,2,150,0.4266666666666667,94,-30,88,-24
2018-19,2019-03-26,Detroit Red Wings,2,Atlantic,Eastern,66,2,152,0.4342105263157895,96,-30,90,-24
2018-19,2019-03-28,Detroit Red Wings,2,Atlantic,Eastern,68,2,154,0.44155844155844154,97,-29,90,-22
2018-19,2019-03-29,Detroit Red Wings,2,Atlantic,Eastern,70,2,156,0.44871794871794873,97,-27,90,-20
2018-19,2019-03-31,Detroit Red Wings,2,Atlantic,Eastern,72,2,158,0.45569620253164556,97,-25,92,-20
2018-19,2019-04-02,Detroit Red Wings,2,Atlantic,Eastern,74,2,160,0.4625,99,-25,94,-20
2018-19,2019-04-04,Detroit Red Wings,0,Atlantic,Eastern,74,2,162,0.4567901234567901,99,-25,94,-20
2018-19,2019-04-06,Detroit Red Wings,0,Atlantic,Eastern,74,2,164,0.45121951219512196,100,-26,98,-24
2018-19,2018-10-06,Edmonton Oilers,0,Pacific,Western,0,2,2,0.0,2,-2,2,-2
2018-19,2018-10-11,Edmonton Oilers,0,Pacific,Western,0,2,4,0.0,5,-5,4,-4
2018-19,2018-10-13,Edmonton Oilers,2,Pacific,Western,2,2,6,0.3333333333333333,5,-3,4,-2
2018-19,2018-10-17,Edmonton Oilers,2,Pacific,Western,4,2,8,0.5,6,-2,6,-2
2018-19,2018-10-19,Edmonton Oilers,2,Pacific,Western,6,2,10,0.6,8,-2,7,-1
2018-19,2018-10-21,Edmonton Oilers,0,Pacific,Western,6,2,12,0.5,10,-4,10,-4
2018-19,2018-10-24,Edmonton Oilers,1,Pacific,Western,7,2,14,0.5,10,-3,10,-3
2018-19,2018-10-26,Edmonton Oilers,2,Pacific,Western,9,2,16,0.5625,11,-2,11,-2
2018-19,2018-10-27,Edmonton Oilers,2,Pacific,Western,11,2,18,0.6111111111111112,11,0,11,0
2018-19,2018-10-28,Edmonton Oilers,2,Pacific,Western,13,2,20,0.65,12,1,12,1
2018-19,2018-10-31,Edmonton Oilers,0,Pacific,Western,13,2,22,0.5909090909090909,14,-1,14,-1
2018-19,2018-11-02,Edmonton Oilers,2,Pacific,Western,15,2,24,0.625,15,0,15,0
2018-19,2018-11-03,Edmonton Oilers,2,Pacific,Western,17,2,26,0.6538461538461539,17,0,16,1
2018-19,2018-11-06,Edmonton Oilers,0,Pacific,Western,17,2,28,0.6071428571428571,17,0,17,0
2018-19,2018-11-07,Edmonton Oilers,0,Pacific,Western,17,2,30,0.5666666666666667,19,-2,17,0
2018-19,2018-11-09,Edmonton Oilers,0,Pacific,Western,17,2,32,0.53125,19,-2,17,0
2018-19,2018-11-12,Edmonton Oilers,0,Pacific,Western,17,2,34,0.5,21,-4,19,-2
2018-19,2018-11-14,Edmonton Oilers,2,Pacific,Western,19,2,36,0.5277777777777778,21,-2,19,0
2018-19,2018-11-18,Edmonton Oilers,0,Pacific,Western,19,2,38,0.5,22,-3,22,-3
2018-19,2018-11-19,Edmonton Oilers,0,Pacific,Western,19,2,40,0.475,22,-3,22,-3
2018-19,2018-11-21,Edmonton Oilers,2,Pacific,Western,21,2,42,0.5,22,-1,22,-1
2018-19,2018-11-23,Edmonton Oilers,1,Pacific,Western,22,2,44,0.5,25,-3,24,-2
2018-19,2018-11-26,Edmonton Oilers,0,Pacific,Western,22,2,46,0.4782608695652174,25,-3,25,-3
2018-19,2018-11-28,Edmonton Oilers,2,Pacific,Western,24,2,48,0.5,27,-3,27,-3
2018-19,2018-11-30,Edmonton Oilers,2,Pacific,Western,26,2,50,0.52,29,-3,29,-3
2018-19,2018-12-02,Edmonton Oilers,2,Pacific,Western,28,2,52,0.5384615384615384,29,-1,29,-1
2018-19,2018-12-04,Edmonton Oilers,0,Pacific,Western,28,2,54,0.5185185185185185,31,-3,30,-2
2018-19,2018-12-06,Edmonton Oilers,2,Pacific,Western,30,2,56,0.5357142857142857,33,-3,32,-2
2018-19,2018-12-08,Edmonton Oilers,2,Pacific,Western,32,2,58,0.5517241379310345,33,-1,33,-1
2018-19,2018-12-10,Edmonton Oilers,2,Pacific,Western,34,2,60,0.5666666666666667,35,-1,35,-1
2018-19,2018-12-12,Edmonton Oilers,2,Pacific,Western,36,2,62,0.5806451612903226,37,-1,35,1
2018-19,2018-12-14,Edmonton Oilers,1,Pacific,Western,37,2,64,0.578125,39,-2,37,0
2018-19,2018-12-15,Edmonton Oilers,2,Pacific,Western,39,2,66,0.5909090909090909,39,0,38,1
2018-19,2018-12-17,Edmonton Oilers,0,Pacific,Western,39,2,68,0.5735294117647058,41,-2,39,0
2018-19,2018-12-19,Edmonton Oilers,0,Pacific,Western,39,2,70,0.5571428571428572,43,-4,39,0
2018-19,2018-12-23,Edmonton Oilers,0,Pacific,Western,39,2,72,0.5416666666666666,43,-4,39,0
2018-19,2018-12-28,Edmonton Oilers,0,Pacific,Western,39,2,74,0.527027027027027,46,-7,41,-2
2018-19,2018-12-29,Edmonton Oilers,0,Pacific,Western,39,2,76,0.5131578947368421,48,-9,41,-2
2018-19,2019-01-01,Edmonton Oilers,0,Pacific,Western,39,2,78,0.5,49,-10,44,-5
2018-19,2019-01-03,Edmonton Oilers,2,Pacific,Western,41,2,80,0.5125,51,-10,45,-4
2018-19,2019-01-06,Edmonton Oilers,0,Pacific,Western,41,2,82,0.5,53,-12,45,-4
2018-19,2019-01-07,Edmonton Oilers,2,Pacific,Western,43,2,84,0.5119047619047619,53,-10,45,-2
2018-19,2019-01-09,Edmonton Oilers,0,Pacific,Western,43,2,86,0.5,57,-14,45,-2
2018-19,2019-01-11,Edmonton Oilers,2,Pacific,Western,45,2,88,0.5113636363636364,58,-13,47,-2
2018-19,2019-01-13,Edmonton Oilers,0,Pacific,Western,45,2,90,0.5,60,-15,47,-2
2018-19,2019-01-15,Edmonton Oilers,2,Pacific,Western,47,2,92,0.5108695652173914,60,-13,47,0
2018-19,2019-01-17,Edmonton Oilers,2,Pacific,Western,49,2,94,0.5212765957446809,60,-11,49,0
2018-19,2019-01-20,Edmonton Oilers,0,Pacific,Western,49,2,96,0.5104166666666666,62,-13,52,-3
2018-19,2019-01-21,Edmonton Oilers,0,Pacific,Western,49,2,98,0.5,62,-13,52,-3
2018-19,2019-01-23,Edmonton Oilers,0,Pacific,Western,49,2,100,0.49,62,-13,52,-3
2018-19,2019-02-02,Edmonton Oilers,1,Pacific,Western,50,2,102,0.49019607843137253,62,-12,52,-2
2018-19,2019-02-03,Edmonton Oilers,1,Pacific,Western,51,2,104,0.49038461538461536,62,-11,54,-3
2018-19,2019-02-06,Edmonton Oilers,0,Pacific,Western,51,2,106,0.4811320754716981,64,-13,54,-3
2018-19,2019-02-08,Edmonton Oilers,2,Pacific,Western,53,2,108,0.49074074074074076,66,-13,55,-2
2018-19,2019-02-10,Edmonton Oilers,0,Pacific,Western,53,2,110,0.4818181818181818,66,-13,59,-6
2018-19,2019-02-14,Edmonton Oilers,0,Pacific,Western,53,2,112,0.4732142857142857,66,-13,59,-6
2018-19,2019-02-16,Edmonton Oilers,0,Pacific,Western,53,2,114,0.4649122807017544,66,-13,60,-7
2018-19,2019-02-17,Edmonton Oilers,0,Pacific,Western,53,2,116,0.45689655172413796,68,-15,60,-7
2018-19,2019-02-20,Edmonton Oilers,1,Pacific,Western,54,2,118,0.4576271186440678,68,-14,60,-6
2018-19,2019-02-22,Edmonton Oilers,2,Pacific,Western,56,2,120,0.4666666666666667,69,-13,62,-6
2018-19,2019-02-24,Edmonton Oilers,2,Pacific,Western,58,2,122,0.47540983606557374,69,-11,65,-7
2018-19,2019-02-26,Edmonton Oilers,1,Pacific,Western,59,2,124,0.47580645161290325,69,-10,66,-7
2018-19,2019-02-28,Edmonton Oilers,0,Pacific,Western,59,2,126,0.46825396825396826,71,-12,68,-9
2018-19,2019-03-01,Edmonton Oilers,2,Pacific,Western,61,2,128,0.4765625,73,-12,68,-7
2018-19,2019-03-02,Edmonton Oilers,2,Pacific,Western,63,2,130,0.4846153846153846,75,-12,68,-5
2018-19,2019-03-05,Edmonton Oilers,2,Pacific,Western,65,2,132,0.49242424242424243,77,-12,71,-6
2018-19,2019-03-08,Edmonton Oilers,2,Pacific,Western,67,2,134,0.5,79,-12,74,-7
2018-19,2019-03-10,Edmonton Oilers,0,Pacific,Western,67,2,136,0.49264705882352944,81,-14,74,-7
2018-19,2019-03-12,Edmonton Oilers,2,Pacific,Western,69,2,138,0.5,81,-12,74,-5
2018-19,2019-03-14,Edmonton Oilers,0,Pacific,Western,69,2,140,0.4928571428571429,81,-12,75,-6
2018-19,2019-03-17,Edmonton Oilers,2,Pacific,Western,71,2,142,0.5,83,-12,78,-7
2018-19,2019-03-18,Edmonton Oilers,0,Pacific,Western,71,2,144,0.4930555555555556,85,-14,78,-7
2018-19,2019-03-20,Edmonton Oilers,0,Pacific,Western,71,2,146,0.4863013698630137,87,-16,78,-7
2018-19,2019-03-22,Edmonton Oilers,2,Pacific,Western,73,2,148,0.49324324324324326,89,-16,79,-6
2018-19,2019-03-23,Edmonton Oilers,1,Pacific,Western,74,2,150,0.49333333333333335,89,-15,80,-6
2018-19,2019-03-27,Edmonton Oilers,2,Pacific,Western,76,2,152,0.5,90,-14,81,-5
2018-19,2019-03-29,Edmonton Oilers,1,Pacific,Western,77,2,154,0.5,90,-13,83,-6
2018-19,2019-03-31,Edmonton Oilers,0,Pacific,Western,77,2,156,0.4935897435897436,91,-14,85,-8
2018-19,2019-04-02,Edmonton Oilers,0,Pacific,Western,77,2,158,0.4873417721518987,93,-16,86,-9
2018-19,2019-04-03,Edmonton Oilers,0,Pacific,Western,77,2,160,0.48125,93,-16,88,-11
2018-19,2019-04-05,Edmonton Oilers,0,Pacific,Western,77,2,162,0.47530864197530864,93,-16,90,-13
2018-19,2019-04-07,Edmonton Oilers,2,Pacific,Western,79,2,164,0.4817073170731707,93,-14,90,-11
2018-19,2018-10-06,Florida Panthers,1,Atlantic,Eastern,1,2,2,0.5,2,-1,2,-1
2018-19,2018-10-11,Florida Panthers,0,Atlantic,Eastern,1,2,4,0.25,4,-3,4,-3
2018-19,2018-10-13,Florida Panthers,0,Atlantic,Eastern,1,2,6,0.16666666666666666,5,-4,5,-4
2018-19,2018-10-16,Florida Panthers,1,Atlantic,Eastern,2,2,8,0.25,7,-5,6,-4
2018-19,2018-10-19,Florida Panthers,2,Atlantic,Eastern,4,2,10,0.4,9,-5,8,-4
2018-19,2018-10-20,Florida Panthers,1,Atlantic,Eastern,5,2,12,0.4166666666666667,9,-4,8,-3
2018-19,2018-10-23,Florida Panthers,0,Atlantic,Eastern,5,2,14,0.35714285714285715,12,-7,9,-4
2018-19,2018-10-24,Florida Panthers,2,Atlantic,Eastern,7,2,16,0.4375,12,-5,10,-3
2018-19,2018-10-27,Florida Panthers,0,Atlantic,Eastern,7,2,18,0.3888888888888889,14,-7,12,-5
2018-19,2018-11-02,Florida Panthers,0,Atlantic,Eastern,7,2,20,0.35,16,-9,14,-7
2018-19,2018-11-03,Florida Panthers,2,Atlantic,Eastern,9,2,22,0.4090909090909091,16,-7,14,-5
2018-19,2018-11-09,Florida Panthers,2,Atlantic,Eastern,11,2,24,0.4583333333333333,19,-8,17,-6
2018-19,2018-11-11,Florida Panthers,2,Atlantic,Eastern,13,2,26,0.5,21,-8,18,-5
2018-19,2018-11-11,Florida Panthers,2,Atlantic,Eastern,15,2,28,0.5357142857142857,21,-6,18,-3
2018-19,2018-11-14,Florida Panthers,2,Atlantic,Eastern,17,2,30,0.5666666666666667,22,-5,20,-3
2018-19,2018-11-16,Florida Panthers,0,Atlantic,Eastern,17,2,32,0.53125,23,-6,20,-3
2018-19,2018-11-18,Florida Panthers,0,Atlantic,Eastern,17,2,34,0.5,26,-9,22,-5
2018-19,2018-11-20,Florida Panthers,2,Atlantic,Eastern,19,2,36,0.5277777777777778,28,-9,23,-4
2018-19,2018-11-22,Florida Panthers,0,Atlantic,Eastern,19,2,38,0.5,30,-11,25,-6
2018-19,2018-11-24,Florida Panthers,0,Atlantic,Eastern,19,2,40,0.475,30,-11,26,-7
2018-19,2018-11-25,Florida Panthers,1,Atlantic,Eastern,20,2,42,0.47619047619047616,32,-12,26,-6
2018-19,2018-11-27,Florida Panthers,2,Atlantic,Eastern,22,2,44,0.5,34,-12,27,-5
2018-19,2018-11-29,Florida Panthers,0,Atlantic,Eastern,22,2,46,0.4782608695652174,35,-13,27,-5
2018-19,2018-12-01,Florida Panthers,2,Atlantic,Eastern,24,2,48,0.5,36,-12,28,-4
2018-19,2018-12-02,Florida Panthers,1,Atlantic,Eastern,25,2,50,0.5,37,-12,29,-4
2018-19,2018-12-05,Florida Panthers,2,Atlantic,Eastern,27,2,52,0.5192307692307693,38,-11,29,-2
2018-19,2018-12-07,Florida Panthers,0,Atlantic,Eastern,27,2,54,0.5,38,-11,30,-3
2018-19,2018-12-09,Florida Panthers,1,Atlantic,Eastern,28,2,56,0.5,38,-10,31,-3
2018-19,2018-12-12,Florida Panthers,0,Atlantic,Eastern,28,2,58,0.4827586206896552,40,-12,32,-4
2018-19,2018-12-14,Florida Panthers,0,Atlantic,Eastern,28,2,60,0.4666666666666667,42,-14,32,-4
2018-19,2018-12-16,Florida Panthers,2,Atlantic,Eastern,30,2,62,0.4838709677419355,44,-14,36,-6
2018-19,2018-12-19,Florida Panthers,2,Atlantic,Eastern,32,2,64,0.5,45,-13,38,-6
2018-19,2018-12-21,Florida Panthers,0,Atlantic,Eastern,32,2,66,0.48484848484848486,45,-13,40,-8
2018-19,2018-12-22,Florida Panthers,2,Atlantic,Eastern,34,2,68,0.5,45,-11,40,-6
2018-19,2018-12-24,Florida Panthers,2,Atlantic,Eastern,36,2,70,0.5142857142857142,47,-11,42,-6
2018-19,2018-12-29,Florida Panthers,0,Atlantic,Eastern,36,2,72,0.5,47,-11,44,-8
2018-19,2018-12-30,Florida Panthers,2,Atlantic,Eastern,38,2,74,0.5135135135135135,48,-10,45,-7
2018-19,2019-01-01,Florida Panthers,2,Atlantic,Eastern,40,2,76,0.5263157894736842,48,-8,47,-7
2018-19,2019-01-04,Florida Panthers,0,Atlantic,Eastern,40,2,78,0.5128205128205128,50,-10,49,-9
2018-19,2019-01-06,Florida Panthers,1,Atlantic,Eastern,41,2,80,0.5125,52,-11,50,-9
2018-19,2019-01-09,Florida Panthers,0,Atlantic,Eastern,41,2,82,0.5,54,-13,51,-10
2018-19,2019-01-11,Florida Panthers,1,Atlantic,Eastern,42,2,84,0.5,54,-12,52,-10
2018-19,2019-01-12,Florida Panthers,0,Atlantic,Eastern,42,2,86,0.4883720930232558,54,-12,52,-10
2018-19,2019-01-14,Florida Panthers,0,Atlantic,Eastern,42,2,88,0.4772727272727273,56,-14,53,-11
2018-19,2019-01-16,Florida Panthers,0,Atlantic,Eastern,42,2,90,0.4666666666666667,57,-15,56,-14
2018-19,2019-01-19,Florida Panthers,2,Atlantic,Eastern,44,2,92,0.4782608695652174,59,-15,58,-14
2018-19,2019-01-20,Florida Panthers,2,Atlantic,Eastern,46,2,94,0.48936170212765956,59,-13,58,-12
2018-19,2019-01-22,Florida Panthers,2,Atlantic,Eastern,48,2,96,0.5,59,-11,58,-10
2018-19,2019-02-02,Florida Panthers,0,Atlantic,Eastern,48,2,98,0.4897959183673469,62,-14,59,-11
2018-19,2019-02-03,Florida Panthers,2,Atlantic,Eastern,50,2,100,0.5,64,-14,59,-9
2018-19,2019-02-06,Florida Panthers,0,Atlantic,Eastern,50,2,102,0.49019607843137253,66,-16,61,-11
2018-19,2019-02-08,Florida Panthers,2,Atlantic,Eastern,52,2,104,0.5,68,-16,63,-11
2018-19,2019-02-10,Florida Panthers,2,Atlantic,Eastern,54,2,106,0.5094339622641509,70,-16,63,-9
2018-19,2019-02-10,Florida Panthers,0,Atlantic,Eastern,54,2,108,0.5,70,-16,63,-9
2018-19,2019-02-13,Florida Panthers,0,Atlantic,Eastern,54,2,110,0.4909090909090909,72,-18,65,-11
2018-19,2019-02-15,Florida Panthers,2,Atlantic,Eastern,56,2,112,0.5,72,-16,67,-11
2018-19,2019-02-18,Florida Panthers,2,Atlantic,Eastern,58,2,114,0.5087719298245614,75,-17,69,-11
2018-19,2019-02-20,Florida Panthers,2,Atlantic,Eastern,60,2,116,0.5172413793103449,76,-16,69,-9
2018-19,2019-02-22,Florida Panthers,0,Atlantic,Eastern,60,2,118,0.5084745762711864,76,-16,70,-10
2018-19,2019-02-23,Florida Panthers,2,Atlantic,Eastern,62,2,120,0.5166666666666667,76,-14,71,-9
2018-19,2019-02-26,Florida Panthers,2,Atlantic,Eastern,64,2,122,0.5245901639344263,80,-16,72,-8
2018-19,2019-02-27,Florida Panthers,1,Atlantic,Eastern,65,2,124,0.5241935483870968,80,-15,74,-9
2018-19,2019-03-01,Florida Panthers,1,Atlantic,Eastern,66,2,126,0.5238095238095238,82,-16,74,-8
2018-19,2019-03-03,Florida Panthers,1,Atlantic,Eastern,67,2,128,0.5234375,84,-17,77,-10
2018-19,2019-03-03,Florida Panthers,0,Atlantic,Eastern,67,2,130,0.5153846153846153,84,-17,77,-10
2018-19,2019-03-06,Florida Panthers,1,Atlantic,Eastern,68,2,132,0.5151515151515151,86,-18,79,-11
2018-19,2019-03-08,Florida Panthers,0,Atlantic,Eastern,68,2,134,0.5074626865671642,87,-19,79,-11
2018-19,2019-03-09,Florida Panthers,2,Atlantic,Eastern,70,2,136,0.5147058823529411,87,-17,79,-9
2018-19,2019-03-10,Florida Panthers,2,Atlantic,Eastern,72,2,138,0.5217391304347826,89,-17,79,-7
2018-19,2019-03-15,Florida Panthers,2,Atlantic,Eastern,74,2,140,0.5285714285714286,91,-17,83,-9
2018-19,2019-03-16,Florida Panthers,2,Atlantic,Eastern,76,2,142,0.5352112676056338,91,-15,84,-8
2018-19,2019-03-18,Florida Panthers,0,Atlantic,Eastern,76,2,144,0.5277777777777778,91,-15,84,-8
2018-19,2019-03-20,Florida Panthers,0,Atlantic,Eastern,76,2,146,0.5205479452054794,93,-17,84,-8
2018-19,2019-03-21,Florida Panthers,2,Atlantic,Eastern,78,2,148,0.527027027027027,93,-15,85,-7
2018-19,2019-03-23,Florida Panthers,0,Atlantic,Eastern,78,2,150,0.52,94,-16,87,-9
2018-19,2019-03-25,Florida Panthers,0,Atlantic,Eastern,78,2,152,0.5131578947368421,96,-18,88,-10
2018-19,2019-03-26,Florida Panthers,0,Atlantic,Eastern,78,2,154,0.5064935064935064,96,-18,90,-12
2018-19,2019-03-28,Florida Panthers,2,Atlantic,Eastern,80,2,156,0.5128205128205128,97,-17,90,-10
2018-19,2019-03-30,Florida Panthers,2,Atlantic,Eastern,82,2,158,0.5189873417721519,97,-15,92,-10
2018-19,2019-04-01,Florida Panthers,2,Atlantic,Eastern,84,2,160,0.525,99,-15,92,-8
2018-19,2019-04-04,Florida Panthers,1,Atlantic,Eastern,85,2,162,0.5246913580246914,99,-14,94,-9
2018-19,2019-04-06,Florida Panthers,1,Atlantic,Eastern,86,2,164,0.524390243902439,100,-14,98,-12
2018-19,2018-10-06,Los Angeles Kings,1,Pacific,Western,1,2,2,0.5,2,-1,2,-1
2018-19,2018-10-08,Los Angeles Kings,2,Pacific,Western,3,2,4,0.75,2,1,2,1
2018-19,2018-10-10,Los Angeles Kings,0,Pacific,Western,3,2,6,0.5,4,-1,4,-1
2018-19,2018-10-11,Los Angeles Kings,2,Pacific,Western,5,2,8,0.625,5,0,4,1
2018-19,2018-10-13,Los Angeles Kings,0,Pacific,Western,5,2,10,0.5,5,0,4,1
2018-19,2018-10-15,Los Angeles Kings,0,Pacific,Western,5,2,12,0.4166666666666667,6,-1,6,-1
2018-19,2018-10-19,Los Angeles Kings,0,Pacific,Western,5,2,14,0.35714285714285715,8,-3,7,-2
2018-19,2018-10-20,Los Angeles Kings,0,Pacific,Western,5,2,16,0.3125,8,-3,8,-3
2018-19,2018-10-24,Los Angeles Kings,0,Pacific,Western,5,2,18,0.2777777777777778,10,-5,10,-5
2018-19,2018-10-26,Los Angeles Kings,0,Pacific,Western,5,2,20,0.25,11,-6,11,-6
2018-19,2018-10-28,Los Angeles Kings,2,Pacific,Western,7,2,22,0.3181818181818182,12,-5,12,-5
2018-19,2018-11-02,Los Angeles Kings,0,Pacific,Western,7,2,24,0.2916666666666667,15,-8,15,-8
2018-19,2018-11-04,Los Angeles Kings,2,Pacific,Western,9,2,26,0.34615384615384615,17,-8,17,-8
2018-19,2018-11-07,Los Angeles Kings,2,Pacific,Western,11,2,28,0.39285714285714285,19,-8,17,-6
2018-19,2018-11-09,Los Angeles Kings,0,Pacific,Western,11,2,30,0.36666666666666664,19,-8,17,-6
2018-19,2018-11-11,Los Angeles Kings,0,Pacific,Western,11,2,32,0.34375,19,-8,17,-6
2018-19,2018-11-14,Los Angeles Kings,0,Pacific,Western,11,2,34,0.3235294117647059,21,-10,19,-8
2018-19,2018-11-17,Los Angeles Kings,2,Pacific,Western,13,2,36,0.3611111111111111,21,-8,21,-8
2018-19,2018-11-18,Los Angeles Kings,0,Pacific,Western,13,2,38,0.34210526315789475,22,-9,22,-9
2018-19,2018-11-20,Los Angeles Kings,2,Pacific,Western,15,2,40,0.375,22,-7,22,-7
2018-19,2018-11-22,Los Angeles Kings,0,Pacific,Western,15,2,42,0.35714285714285715,23,-8,23,-8
2018-19,2018-11-25,Los Angeles Kings,0,Pacific,Western,15,2,44,0.3409090909090909,25,-10,25,-10
2018-19,2018-11-26,Los Angeles Kings,2,Pacific,Western,17,2,46,0.3695652173913043,25,-8,25,-8
2018-19,2018-11-28,Los Angeles Kings,2,Pacific,Western,19,2,48,0.3958333333333333,27,-8,27,-8
2018-19,2018-11-30,Los Angeles Kings,0,Pacific,Western,19,2,50,0.38,29,-10,29,-10
2018-19,2018-12-01,Los Angeles Kings,0,Pacific,Western,19,2,52,0.36538461538461536,29,-10,29,-10
2018-19,2018-12-03,Los Angeles Kings,2,Pacific,Western,21,2,54,0.3888888888888889,31,-10,30,-9
2018-19,2018-12-05,Los Angeles Kings,0,Pacific,Western,21,2,56,0.375,31,-10,31,-10
2018-19,2018-12-07,Los Angeles Kings,0,Pacific,Western,21,2,58,0.3620689655172414,33,-12,33,-12
2018-19,2018-12-08,Los Angeles Kings,2,Pacific,Western,23,2,60,0.38333333333333336,33,-10,33,-10
2018-19,2018-12-11,Los Angeles Kings,0,Pacific,Western,23,2,62,0.3709677419354839,37,-14,35,-12
2018-19,2018-12-12,Los Angeles Kings,1,Pacific,Western,24,2,64,0.375,37,-13,35,-11
2018-19,2018-12-14,Los Angeles Kings,0,Pacific,Western,24,2,66,0.36363636363636365,39,-15,37,-13
2018-19,2018-12-16,Los Angeles Kings,1,Pacific,Western,25,2,68,0.36764705882352944,40,-15,39,-14
2018-19,2018-12-19,Los Angeles Kings,2,Pacific,Western,27,2,70,0.38571428571428573,43,-16,39,-12
2018-19,2018-12-22,Los Angeles Kings,2,Pacific,Western,29,2,72,0.4027777777777778,43,-14,39,-10
2018-19,2018-12-24,Los Angeles Kings,2,Pacific,Western,31,2,74,0.4189189189189189,44,-13,39,-8
2018-19,2018-12-28,Los Angeles Kings,2,Pacific,Western,33,2,76,0.4342105263157895,46,-13,41,-8
2018-19,2018-12-29,Los Angeles Kings,0,Pacific,Western,33,2,78,0.4230769230769231,48,-15,41,-8
2018-19,2019-01-01,Los Angeles Kings,2,Pacific,Western,35,2,80,0.4375,49,-14,44,-9
2018-19,2019-01-02,Los Angeles Kings,0,Pacific,Western,35,2,82,0.4268292682926829,49,-14,44,-9
2018-19,2019-01-04,Los Angeles Kings,0,Pacific,Western,35,2,84,0.4166666666666667,51,-16,45,-10
2018-19,2019-01-06,Los Angeles Kings,2,Pacific,Western,37,2,86,0.43023255813953487,53,-16,45,-8
2018-19,2019-01-08,Los Angeles Kings,0,Pacific,Western,37,2,88,0.42045454545454547,55,-18,45,-8
2018-19,2019-01-11,Los Angeles Kings,0,Pacific,Western,37,2,90,0.4111111111111111,58,-21,47,-10
2018-19,2019-01-13,Los Angeles Kings,2,Pacific,Western,39,2,92,0.42391304347826086,60,-21,47,-8
2018-19,2019-01-16,Los Angeles Kings,1,Pacific,Western,40,2,94,0.425531914893617,60,-20,49,-9
2018-19,2019-01-18,Los Angeles Kings,2,Pacific,Western,42,2,96,0.4375,60,-18,49,-7
2018-19,2019-01-19,Los Angeles Kings,0,Pacific,Western,42,2,98,0.42857142857142855,60,-18,50,-8
2018-19,2019-01-21,Los Angeles Kings,2,Pacific,Western,44,2,100,0.44,62,-18,52,-8
2018-19,2019-02-03,Los Angeles Kings,0,Pacific,Western,44,2,102,0.43137254901960786,62,-18,54,-10
2018-19,2019-02-05,Los Angeles Kings,2,Pacific,Western,46,2,104,0.4423076923076923,62,-16,54,-8
2018-19,2019-02-06,Los Angeles Kings,2,Pacific,Western,48,2,106,0.4528301886792453,64,-16,54,-6
2018-19,2019-02-08,Los Angeles Kings,2,Pacific,Western,50,2,108,0.46296296296296297,66,-16,55,-5
2018-19,2019-02-09,Los Angeles Kings,1,Pacific,Western,51,2,110,0.4636363636363636,66,-15,57,-6
2018-19,2019-02-12,Los Angeles Kings,0,Pacific,Western,51,2,112,0.45535714285714285,66,-15,59,-8
2018-19,2019-02-15,Los Angeles Kings,1,Pacific,Western,52,2,114,0.45614035087719296,66,-14,59,-7
2018-19,2019-02-17,Los Angeles Kings,0,Pacific,Western,52,2,116,0.4482758620689655,68,-16,60,-8
2018-19,2019-02-19,Los Angeles Kings,0,Pacific,Western,52,2,118,0.4406779661016949,68,-16,60,-8
2018-19,2019-02-22,Los Angeles Kings,0,Pacific,Western,52,2,120,0.43333333333333335,69,-17,62,-10
2018-19,2019-02-23,Los Angeles Kings,0,Pacific,Western,52,2,122,0.4262295081967213,69,-17,64,-12
2018-19,2019-02-26,Los Angeles Kings,1,Pacific,Western,53,2,124,0.4274193548387097,69,-16,66,-13
2018-19,2019-02-27,Los Angeles Kings,0,Pacific,Western,53,2,126,0.42063492063492064,71,-18,67,-14
2018-19,2019-03-01,Los Angeles Kings,1,Pacific,Western,54,2,128,0.421875,73,-19,68,-14
2018-19,2019-03-02,Los Angeles Kings,2,Pacific,Western,56,2,130,0.4307692307692308,75,-19,68,-12
2018-19,2019-03-06,Los Angeles Kings,0,Pacific,Western,56,2,132,0.42424242424242425,77,-21,72,-16
2018-19,2019-03-08,Los Angeles Kings,0,Pacific,Western,56,2,134,0.417910447761194,79,-23,74,-18
2018-19,2019-03-10,Los Angeles Kings,0,Pacific,Western,56,2,136,0.4117647058823529,81,-25,74,-18
2018-19,2019-03-11,Los Angeles Kings,2,Pacific,Western,58,2,138,0.42028985507246375,81,-23,74,-16
2018-19,2019-03-15,Los Angeles Kings,0,Pacific,Western,58,2,140,0.4142857142857143,81,-23,77,-19
2018-19,2019-03-16,Los Angeles Kings,0,Pacific,Western,58,2,142,0.4084507042253521,83,-25,77,-19
2018-19,2019-03-19,Los Angeles Kings,0,Pacific,Western,58,2,144,0.4027777777777778,87,-29,78,-20
2018-19,2019-03-22,Los Angeles Kings,2,Pacific,Western,60,2,146,0.410958904109589,89,-29,79,-19
2018-19,2019-03-24,Los Angeles Kings,2,Pacific,Western,62,2,148,0.4189189189189189,90,-28,80,-18
2018-19,2019-03-26,Los Angeles Kings,2,Pacific,Western,64,2,150,0.4266666666666667,90,-26,81,-17
2018-19,2019-03-27,Los Angeles Kings,0,Pacific,Western,64,2,152,0.42105263157894735,90,-26,81,-17
2018-19,2019-03-29,Los Angeles Kings,1,Pacific,Western,65,2,154,0.42207792207792205,90,-25,83,-18
2018-19,2019-03-31,Los Angeles Kings,2,Pacific,Western,67,2,156,0.42948717948717946,91,-24,85,-18
2018-19,2019-04-02,Los Angeles Kings,0,Pacific,Western,67,2,158,0.4240506329113924,93,-26,86,-19
2018-19,2019-04-03,Los Angeles Kings,2,Pacific,Western,69,2,160,0.43125,93,-24,88,-19
2018-19,2019-04-06,Los Angeles Kings,0,Pacific,Western,69,2,162,0.42592592592592593,93,-24,90,-21
2018-19,2019-04-07,Los Angeles Kings,2,Pacific,Western,71,2,164,0.4329268292682927,93,-22,90,-19
2018-19,2018-10-05,Minnesota Wild,0,Central,Western,0,2,2,0.0,2,-2,0,0
2018-19,2018-10-07,Minnesota Wild,1,Central,Western,1,2,4,0.25,4,-3,2,-1
2018-19,2018-10-12,Minnesota Wild,2,Central,Western,3,2,6,0.5,6,-3,4,-1
2018-19,2018-10-13,Minnesota Wild,1,Central,Western,4,2,8,0.5,6,-2,4,0
2018-19,2018-10-16,Minnesota Wild,0,Central,Western,4,2,10,0.4,8,-4,6,-2
2018-19,2018-10-17,Minnesota Wild,2,Central,Western,6,2,12,0.5,8,-2,6,0
2018-19,2018-10-20,Minnesota Wild,2,Central,Western,8,2,14,0.5714285714285714,11,-3,8,0
2018-19,2018-10-21,Minnesota Wild,2,Central,Western,10,2,16,0.625,11,-1,10,0
2018-19,2018-10-26,Minnesota Wild,2,Central,Western,12,2,18,0.6666666666666666,14,-2,11,1
2018-19,2018-10-28,Minnesota Wild,2,Central,Western,14,2,20,0.7,15,-1,12,2
2018-19,2018-10-30,Minnesota Wild,0,Central,Western,14,2,22,0.6363636363636364,15,-1,14,0
2018-19,2018-10-31,Minnesota Wild,2,Central,Western,16,2,24,0.6666666666666666,16,0,14,2
2018-19,2018-11-04,Minnesota Wild,2,Central,Western,18,2,26,0.6923076923076923,17,1,17,1
2018-19,2018-11-07,Minnesota Wild,0,Central,Western,18,2,28,0.6428571428571429,17,1,17,1
2018-19,2018-11-09,Minnesota Wild,2,Central,Western,20,2,30,0.6666666666666666,19,1,17,3
2018-19,2018-11-10,Minnesota Wild,2,Central,Western,22,2,32,0.6875,20,2,17,5
2018-19,2018-11-11,Minnesota Wild,2,Central,Western,24,2,34,0.7058823529411765,20,4,17,7
2018-19,2018-11-14,Minnesota Wild,0,Central,Western,24,2,36,0.6666666666666666,21,3,19,5
2018-19,2018-11-16,Minnesota Wild,2,Central,Western,26,2,38,0.6842105263157895,23,3,20,6
2018-19,2018-11-17,Minnesota Wild,0,Central,Western,26,2,40,0.65,24,2,21,5
2018-19,2018-11-18,Minnesota Wild,0,Central,Western,26,2,42,0.6190476190476191,24,2,22,4
2018-19,2018-11-22,Minnesota Wild,2,Central,Western,28,2,44,0.6363636363636364,26,2,23,5
2018-19,2018-11-23,Minnesota Wild,2,Central,Western,30,2,46,0.6521739130434783,26,4,24,6
2018-19,2018-11-28,Minnesota Wild,0,Central,Western,30,2,48,0.625,30,0,27,3
2018-19,2018-11-30,Minnesota Wild,0,Central,Western,30,2,50,0.6,30,0,29,1
2018-19,2018-12-02,Minnesota Wild,0,Central,Western,30,2,52,0.5769230769230769,34,-4,29,1
2018-19,2018-12-05,Minnesota Wild,2,Central,Western,32,2,54,0.5925925925925926,36,-4,31,1
2018-19,2018-12-07,Minnesota Wild,0,Central,Western,32,2,56,0.5714285714285714,36,-4,33,-1
2018-19,2018-12-08,Minnesota Wild,0,Central,Western,32,2,58,0.5517241379310345,36,-4,33,-1
2018-19,2018-12-12,Minnesota Wild,2,Central,Western,34,2,60,0.5666666666666667,39,-5,35,-1
2018-19,2018-12-14,Minnesota Wild,2,Central,Western,36,2,62,0.5806451612903226,39,-3,37,-1
2018-19,2018-12-15,Minnesota Wild,0,Central,Western,36,2,64,0.5625,40,-4,38,-2
2018-19,2018-12-19,Minnesota Wild,0,Central,Western,36,2,66,0.5454545454545454,42,-6,39,-3
2018-19,2018-12-21,Minnesota Wild,0,Central,Western,36,2,68,0.5294117647058824,44,-8,39,-3
2018-19,2018-12-23,Minnesota Wild,1,Central,Western,37,2,70,0.5285714285714286,44,-7,39,-2
2018-19,2018-12-28,Minnesota Wild,0,Central,Western,37,2,72,0.5138888888888888,44,-7,41,-4
2018-19,2018-12-29,Minnesota Wild,2,Central,Western,39,2,74,0.527027027027027,44,-5,41,-2
2018-19,2018-12-31,Minnesota Wild,0,Central,Western,39,2,76,0.5131578947368421,45,-6,43,-4
2018-19,2019-01-03,Minnesota Wild,2,Central,Western,41,2,78,0.5256410256410257,46,-5,45,-4
2018-19,2019-01-05,Minnesota Wild,2,Central,Western,43,2,80,0.5375,48,-5,45,-2
2018-19,2019-01-08,Minnesota Wild,2,Central,Western,45,2,82,0.5487804878048781,48,-3,45,0
2018-19,2019-01-09,Minnesota Wild,0,Central,Western,45,2,84,0.5357142857142857,50,-5,45,0
2018-19,2019-01-11,Minnesota Wild,2,Central,Western,47,2,86,0.5465116279069767,50,-3,47,0
2018-19,2019-01-13,Minnesota Wild,0,Central,Western,47,2,88,0.5340909090909091,50,-3,47,0
2018-19,2019-01-15,Minnesota Wild,0,Central,Western,47,2,90,0.5222222222222223,50,-3,47,0
2018-19,2019-01-16,Minnesota Wild,2,Central,Western,49,2,92,0.532608695652174,50,-1,49,0
2018-19,2019-01-18,Minnesota Wild,0,Central,Western,49,2,94,0.5212765957446809,50,-1,49,0
2018-19,2019-01-20,Minnesota Wild,2,Central,Western,51,2,96,0.53125,52,-1,52,-1
2018-19,2019-01-21,Minnesota Wild,2,Central,Western,53,2,98,0.5408163265306123,53,0,52,1
2018-19,2019-01-24,Minnesota Wild,2,Central,Western,55,2,100,0.55,55,0,52,3
2018-19,2019-02-02,Minnesota Wild,0,Central,Western,55,2,102,0.5392156862745098,56,-1,52,3
2018-19,2019-02-03,Minnesota Wild,1,Central,Western,56,2,104,0.5384615384615384,58,-2,54,2
2018-19,2019-02-06,Minnesota Wild,1,Central,Western,57,2,106,0.5377358490566038,60,-3,54,3
2018-19,2019-02-08,Minnesota Wild,0,Central,Western,57,2,108,0.5277777777777778,61,-4,55,2
2018-19,2019-02-09,Minnesota Wild,2,Central,Western,59,2,110,0.5363636363636364,61,-2,57,2
2018-19,2019-02-10,Minnesota Wild,0,Central,Western,59,2,112,0.5267857142857143,61,-2,59,0
2018-19,2019-02-13,Minnesota Wild,0,Central,Western,59,2,114,0.5175438596491229,63,-4,59,0
2018-19,2019-02-16,Minnesota Wild,1,Central,Western,60,2,116,0.5172413793103449,65,-5,60,0
2018-19,2019-02-17,Minnesota Wild,0,Central,Western,60,2,118,0.5084745762711864,67,-7,60,0
2018-19,2019-02-20,Minnesota Wild,0,Central,Western,60,2,120,0.5,69,-9,60,0
2018-19,2019-02-22,Minnesota Wild,2,Central,Western,62,2,122,0.5081967213114754,69,-7,62,0
2018-19,2019-02-23,Minnesota Wild,2,Central,Western,64,2,124,0.5161290322580645,71,-7,64,0
2018-19,2019-02-25,Minnesota Wild,2,Central,Western,66,2,126,0.5238095238095238,72,-6,66,0
2018-19,2019-02-27,Minnesota Wild,2,Central,Western,68,2,128,0.53125,74,-6,67,1
2018-19,2019-03-03,Minnesota Wild,2,Central,Western,70,2,130,0.5384615384615384,74,-4,70,0
2018-19,2019-03-04,Minnesota Wild,1,Central,Western,71,2,132,0.5378787878787878,74,-3,71,0
2018-19,2019-03-06,Minnesota Wild,1,Central,Western,72,2,134,0.5373134328358209,74,-2,72,0
2018-19,2019-03-08,Minnesota Wild,2,Central,Western,74,2,136,0.5441176470588235,78,-4,74,0
2018-19,2019-03-09,Minnesota Wild,0,Central,Western,74,2,138,0.5362318840579711,79,-5,74,0
2018-19,2019-03-12,Minnesota Wild,0,Central,Western,74,2,140,0.5285714285714286,79,-5,74,0
2018-19,2019-03-15,Minnesota Wild,0,Central,Western,74,2,142,0.5211267605633803,79,-5,77,-3
2018-19,2019-03-17,Minnesota Wild,2,Central,Western,76,2,144,0.5277777777777778,82,-6,78,-2
2018-19,2019-03-17,Minnesota Wild,1,Central,Western,77,2,146,0.5273972602739726,82,-5,78,-1
2018-19,2019-03-20,Minnesota Wild,0,Central,Western,77,2,148,0.5202702702702703,84,-7,78,-1
2018-19,2019-03-22,Minnesota Wild,2,Central,Western,79,2,150,0.5266666666666666,86,-7,79,0
2018-19,2019-03-23,Minnesota Wild,0,Central,Western,79,2,152,0.5197368421052632,86,-7,80,-1
2018-19,2019-03-26,Minnesota Wild,0,Central,Western,79,2,154,0.512987012987013,90,-11,81,-2
2018-19,2019-03-30,Minnesota Wild,2,Central,Western,81,2,156,0.5192307692307693,92,-11,85,-4
2018-19,2019-03-31,Minnesota Wild,0,Central,Western,81,2,158,0.5126582278481012,92,-11,85,-4
2018-19,2019-04-03,Minnesota Wild,2,Central,Western,83,2,160,0.51875,94,-11,88,-5
2018-19,2019-04-05,Minnesota Wild,0,Central,Western,83,2,162,0.5123456790123457,97,-14,90,-7
2018-19,2019-04-07,Minnesota Wild,0,Central,Western,83,2,164,0.5060975609756098,99,-16,90,-7
2018-19,2018-10-03,Montréal Canadiens,1,Atlantic,Eastern,1,2,2,0.5,0,1,0,1
2018-19,2018-10-06,Montréal Canadiens,2,Atlantic,Eastern,3,2,4,0.75,2,1,2,1
2018-19,2018-10-11,Montréal Canadiens,0,Atlantic,Eastern,3,2,6,0.5,4,-1,4,-1
2018-19,2018-10-13,Montréal Canadiens,2,Atlantic,Eastern,5,2,8,0.625,5,0,5,0
2018-19,2018-10-15,Montréal Canadiens,2,Atlantic,Eastern,7,2,10,0.7,7,0,6,1
2018-19,2018-10-17,Montréal Canadiens,2,Atlantic,Eastern,9,2,12,0.75,8,1,6,3
2018-19,2018-10-20,Montréal Canadiens,1,Atlantic,Eastern,10,2,14,0.7142857142857143,9,1,8,2
2018-19,2018-10-23,Montréal Canadiens,2,Atlantic,Eastern,12,2,16,0.75,12,0,9,3
2018-19,2018-10-25,Montréal Canadiens,0,Atlantic,Eastern,12,2,18,0.6666666666666666,13,-1,10,2
2018-19,2018-10-27,Montréal Canadiens,2,Atlantic,Eastern,14,2,20,0.7,14,0,12,2
2018-19,2018-10-30,Montréal Canadiens,0,Atlantic,Eastern,14,2,22,0.6363636363636364,16,-2,13,1
2018-19,2018-11-01,Montréal Canadiens,2,Atlantic,Eastern,16,2,24,0.6666666666666666,16,0,13,3
2018-19,2018-11-03,Montréal Canadiens,0,Atlantic,Eastern,16,2,26,0.6153846153846154,16,0,14,2
2018-19,2018-11-06,Montréal Canadiens,2,Atlantic,Eastern,18,2,28,0.6428571428571429,18,0,15,3
2018-19,2018-11-07,Montréal Canadiens,0,Atlantic,Eastern,18,2,30,0.6,18,0,15,3
2018-19,2018-11-09,Montréal Canadiens,1,Atlantic,Eastern,19,2,32,0.59375,19,0,17,2
2018-19,2018-11-11,Montréal Canadiens,2,Atlantic,Eastern,21,2,34,0.6176470588235294,21,0,18,3
2018-19,2018-11-14,Montréal Canadiens,0,Atlantic,Eastern,21,2,36,0.5833333333333334,22,-1,20,1
2018-19,2018-11-16,Montréal Canadiens,2,Atlantic,Eastern,23,2,38,0.6052631578947368,23,0,20,3
2018-19,2018-11-18,Montréal Canadiens,2,Atlantic,Eastern,25,2,40,0.625,26,-1,22,3
2018-19,2018-11-20,Montréal Canadiens,1,Atlantic,Eastern,26,2,42,0.6190476190476191,28,-2,23,3
2018-19,2018-11-22,Montréal Canadiens,0,Atlantic,Eastern,26,2,44,0.5909090909090909,30,-4,25,1
2018-19,2018-11-23,Montréal Canadiens,1,Atlantic,Eastern,27,2,46,0.5869565217391305,30,-3,26,1
2018-19,2018-11-25,Montréal Canadiens,0,Atlantic,Eastern,27,2,48,0.5625,32,-5,26,1
2018-19,2018-11-28,Montréal Canadiens,0,Atlantic,Eastern,27,2,50,0.54,34,-7,27,0
2018-19,2018-12-02,Montréal Canadiens,2,Atlantic,Eastern,29,2,52,0.5576923076923077,37,-8,29,0
2018-19,2018-12-03,Montréal Canadiens,0,Atlantic,Eastern,29,2,54,0.5370370370370371,37,-8,29,0
2018-19,2018-12-05,Montréal Canadiens,2,Atlantic,Eastern,31,2,56,0.5535714285714286,38,-7,29,2
2018-19,2018-12-07,Montréal Canadiens,2,Atlantic,Eastern,33,2,58,0.5689655172413793,38,-5,30,3
2018-19,2018-12-09,Montréal Canadiens,2,Atlantic,Eastern,35,2,60,0.5833333333333334,38,-3,31,4
2018-19,2018-12-12,Montréal Canadiens,0,Atlantic,Eastern,35,2,62,0.5645161290322581,40,-5,32,3
2018-19,2018-12-14,Montréal Canadiens,2,Atlantic,Eastern,37,2,64,0.578125,42,-5,32,5
2018-19,2018-12-16,Montréal Canadiens,2,Atlantic,Eastern,39,2,66,0.5909090909090909,44,-5,36,3
2018-19,2018-12-18,Montréal Canadiens,0,Atlantic,Eastern,39,2,68,0.5735294117647058,43,-4,36,3
2018-19,2018-12-20,Montréal Canadiens,0,Atlantic,Eastern,39,2,70,0.5571428571428572,45,-6,38,1
2018-19,2018-12-21,Montréal Canadiens,2,Atlantic,Eastern,41,2,72,0.5694444444444444,45,-4,40,1
2018-19,2018-12-22,Montréal Canadiens,2,Atlantic,Eastern,43,2,74,0.581081081081081,45,-2,40,3
2018-19,2018-12-29,Montréal Canadiens,2,Atlantic,Eastern,45,2,76,0.5921052631578947,47,-2,44,1
2018-19,2018-12-30,Montréal Canadiens,0,Atlantic,Eastern,45,2,78,0.5769230769230769,48,-3,45,0
2018-19,2019-01-01,Montréal Canadiens,2,Atlantic,Eastern,47,2,80,0.5875,48,-1,47,0
2018-19,2019-01-04,Montréal Canadiens,2,Atlantic,Eastern,49,2,82,0.5975609756097561,50,-1,49,0
2018-19,2019-01-06,Montréal Canadiens,0,Atlantic,Eastern,49,2,84,0.5833333333333334,52,-3,50,-1
2018-19,2019-01-08,Montréal Canadiens,0,Atlantic,Eastern,49,2,86,0.5697674418604651,52,-3,50,-1
2018-19,2019-01-09,Montréal Canadiens,2,Atlantic,Eastern,51,2,88,0.5795454545454546,54,-3,51,0
2018-19,2019-01-11,Montréal Canadiens,0,Atlantic,Eastern,51,2,90,0.5666666666666667,54,-3,52,-1
2018-19,2019-01-13,Montréal Canadiens,2,Atlantic,Eastern,53,2,92,0.5760869565217391,56,-3,52,1
2018-19,2019-01-15,Montréal Canadiens,2,Atlantic,Eastern,55,2,94,0.5851063829787234,57,-2,54,1
2018-19,2019-01-16,Montréal Canadiens,2,Atlantic,Eastern,57,2,96,0.59375,57,0,56,1
2018-19,2019-01-19,Montréal Canadiens,2,Atlantic,Eastern,59,2,98,0.6020408163265306,59,0,58,1
2018-19,2019-01-20,Montréal Canadiens,0,Atlantic,Eastern,59,2,100,0.59,59,0,58,1
2018-19,2019-01-24,Montréal Canadiens,2,Atlantic,Eastern,61,2,102,0.5980392156862745,61,0,58,3
2018-19,2019-02-02,Montréal Canadiens,1,Atlantic,Eastern,62,2,104,0.5961538461538461,62,0,59,3
2018-19,2019-02-03,Montréal Canadiens,2,Atlantic,Eastern,64,2,106,0.6037735849056604,64,0,59,5
2018-19,2019-02-06,Montréal Canadiens,2,Atlantic,Eastern,66,2,108,0.6111111111111112,66,0,61,5
2018-19,2019-02-08,Montréal Canadiens,2,Atlantic,Eastern,68,2,110,0.6181818181818182,68,0,63,5
2018-19,2019-02-10,Montréal Canadiens,1,Atlantic,Eastern,69,2,112,0.6160714285714286,70,-1,63,6
2018-19,2019-02-15,Montréal Canadiens,0,Atlantic,Eastern,69,2,114,0.6052631578947368,72,-3,67,2
2018-19,2019-02-17,Montréal Canadiens,0,Atlantic,Eastern,69,2,116,0.5948275862068966,75,-6,69,0
2018-19,2019-02-18,Montréal Canadiens,0,Atlantic,Eastern,69,2,118,0.5847457627118644,75,-6,69,0
2018-19,2019-02-20,Montréal Canadiens,2,Atlantic,Eastern,71,2,120,0.5916666666666667,76,-5,69,2
2018-19,2019-02-22,Montréal Canadiens,2,Atlantic,Eastern,73,2,122,0.5983606557377049,76,-3,70,3
2018-19,2019-02-24,Montréal Canadiens,0,Atlantic,Eastern,73,2,124,0.5887096774193549,78,-5,72,1
2018-19,2019-02-26,Montréal Canadiens,0,Atlantic,Eastern,73,2,126,0.5793650793650794,80,-7,72,1
2018-19,2019-02-27,Montréal Canadiens,2,Atlantic,Eastern,75,2,128,0.5859375,80,-5,74,1
2018-19,2019-03-02,Montréal Canadiens,2,Atlantic,Eastern,77,2,130,0.5923076923076923,82,-5,75,2
2018-19,2019-03-03,Montréal Canadiens,0,Atlantic,Eastern,77,2,132,0.5833333333333334,84,-7,77,0
2018-19,2019-03-06,Montréal Canadiens,2,Atlantic,Eastern,79,2,134,0.5895522388059702,86,-7,79,0
2018-19,2019-03-08,Montréal Canadiens,0,Atlantic,Eastern,79,2,136,0.5808823529411765,87,-8,79,0
2018-19,2019-03-09,Montréal Canadiens,0,Atlantic,Eastern,79,2,138,0.572463768115942,87,-8,79,0
2018-19,2019-03-12,Montréal Canadiens,2,Atlantic,Eastern,81,2,140,0.5785714285714286,89,-8,81,0
2018-19,2019-03-14,Montréal Canadiens,0,Atlantic,Eastern,81,2,142,0.5704225352112676,89,-8,81,0
2018-19,2019-03-16,Montréal Canadiens,0,Atlantic,Eastern,81,2,144,0.5625,91,-10,84,-3
2018-19,2019-03-19,Montréal Canadiens,2,Atlantic,Eastern,83,2,146,0.5684931506849316,91,-8,84,-1
2018-19,2019-03-21,Montréal Canadiens,2,Atlantic,Eastern,85,2,148,0.5743243243243243,93,-8,85,0
2018-19,2019-03-23,Montréal Canadiens,2,Atlantic,Eastern,87,2,150,0.58,94,-7,87,0
2018-19,2019-03-24,Montréal Canadiens,1,Atlantic,Eastern,88,2,152,0.5789473684210527,94,-6,88,0
2018-19,2019-03-26,Montréal Canadiens,2,Atlantic,Eastern,90,2,154,0.5844155844155844,96,-6,90,0
2018-19,2019-03-28,Montréal Canadiens,0,Atlantic,Eastern,90,2,156,0.5769230769230769,97,-7,90,0
2018-19,2019-03-30,Montréal Canadiens,2,Atlantic,Eastern,92,2,158,0.5822784810126582,97,-5,92,0
2018-19,2019-04-02,Montréal Canadiens,2,Atlantic,Eastern,94,2,160,0.5875,99,-5,94,0
2018-19,2019-04-04,Montréal Canadiens,0,Atlantic,Eastern,94,2,162,0.5802469135802469,99,-5,94,0
2018-19,2019-04-06,Montréal Canadiens,2,Atlantic,Eastern,96,2,164,0.5853658536585366,100,-4,98,-2
2018-19,2018-10-04,Nashville Predators,2,Central,Western,2,2,2,1.0,0,2,0,2
2018-19,2018-10-06,Nashville Predators,2,Central,Western,4,2,4,1.0,2,2,2,2
2018-19,2018-10-10,Nashville Predators,0,Central,Western,4,2,6,0.6666666666666666,4,0,4,0
2018-19,2018-10-12,Nashville Predators,2,Central,Western,6,2,8,0.75,6,0,4,2
2018-19,2018-10-14,Nashville Predators,2,Central,Western,8,2,10,0.8,7,1,6,2
2018-19,2018-10-16,Nashville Predators,2,Central,Western,10,2,12,0.8333333333333334,8,2,6,4
2018-19,2018-10-20,Nashville Predators,2,Central,Western,12,2,14,0.8571428571428571,11,1,8,4
2018-19,2018-10-21,Nashville Predators,2,Central,Western,14,2,16,0.875,11,3,10,4
2018-19,2018-10-24,Nashville Predators,0,Central,Western,14,2,18,0.7777777777777778,13,1,10,4
2018-19,2018-10-25,Nashville Predators,2,Central,Western,16,2,20,0.8,13,3,10,6
2018-19,2018-10-27,Nashville Predators,0,Central,Western,16,2,22,0.7272727272727273,15,1,11,5
2018-19,2018-10-31,Nashville Predators,2,Central,Western,18,2,24,0.75,16,2,14,4
2018-19,2018-11-01,Nashville Predators,2,Central,Western,20,2,26,0.7692307692307693,16,4,15,5
2018-19,2018-11-04,Nashville Predators,2,Central,Western,22,2,28,0.7857142857142857,17,5,17,5
2018-19,2018-11-08,Nashville Predators,2,Central,Western,24,2,30,0.8,17,7,17,7
2018-19,2018-11-10,Nashville Predators,2,Central,Western,26,2,32,0.8125,20,6,17,9
2018-19,2018-11-13,Nashville Predators,1,Central,Western,27,2,34,0.7941176470588235,21,6,19,8
2018-19,2018-11-14,Nashville Predators,0,Central,Western,27,2,36,0.75,21,6,19,8
2018-19,2018-11-16,Nashville Predators,0,Central,Western,27,2,38,0.7105263157894737,23,4,20,7
2018-19,2018-11-18,Nashville Predators,2,Central,Western,29,2,40,0.725,24,5,22,7
2018-19,2018-11-20,Nashville Predators,2,Central,Western,31,2,42,0.7380952380952381,26,5,22,9
2018-19,2018-11-22,Nashville Predators,2,Central,Western,33,2,44,0.75,26,7,23,10
2018-19,2018-11-24,Nashville Predators,0,Central,Western,33,2,46,0.717391304347826,28,5,25,8
2018-19,2018-11-26,Nashville Predators,2,Central,Western,35,2,48,0.7291666666666666,30,5,25,10
2018-19,2018-11-28,Nashville Predators,0,Central,Western,35,2,50,0.7,30,5,27,8
2018-19,2018-11-30,Nashville Predators,0,Central,Western,35,2,52,0.6730769230769231,30,5,29,6
2018-19,2018-12-02,Nashville Predators,2,Central,Western,37,2,54,0.6851851851851852,34,3,29,8
2018-19,2018-12-04,Nashville Predators,2,Central,Western,39,2,56,0.6964285714285714,34,5,30,9
2018-19,2018-12-07,Nashville Predators,0,Central,Western,39,2,58,0.6724137931034483,36,3,33,6
2018-19,2018-12-09,Nashville Predators,0,Central,Western,39,2,60,0.65,38,1,33,6
2018-19,2018-12-12,Nashville Predators,2,Central,Western,41,2,62,0.6612903225806451,39,2,35,6
2018-19,2018-12-14,Nashville Predators,2,Central,Western,43,2,64,0.671875,39,4,37,6
2018-19,2018-12-16,Nashville Predators,2,Central,Western,45,2,66,0.6818181818181818,42,3,39,6
2018-19,2018-12-18,Nashville Predators,1,Central,Western,46,2,68,0.6764705882352942,42,4,39,7
2018-19,2018-12-19,Nashville Predators,0,Central,Western,46,2,70,0.6571428571428571,42,4,39,7
2018-19,2018-12-21,Nashville Predators,0,Central,Western,46,2,72,0.6388888888888888,44,2,39,7
2018-19,2018-12-22,Nashville Predators,0,Central,Western,46,2,74,0.6216216216216216,44,2,39,7
2018-19,2018-12-28,Nashville Predators,0,Central,Western,46,2,76,0.6052631578947368,44,2,41,5
2018-19,2018-12-30,Nashville Predators,0,Central,Western,46,2,78,0.5897435897435898,45,1,43,3
2018-19,2018-12-31,Nashville Predators,2,Central,Western,48,2,80,0.6,45,3,43,5
2018-19,2019-01-02,Nashville Predators,2,Central,Western,50,2,82,0.6097560975609756,46,4,44,6
2018-19,2019-01-05,Nashville Predators,1,Central,Western,51,2,84,0.6071428571428571,48,3,45,6
2018-19,2019-01-06,Nashville Predators,2,Central,Western,53,2,86,0.6162790697674418,48,5,45,8
2018-19,2019-01-08,Nashville Predators,2,Central,Western,55,2,88,0.625,48,7,45,10
2018-19,2019-01-10,Nashville Predators,2,Central,Western,57,2,90,0.6333333333333333,50,7,46,11
2018-19,2019-01-11,Nashville Predators,1,Central,Western,58,2,92,0.6304347826086957,50,8,47,11
2018-19,2019-01-13,Nashville Predators,0,Central,Western,58,2,94,0.6170212765957447,50,8,47,11
2018-19,2019-01-16,Nashville Predators,2,Central,Western,60,2,96,0.625,50,10,49,11
2018-19,2019-01-18,Nashville Predators,0,Central,Western,60,2,98,0.6122448979591837,50,10,49,11
2018-19,2019-01-20,Nashville Predators,0,Central,Western,60,2,100,0.6,52,8,52,8
2018-19,2019-01-21,Nashville Predators,2,Central,Western,62,2,102,0.6078431372549019,53,9,52,10
2018-19,2019-01-24,Nashville Predators,2,Central,Western,64,2,104,0.6153846153846154,55,9,52,12
2018-19,2019-02-02,Nashville Predators,2,Central,Western,66,2,106,0.6226415094339622,56,10,52,14
2018-19,2019-02-03,Nashville Predators,0,Central,Western,66,2,108,0.6111111111111112,58,8,54,12
2018-19,2019-02-06,Nashville Predators,2,Central,Western,68,2,110,0.6181818181818182,60,8,54,14
2018-19,2019-02-08,Nashville Predators,2,Central,Western,70,2,112,0.625,61,9,55,15
2018-19,2019-02-09,Nashville Predators,0,Central,Western,70,2,114,0.6140350877192983,61,9,57,13
2018-19,2019-02-10,Nashville Predators,1,Central,Western,71,2,116,0.6120689655172413,61,10,59,12
2018-19,2019-02-13,Nashville Predators,0,Central,Western,71,2,118,0.6016949152542372,63,8,59,12
2018-19,2019-02-15,Nashville Predators,2,Central,Western,73,2,120,0.6083333333333333,63,10,59,14
2018-19,2019-02-17,Nashville Predators,0,Central,Western,73,2,122,0.5983606557377049,67,6,60,13
2018-19,2019-02-20,Nashville Predators,2,Central,Western,75,2,124,0.6048387096774194,69,6,60,15
2018-19,2019-02-22,Nashville Predators,2,Central,Western,77,2,126,0.6111111111111112,69,8,62,15
2018-19,2019-02-23,Nashville Predators,0,Central,Western,77,2,128,0.6015625,71,6,64,13
2018-19,2019-02-26,Nashville Predators,2,Central,Western,79,2,130,0.6076923076923076,72,7,66,13
2018-19,2019-02-27,Nashville Predators,0,Central,Western,79,2,132,0.5984848484848485,74,5,67,12
2018-19,2019-03-02,Nashville Predators,0,Central,Western,79,2,134,0.5895522388059702,74,5,68,11
2018-19,2019-03-04,Nashville Predators,2,Central,Western,81,2,136,0.5955882352941176,74,7,71,10
2018-19,2019-03-06,Nashville Predators,2,Central,Western,83,2,138,0.6014492753623188,74,9,72,11
2018-19,2019-03-10,Nashville Predators,0,Central,Western,83,2,140,0.5928571428571429,79,4,74,9
2018-19,2019-03-13,Nashville Predators,0,Central,Western,83,2,142,0.5845070422535211,79,4,75,8
2018-19,2019-03-15,Nashville Predators,2,Central,Western,85,2,144,0.5902777777777778,79,6,77,8
2018-19,2019-03-17,Nashville Predators,2,Central,Western,87,2,146,0.5958904109589042,82,5,78,9
2018-19,2019-03-20,Nashville Predators,2,Central,Western,89,2,148,0.6013513513513513,84,5,78,11
2018-19,2019-03-22,Nashville Predators,1,Central,Western,90,2,150,0.6,86,4,79,11
2018-19,2019-03-23,Nashville Predators,0,Central,Western,90,2,152,0.5921052631578947,86,4,80,10
2018-19,2019-03-26,Nashville Predators,2,Central,Western,92,2,154,0.5974025974025974,90,2,81,11
2018-19,2019-03-29,Nashville Predators,2,Central,Western,94,2,156,0.6025641025641025,90,4,83,11
2018-19,2019-03-31,Nashville Predators,0,Central,Western,94,2,158,0.5949367088607594,92,2,85,9
2018-19,2019-04-02,Nashville Predators,2,Central,Western,96,2,160,0.6,94,2,86,10
2018-19,2019-04-05,Nashville Predators,2,Central,Western,98,2,162,0.6049382716049383,97,1,90,8
2018-19,2019-04-07,Nashville Predators,2,Central,Western,100,2,164,0.6097560975609756,99,1,90,10
2018-19,2018-10-06,New Jersey Devils,2,Metropolitan,Eastern,2,2,2,1.0,2,0,2,0
2018-19,2018-10-11,New Jersey Devils,2,Metropolitan,Eastern,4,2,4,1.0,5,-1,4,0
2018-19,2018-10-14,New Jersey Devils,2,Metropolitan,Eastern,6,2,6,1.0,6,0,5,1
2018-19,2018-10-16,New Jersey Devils,2,Metropolitan,Eastern,8,2,8,1.0,6,2,6,2
2018-19,2018-10-18,New Jersey Devils,0,Metropolitan,Eastern,8,2,10,0.8,8,0,8,0
2018-19,2018-10-20,New Jersey Devils,0,Metropolitan,Eastern,8,2,12,0.6666666666666666,8,0,8,0
2018-19,2018-10-25,New Jersey Devils,1,Metropolitan,Eastern,9,2,14,0.6428571428571429,10,-1,10,-1
2018-19,2018-10-27,New Jersey Devils,2,Metropolitan,Eastern,11,2,16,0.6875,12,-1,12,-1
2018-19,2018-10-30,New Jersey Devils,0,Metropolitan,Eastern,11,2,18,0.6111111111111112,13,-2,13,-2
2018-19,2018-11-01,New Jersey Devils,0,Metropolitan,Eastern,11,2,20,0.55,13,-2,13,-2
2018-19,2018-11-03,New Jersey Devils,0,Metropolitan,Eastern,11,2,22,0.5,14,-3,14,-3
2018-19,2018-11-06,New Jersey Devils,2,Metropolitan,Eastern,13,2,24,0.5416666666666666,15,-2,15,-2
2018-19,2018-11-07,New Jersey Devils,0,Metropolitan,Eastern,13,2,26,0.5,15,-2,15,-2
2018-19,2018-11-10,New Jersey Devils,0,Metropolitan,Eastern,13,2,28,0.4642857142857143,18,-5,18,-5
2018-19,2018-11-12,New Jersey Devils,0,Metropolitan,Eastern,13,2,30,0.43333333333333335,18,-5,18,-5
2018-19,2018-11-14,New Jersey Devils,2,Metropolitan,Eastern,15,2,32,0.46875,20,-5,20,-5
2018-19,2018-11-16,New Jersey Devils,2,Metropolitan,Eastern,17,2,34,0.5,20,-3,20,-3
2018-19,2018-11-17,New Jersey Devils,1,Metropolitan,Eastern,18,2,36,0.5,21,-3,21,-3
2018-19,2018-11-18,New Jersey Devils,0,Metropolitan,Eastern,18,2,38,0.47368421052631576,22,-4,22,-4
2018-19,2018-11-22,New Jersey Devils,2,Metropolitan,Eastern,20,2,40,0.5,25,-5,25,-5
2018-19,2018-11-23,New Jersey Devils,1,Metropolitan,Eastern,21,2,42,0.5,26,-5,26,-5
2018-19,2018-11-26,New Jersey Devils,0,Metropolitan,Eastern,21,2,44,0.4772727272727273,26,-5,26,-5
2018-19,2018-11-27,New Jersey Devils,1,Metropolitan,Eastern,22,2,46,0.4782608695652174,28,-6,27,-5
2018-19,2018-12-01,New Jersey Devils,0,Metropolitan,Eastern,22,2,48,0.4583333333333333,28,-6,28,-6
2018-19,2018-12-02,New Jersey Devils,1,Metropolitan,Eastern,23,2,50,0.46,29,-6,29,-6
2018-19,2018-12-04,New Jersey Devils,0,Metropolitan,Eastern,23,2,52,0.4423076923076923,29,-6,29,-6
2018-19,2018-12-07,New Jersey Devils,2,Metropolitan,Eastern,25,2,54,0.46296296296296297,29,-4,30,-5
2018-19,2018-12-10,New Jersey Devils,1,Metropolitan,Eastern,26,2,56,0.4642857142857143,31,-5,31,-5
2018-19,2018-12-11,New Jersey Devils,0,Metropolitan,Eastern,26,2,58,0.4482758620689655,32,-6,32,-6
2018-19,2018-12-15,New Jersey Devils,2,Metropolitan,Eastern,28,2,60,0.4666666666666667,34,-6,34,-6
2018-19,2018-12-16,New Jersey Devils,1,Metropolitan,Eastern,29,2,62,0.46774193548387094,36,-7,36,-7
2018-19,2018-12-19,New Jersey Devils,0,Metropolitan,Eastern,29,2,64,0.453125,38,-9,38,-9
2018-19,2018-12-21,New Jersey Devils,0,Metropolitan,Eastern,29,2,66,0.4393939393939394,40,-11,40,-11
2018-19,2018-12-22,New Jersey Devils,2,Metropolitan,Eastern,31,2,68,0.45588235294117646,40,-9,40,-9
2018-19,2018-12-23,New Jersey Devils,0,Metropolitan,Eastern,31,2,70,0.44285714285714284,42,-11,42,-11
2018-19,2018-12-28,New Jersey Devils,2,Metropolitan,Eastern,33,2,72,0.4583333333333333,44,-11,43,-10
2018-19,2018-12-29,New Jersey Devils,2,Metropolitan,Eastern,35,2,74,0.47297297297297297,44,-9,44,-9
2018-19,2018-12-31,New Jersey Devils,2,Metropolitan,Eastern,37,2,76,0.4868421052631579,47,-10,46,-9
2018-19,2019-01-03,New Jersey Devils,0,Metropolitan,Eastern,37,2,78,0.47435897435897434,49,-12,47,-10
2018-19,2019-01-05,New Jersey Devils,2,Metropolitan,Eastern,39,2,80,0.4875,49,-10,49,-10
2018-19,2019-01-06,New Jersey Devils,0,Metropolitan,Eastern,39,2,82,0.47560975609756095,51,-12,50,-11
2018-19,2019-01-09,New Jersey Devils,0,Metropolitan,Eastern,39,2,84,0.4642857142857143,51,-12,51,-12
2018-19,2019-01-11,New Jersey Devils,0,Metropolitan,Eastern,39,2,86,0.45348837209302323,53,-14,52,-13
2018-19,2019-01-12,New Jersey Devils,2,Metropolitan,Eastern,41,2,88,0.4659090909090909,53,-12,52,-11
2018-19,2019-01-15,New Jersey Devils,2,Metropolitan,Eastern,43,2,90,0.4777777777777778,56,-13,54,-11
2018-19,2019-01-16,New Jersey Devils,0,Metropolitan,Eastern,43,2,92,0.4673913043478261,56,-13,56,-13
2018-19,2019-01-18,New Jersey Devils,0,Metropolitan,Eastern,43,2,94,0.4574468085106383,58,-15,56,-13
2018-19,2019-01-19,New Jersey Devils,0,Metropolitan,Eastern,43,2,96,0.4479166666666667,59,-16,58,-15
2018-19,2019-01-29,New Jersey Devils,2,Metropolitan,Eastern,45,2,98,0.45918367346938777,59,-14,58,-13
2018-19,2019-02-01,New Jersey Devils,0,Metropolitan,Eastern,45,2,100,0.45,60,-15,59,-14
2018-19,2019-02-02,New Jersey Devils,2,Metropolitan,Eastern,47,2,102,0.46078431372549017,62,-15,59,-12
2018-19,2019-02-06,New Jersey Devils,0,Metropolitan,Eastern,47,2,104,0.4519230769230769,62,-15,61,-14
2018-19,2019-02-08,New Jersey Devils,1,Metropolitan,Eastern,48,2,106,0.4528301886792453,63,-15,63,-15
2018-19,2019-02-09,New Jersey Devils,0,Metropolitan,Eastern,48,2,108,0.4444444444444444,63,-15,63,-15
2018-19,2019-02-10,New Jersey Devils,2,Metropolitan,Eastern,50,2,110,0.45454545454545453,65,-15,63,-13
2018-19,2019-02-13,New Jersey Devils,0,Metropolitan,Eastern,50,2,112,0.44642857142857145,67,-17,65,-15
2018-19,2019-02-15,New Jersey Devils,0,Metropolitan,Eastern,50,2,114,0.43859649122807015,67,-17,67,-17
2018-19,2019-02-16,New Jersey Devils,2,Metropolitan,Eastern,52,2,116,0.4482758620689655,67,-15,67,-15
2018-19,2019-02-17,New Jersey Devils,2,Metropolitan,Eastern,54,2,118,0.4576271186440678,69,-15,69,-15
2018-19,2019-02-20,New Jersey Devils,0,Metropolitan,Eastern,54,2,120,0.45,71,-17,69,-15
2018-19,2019-02-22,New Jersey Devils,2,Metropolitan,Eastern,56,2,122,0.45901639344262296,71,-15,70,-14
2018-19,2019-02-23,New Jersey Devils,0,Metropolitan,Eastern,56,2,124,0.45161290322580644,72,-16,71,-15
2018-19,2019-02-26,New Jersey Devils,2,Metropolitan,Eastern,58,2,126,0.4603174603174603,72,-14,72,-14
2018-19,2019-02-28,New Jersey Devils,0,Metropolitan,Eastern,58,2,128,0.453125,74,-16,74,-16
2018-19,2019-03-02,New Jersey Devils,0,Metropolitan,Eastern,58,2,130,0.4461538461538462,76,-18,75,-17
2018-19,2019-03-03,New Jersey Devils,0,Metropolitan,Eastern,58,2,132,0.4393939393939394,78,-20,77,-19
2018-19,2019-03-06,New Jersey Devils,1,Metropolitan,Eastern,59,2,134,0.44029850746268656,79,-20,79,-20
2018-19,2019-03-09,New Jersey Devils,0,Metropolitan,Eastern,59,2,136,0.4338235294117647,81,-22,79,-20
2018-19,2019-03-10,New Jersey Devils,0,Metropolitan,Eastern,59,2,138,0.427536231884058,81,-22,79,-20
2018-19,2019-03-13,New Jersey Devils,0,Metropolitan,Eastern,59,2,140,0.42142857142857143,85,-26,81,-22
2018-19,2019-03-14,New Jersey Devils,2,Metropolitan,Eastern,61,2,142,0.4295774647887324,87,-26,81,-20
2018-19,2019-03-16,New Jersey Devils,2,Metropolitan,Eastern,63,2,144,0.4375,87,-24,84,-21
2018-19,2019-03-17,New Jersey Devils,0,Metropolitan,Eastern,63,2,146,0.4315068493150685,88,-25,84,-21
2018-19,2019-03-19,New Jersey Devils,0,Metropolitan,Eastern,63,2,148,0.42567567567567566,89,-26,84,-21
2018-19,2019-03-21,New Jersey Devils,0,Metropolitan,Eastern,63,2,150,0.42,89,-26,85,-22
2018-19,2019-03-23,New Jersey Devils,2,Metropolitan,Eastern,65,2,152,0.4276315789473684,91,-26,87,-22
2018-19,2019-03-25,New Jersey Devils,2,Metropolitan,Eastern,67,2,154,0.43506493506493504,95,-28,88,-21
2018-19,2019-03-29,New Jersey Devils,0,Metropolitan,Eastern,67,2,156,0.42948717948717946,95,-28,90,-23
2018-19,2019-03-30,New Jersey Devils,1,Metropolitan,Eastern,68,2,158,0.43037974683544306,95,-27,92,-24
2018-19,2019-04-01,New Jersey Devils,2,Metropolitan,Eastern,70,2,160,0.4375,97,-27,92,-22
2018-19,2019-04-04,New Jersey Devils,0,Metropolitan,Eastern,70,2,162,0.43209876543209874,99,-29,94,-24
2018-19,2019-04-06,New Jersey Devils,2,Metropolitan,Eastern,72,2,164,0.43902439024390244,100,-28,98,-26
2018-19,2018-10-04,New York Islanders,2,Metropolitan,Eastern,2,2,2,1.0,2,0,1,1
2018-19,2018-10-06,New York Islanders,0,Metropolitan,Eastern,2,2,4,0.5,2,0,2,0
2018-19,2018-10-08,New York Islanders,2,Metropolitan,Eastern,4,2,6,0.6666666666666666,3,1,3,1
2018-19,2018-10-14,New York Islanders,0,Metropolitan,Eastern,4,2,8,0.5,6,-2,5,-1
2018-19,2018-10-18,New York Islanders,0,Metropolitan,Eastern,4,2,10,0.4,8,-4,8,-4
2018-19,2018-10-19,New York Islanders,2,Metropolitan,Eastern,6,2,12,0.5,8,-2,8,-2
2018-19,2018-10-21,New York Islanders,0,Metropolitan,Eastern,6,2,14,0.42857142857142855,8,-2,8,-2
2018-19,2018-10-24,New York Islanders,1,Metropolitan,Eastern,7,2,16,0.4375,10,-3,10,-3
2018-19,2018-10-27,New York Islanders,2,Metropolitan,Eastern,9,2,18,0.5,12,-3,12,-3
2018-19,2018-10-28,New York Islanders,2,Metropolitan,Eastern,11,2,20,0.55,12,-1,12,-1
2018-19,2018-10-30,New York Islanders,2,Metropolitan,Eastern,13,2,22,0.5909090909090909,13,0,13,0
2018-19,2018-11-01,New York Islanders,2,Metropolitan,Eastern,15,2,24,0.625,13,2,13,2
2018-19,2018-11-03,New York Islanders,2,Metropolitan,Eastern,17,2,26,0.6538461538461539,14,3,14,3
2018-19,2018-11-06,New York Islanders,1,Metropolitan,Eastern,18,2,28,0.6428571428571429,15,3,15,3
2018-19,2018-11-09,New York Islanders,0,Metropolitan,Eastern,18,2,30,0.6,17,1,17,1
2018-19,2018-11-11,New York Islanders,0,Metropolitan,Eastern,18,2,32,0.5625,18,0,18,0
2018-19,2018-11-14,New York Islanders,2,Metropolitan,Eastern,20,2,34,0.5882352941176471,20,0,20,0
2018-19,2018-11-16,New York Islanders,2,Metropolitan,Eastern,22,2,36,0.6111111111111112,20,2,20,2
2018-19,2018-11-18,New York Islanders,0,Metropolitan,Eastern,22,2,38,0.5789473684210527,22,0,22,0
2018-19,2018-11-22,New York Islanders,0,Metropolitan,Eastern,22,2,40,0.55,25,-3,25,-3
2018-19,2018-11-23,New York Islanders,2,Metropolitan,Eastern,24,2,42,0.5714285714285714,26,-2,26,-2
2018-19,2018-11-25,New York Islanders,2,Metropolitan,Eastern,26,2,44,0.5909090909090909,26,0,26,0
2018-19,2018-11-27,New York Islanders,0,Metropolitan,Eastern,26,2,46,0.5652173913043478,28,-2,27,-1
2018-19,2018-11-30,New York Islanders,1,Metropolitan,Eastern,27,2,48,0.5625,28,-1,27,0
2018-19,2018-12-02,New York Islanders,2,Metropolitan,Eastern,29,2,50,0.58,29,0,29,0
2018-19,2018-12-05,New York Islanders,0,Metropolitan,Eastern,29,2,52,0.5576923076923077,29,0,29,0
2018-19,2018-12-07,New York Islanders,0,Metropolitan,Eastern,29,2,54,0.5370370370370371,29,0,30,-1
2018-19,2018-12-09,New York Islanders,2,Metropolitan,Eastern,31,2,56,0.5535714285714286,31,0,31,0
2018-19,2018-12-11,New York Islanders,1,Metropolitan,Eastern,32,2,58,0.5517241379310345,32,0,32,0
2018-19,2018-12-13,New York Islanders,0,Metropolitan,Eastern,32,2,60,0.5333333333333333,32,0,32,0
2018-19,2018-12-16,New York Islanders,2,Metropolitan,Eastern,34,2,62,0.5483870967741935,36,-2,36,-2
2018-19,2018-12-18,New York Islanders,2,Metropolitan,Eastern,36,2,64,0.5625,36,0,36,0
2018-19,2018-12-19,New York Islanders,2,Metropolitan,Eastern,38,2,66,0.5757575757575758,38,0,38,0
2018-19,2018-12-21,New York Islanders,0,Metropolitan,Eastern,38,2,68,0.5588235294117647,40,-2,40,-2
2018-19,2018-12-24,New York Islanders,2,Metropolitan,Eastern,40,2,70,0.5714285714285714,42,-2,42,-2
2018-19,2018-12-29,New York Islanders,2,Metropolitan,Eastern,42,2,72,0.5833333333333334,44,-2,44,-2
2018-19,2018-12-30,New York Islanders,2,Metropolitan,Eastern,44,2,74,0.5945945945945946,46,-2,45,-1
2018-19,2018-12-31,New York Islanders,2,Metropolitan,Eastern,46,2,76,0.6052631578947368,47,-1,46,0
2018-19,2019-01-04,New York Islanders,2,Metropolitan,Eastern,48,2,78,0.6153846153846154,49,-1,49,-1
2018-19,2019-01-06,New York Islanders,2,Metropolitan,Eastern,50,2,80,0.625,51,-1,50,0
2018-19,2019-01-09,New York Islanders,0,Metropolitan,Eastern,50,2,82,0.6097560975609756,51,-1,51,-1
2018-19,2019-01-11,New York Islanders,2,Metropolitan,Eastern,52,2,84,0.6190476190476191,53,-1,52,0
2018-19,2019-01-12,New York Islanders,0,Metropolitan,Eastern,52,2,86,0.6046511627906976,53,-1,52,0
2018-19,2019-01-14,New York Islanders,2,Metropolitan,Eastern,54,2,88,0.6136363636363636,55,-1,53,1
2018-19,2019-01-16,New York Islanders,2,Metropolitan,Eastern,56,2,90,0.6222222222222222,56,0,56,0
2018-19,2019-01-18,New York Islanders,2,Metropolitan,Eastern,58,2,92,0.6304347826086957,58,0,56,2
2018-19,2019-01-19,New York Islanders,2,Metropolitan,Eastern,60,2,94,0.6382978723404256,59,1,58,2
2018-19,2019-01-20,New York Islanders,2,Metropolitan,Eastern,62,2,96,0.6458333333333334,59,3,58,4
2018-19,2019-01-23,New York Islanders,1,Metropolitan,Eastern,63,2,98,0.6428571428571429,59,4,58,5
2018-19,2019-02-02,New York Islanders,1,Metropolitan,Eastern,64,2,100,0.64,62,2,59,5
2018-19,2019-02-03,New York Islanders,2,Metropolitan,Eastern,66,2,102,0.6470588235294118,62,4,59,7
2018-19,2019-02-06,New York Islanders,0,Metropolitan,Eastern,66,2,104,0.6346153846153846,62,4,61,5
2018-19,2019-02-08,New York Islanders,2,Metropolitan,Eastern,68,2,106,0.6415094339622641,63,5,63,5
2018-19,2019-02-09,New York Islanders,2,Metropolitan,Eastern,70,2,108,0.6481481481481481,63,7,63,7
2018-19,2019-02-10,New York Islanders,2,Metropolitan,Eastern,72,2,110,0.6545454545454545,65,7,63,9
2018-19,2019-02-13,New York Islanders,0,Metropolitan,Eastern,72,2,112,0.6428571428571429,67,5,65,7
2018-19,2019-02-15,New York Islanders,2,Metropolitan,Eastern,74,2,114,0.6491228070175439,67,7,67,7
2018-19,2019-02-17,New York Islanders,2,Metropolitan,Eastern,76,2,116,0.6551724137931034,69,7,69,7
2018-19,2019-02-21,New York Islanders,0,Metropolitan,Eastern,76,2,118,0.6440677966101694,71,5,69,7
2018-19,2019-02-22,New York Islanders,1,Metropolitan,Eastern,77,2,120,0.6416666666666667,71,6,70,7
2018-19,2019-02-24,New York Islanders,2,Metropolitan,Eastern,79,2,122,0.6475409836065574,73,6,72,7
2018-19,2019-02-27,New York Islanders,0,Metropolitan,Eastern,79,2,124,0.6370967741935484,74,5,74,5
2018-19,2019-03-01,New York Islanders,2,Metropolitan,Eastern,81,2,126,0.6428571428571429,75,6,74,7
2018-19,2019-03-02,New York Islanders,0,Metropolitan,Eastern,81,2,128,0.6328125,76,5,75,6
2018-19,2019-03-03,New York Islanders,0,Metropolitan,Eastern,81,2,130,0.6230769230769231,78,3,77,4
2018-19,2019-03-06,New York Islanders,2,Metropolitan,Eastern,83,2,132,0.6287878787878788,79,4,79,4
2018-19,2019-03-08,New York Islanders,2,Metropolitan,Eastern,85,2,134,0.6343283582089553,81,4,79,6
2018-19,2019-03-10,New York Islanders,0,Metropolitan,Eastern,85,2,136,0.625,81,4,79,6
2018-19,2019-03-11,New York Islanders,2,Metropolitan,Eastern,87,2,138,0.6304347826086957,81,6,79,8
2018-19,2019-03-14,New York Islanders,2,Metropolitan,Eastern,89,2,140,0.6357142857142857,87,2,81,8
2018-19,2019-03-16,New York Islanders,0,Metropolitan,Eastern,89,2,142,0.6267605633802817,87,2,84,5
2018-19,2019-03-17,New York Islanders,2,Metropolitan,Eastern,91,2,144,0.6319444444444444,88,3,84,7
2018-19,2019-03-19,New York Islanders,0,Metropolitan,Eastern,91,2,146,0.6232876712328768,89,2,84,7
2018-19,2019-03-21,New York Islanders,0,Metropolitan,Eastern,91,2,148,0.6148648648648649,89,2,85,6
2018-19,2019-03-23,New York Islanders,2,Metropolitan,Eastern,93,2,150,0.62,91,2,87,6
2018-19,2019-03-24,New York Islanders,2,Metropolitan,Eastern,95,2,152,0.625,93,2,88,7
2018-19,2019-03-26,New York Islanders,0,Metropolitan,Eastern,95,2,154,0.6168831168831169,95,0,90,5
2018-19,2019-03-29,New York Islanders,2,Metropolitan,Eastern,97,2,156,0.6217948717948718,95,2,90,7
2018-19,2019-03-30,New York Islanders,2,Metropolitan,Eastern,99,2,158,0.6265822784810127,95,4,92,7
2018-19,2019-04-01,New York Islanders,0,Metropolitan,Eastern,99,2,160,0.61875,97,2,92,7
2018-19,2019-04-04,New York Islanders,2,Metropolitan,Eastern,101,2,162,0.6234567901234568,99,2,94,7
2018-19,2019-04-06,New York Islanders,2,Metropolitan,Eastern,103,2,164,0.6280487804878049,100,3,98,5
2018-19,2018-10-04,New York Rangers,0,Metropolitan,Eastern,0,2,2,0.0,2,-2,1,-1
2018-19,2018-10-06,New York Rangers,0,Metropolitan,Eastern,0,2,4,0.0,2,-2,2,-2
2018-19,2018-10-07,New York Rangers,0,Metropolitan,Eastern,0,2,6,0.0,2,-2,2,-2
2018-19,2018-10-11,New York Rangers,2,Metropolitan,Eastern,2,2,8,0.25,5,-3,4,-2
2018-19,2018-10-13,New York Rangers,0,Metropolitan,Eastern,2,2,10,0.2,5,-3,5,-3
2018-19,2018-10-16,New York Rangers,2,Metropolitan,Eastern,4,2,12,0.3333333333333333,6,-2,6,-2
2018-19,2018-10-17,New York Rangers,1,Metropolitan,Eastern,5,2,14,0.35714285714285715,7,-2,6,-1
2018-19,2018-10-21,New York Rangers,0,Metropolitan,Eastern,5,2,16,0.3125,8,-3,8,-3
2018-19,2018-10-23,New York Rangers,2,Metropolitan,Eastern,7,2,18,0.3888888888888889,8,-1,9,-2
2018-19,2018-10-26,New York Rangers,0,Metropolitan,Eastern,7,2,20,0.35,10,-3,10,-3
2018-19,2018-10-28,New York Rangers,0,Metropolitan,Eastern,7,2,22,0.3181818181818182,12,-5,12,-5
2018-19,2018-10-31,New York Rangers,2,Metropolitan,Eastern,9,2,24,0.375,13,-4,13,-4
2018-19,2018-11-02,New York Rangers,2,Metropolitan,Eastern,11,2,26,0.4230769230769231,14,-3,14,-3
2018-19,2018-11-05,New York Rangers,2,Metropolitan,Eastern,13,2,28,0.4642857142857143,15,-2,15,-2
2018-19,2018-11-07,New York Rangers,2,Metropolitan,Eastern,15,2,30,0.5,15,0,15,0
2018-19,2018-11-10,New York Rangers,1,Metropolitan,Eastern,16,2,32,0.5,18,-2,18,-2
2018-19,2018-11-11,New York Rangers,2,Metropolitan,Eastern,18,2,34,0.5294117647058824,18,0,18,0
2018-19,2018-11-13,New York Rangers,2,Metropolitan,Eastern,20,2,36,0.5555555555555556,19,1,19,1
2018-19,2018-11-16,New York Rangers,0,Metropolitan,Eastern,20,2,38,0.5263157894736842,20,0,20,0
2018-19,2018-11-18,New York Rangers,2,Metropolitan,Eastern,22,2,40,0.55,22,0,22,0
2018-19,2018-11-20,New York Rangers,2,Metropolitan,Eastern,24,2,42,0.5714285714285714,23,1,23,1
2018-19,2018-11-22,New York Rangers,2,Metropolitan,Eastern,26,2,44,0.5909090909090909,25,1,25,1
2018-19,2018-11-23,New York Rangers,0,Metropolitan,Eastern,26,2,46,0.5652173913043478,26,0,26,0
2018-19,2018-11-24,New York Rangers,0,Metropolitan,Eastern,26,2,48,0.5416666666666666,26,0,26,0
2018-19,2018-11-27,New York Rangers,2,Metropolitan,Eastern,28,2,50,0.56,28,0,27,1
2018-19,2018-11-30,New York Rangers,0,Metropolitan,Eastern,28,2,52,0.5384615384615384,28,0,27,1
2018-19,2018-12-02,New York Rangers,1,Metropolitan,Eastern,29,2,54,0.5370370370370371,29,0,29,0
2018-19,2018-12-02,New York Rangers,0,Metropolitan,Eastern,29,2,56,0.5178571428571429,29,0,29,0
2018-19,2018-12-09,New York Rangers,2,Metropolitan,Eastern,31,2,58,0.5344827586206896,31,0,31,0
2018-19,2018-12-11,New York Rangers,0,Metropolitan,Eastern,31,2,60,0.5166666666666667,32,-1,32,-1
2018-19,2018-12-15,New York Rangers,1,Metropolitan,Eastern,32,2,62,0.5161290322580645,34,-2,34,-2
2018-19,2018-12-16,New York Rangers,1,Metropolitan,Eastern,33,2,64,0.515625,36,-3,36,-3
2018-19,2018-12-19,New York Rangers,2,Metropolitan,Eastern,35,2,66,0.5303030303030303,38,-3,38,-3
2018-19,2018-12-23,New York Rangers,0,Metropolitan,Eastern,35,2,68,0.5147058823529411,42,-7,42,-7
2018-19,2018-12-24,New York Rangers,1,Metropolitan,Eastern,36,2,70,0.5142857142857142,42,-6,42,-6
2018-19,2018-12-28,New York Rangers,1,Metropolitan,Eastern,37,2,72,0.5138888888888888,44,-7,43,-6
2018-19,2018-12-30,New York Rangers,2,Metropolitan,Eastern,39,2,74,0.527027027027027,46,-7,45,-6
2018-19,2019-01-01,New York Rangers,2,Metropolitan,Eastern,41,2,76,0.5394736842105263,48,-7,47,-6
2018-19,2019-01-03,New York Rangers,0,Metropolitan,Eastern,41,2,78,0.5256410256410257,49,-8,47,-6
2018-19,2019-01-05,New York Rangers,0,Metropolitan,Eastern,41,2,80,0.5125,49,-8,49,-8
2018-19,2019-01-06,New York Rangers,0,Metropolitan,Eastern,41,2,82,0.5,51,-10,50,-9
2018-19,2019-01-09,New York Rangers,0,Metropolitan,Eastern,41,2,84,0.4880952380952381,51,-10,51,-10
2018-19,2019-01-11,New York Rangers,0,Metropolitan,Eastern,41,2,86,0.47674418604651164,53,-12,52,-11
2018-19,2019-01-12,New York Rangers,2,Metropolitan,Eastern,43,2,88,0.48863636363636365,53,-10,52,-9
2018-19,2019-01-13,New York Rangers,0,Metropolitan,Eastern,43,2,90,0.4777777777777778,55,-12,52,-9
2018-19,2019-01-16,New York Rangers,2,Metropolitan,Eastern,45,2,92,0.4891304347826087,56,-11,56,-11
2018-19,2019-01-18,New York Rangers,2,Metropolitan,Eastern,47,2,94,0.5,58,-11,56,-9
2018-19,2019-01-20,New York Rangers,2,Metropolitan,Eastern,49,2,96,0.5104166666666666,59,-10,58,-9
2018-19,2019-01-30,New York Rangers,0,Metropolitan,Eastern,49,2,98,0.5,59,-10,58,-9
2018-19,2019-02-01,New York Rangers,2,Metropolitan,Eastern,51,2,100,0.51,60,-9,59,-8
2018-19,2019-02-03,New York Rangers,0,Metropolitan,Eastern,51,2,102,0.5,62,-11,59,-8
2018-19,2019-02-05,New York Rangers,1,Metropolitan,Eastern,52,2,104,0.5,62,-10,59,-7
2018-19,2019-02-07,New York Rangers,2,Metropolitan,Eastern,54,2,106,0.5094339622641509,62,-8,61,-7
2018-19,2019-02-09,New York Rangers,0,Metropolitan,Eastern,54,2,108,0.5,63,-9,63,-9
2018-19,2019-02-11,New York Rangers,2,Metropolitan,Eastern,56,2,110,0.509090909090909,65,-9,63,-7
2018-19,2019-02-13,New York Rangers,0,Metropolitan,Eastern,56,2,112,0.5,67,-11,65,-9
2018-19,2019-02-16,New York Rangers,2,Metropolitan,Eastern,58,2,114,0.5087719298245614,67,-9,67,-9
2018-19,2019-02-17,New York Rangers,0,Metropolitan,Eastern,58,2,116,0.5,69,-11,69,-11
2018-19,2019-02-20,New York Rangers,2,Metropolitan,Eastern,60,2,118,0.5084745762711864,71,-11,69,-9
2018-19,2019-02-22,New York Rangers,0,Metropolitan,Eastern,60,2,120,0.5,71,-11,70,-10
2018-19,2019-02-23,New York Rangers,2,Metropolitan,Eastern,62,2,122,0.5081967213114754,72,-10,71,-9
2018-19,2019-02-24,New York Rangers,1,Metropolitan,Eastern,63,2,124,0.5080645161290323,73,-10,72,-9
2018-19,2019-02-28,New York Rangers,1,Metropolitan,Eastern,64,2,126,0.5079365079365079,74,-10,74,-10
2018-19,2019-03-02,New York Rangers,0,Metropolitan,Eastern,64,2,128,0.5,76,-12,75,-11
2018-19,2019-03-03,New York Rangers,1,Metropolitan,Eastern,65,2,130,0.5,78,-13,77,-12
2018-19,2019-03-06,New York Rangers,0,Metropolitan,Eastern,65,2,132,0.49242424242424243,79,-14,79,-14
2018-19,2019-03-08,New York Rangers,1,Metropolitan,Eastern,66,2,134,0.4925373134328358,81,-15,79,-13
2018-19,2019-03-10,New York Rangers,2,Metropolitan,Eastern,68,2,136,0.5,81,-13,79,-11
2018-19,2019-03-12,New York Rangers,1,Metropolitan,Eastern,69,2,138,0.5,85,-16,81,-12
2018-19,2019-03-14,New York Rangers,0,Metropolitan,Eastern,69,2,140,0.4928571428571429,87,-18,81,-12
2018-19,2019-03-16,New York Rangers,0,Metropolitan,Eastern,69,2,142,0.4859154929577465,87,-18,84,-15
2018-19,2019-03-17,New York Rangers,0,Metropolitan,Eastern,69,2,144,0.4791666666666667,88,-19,84,-15
2018-19,2019-03-19,New York Rangers,0,Metropolitan,Eastern,69,2,146,0.4726027397260274,89,-20,84,-15
2018-19,2019-03-23,New York Rangers,2,Metropolitan,Eastern,71,2,148,0.4797297297297297,91,-20,87,-16
2018-19,2019-03-25,New York Rangers,0,Metropolitan,Eastern,71,2,150,0.47333333333333333,95,-24,88,-17
2018-19,2019-03-27,New York Rangers,0,Metropolitan,Eastern,71,2,152,0.46710526315789475,95,-24,90,-19
2018-19,2019-03-29,New York Rangers,2,Metropolitan,Eastern,73,2,154,0.474025974025974,95,-22,90,-17
2018-19,2019-03-31,New York Rangers,2,Metropolitan,Eastern,75,2,156,0.4807692307692308,97,-22,92,-17
2018-19,2019-04-01,New York Rangers,0,Metropolitan,Eastern,75,2,158,0.47468354430379744,97,-22,92,-17
2018-19,2019-04-03,New York Rangers,0,Metropolitan,Eastern,75,2,160,0.46875,97,-22,94,-19
2018-19,2019-04-05,New York Rangers,1,Metropolitan,Eastern,76,2,162,0.4691358024691358,99,-23,96,-20
2018-19,2019-04-06,New York Rangers,2,Metropolitan,Eastern,78,2,164,0.47560975609756095,100,-22,98,-20
2018-19,2018-10-04,Ottawa Senators,1,Atlantic,Eastern,1,2,2,0.5,1,0,1,0
2018-19,2018-10-06,Ottawa Senators,2,Atlantic,Eastern,3,2,4,0.75,2,1,2,1
2018-19,2018-10-08,Ottawa Senators,0,Atlantic,Eastern,3,2,6,0.5,4,-1,3,0
2018-19,2018-10-10,Ottawa Senators,0,Atlantic,Eastern,3,2,8,0.375,4,-1,3,0
2018-19,2018-10-13,Ottawa Senators,2,Atlantic,Eastern,5,2,10,0.5,5,0,5,0
2018-19,2018-10-15,Ottawa Senators,2,Atlantic,Eastern,7,2,12,0.5833333333333334,7,0,6,1
2018-19,2018-10-20,Ottawa Senators,2,Atlantic,Eastern,9,2,14,0.6428571428571429,9,0,8,1
2018-19,2018-10-23,Ottawa Senators,0,Atlantic,Eastern,9,2,16,0.5625,12,-3,9,0
2018-19,2018-10-27,Ottawa Senators,0,Atlantic,Eastern,9,2,18,0.5,14,-5,12,-3
2018-19,2018-10-29,Ottawa Senators,1,Atlantic,Eastern,10,2,20,0.5,14,-4,12,-2
2018-19,2018-10-31,Ottawa Senators,0,Atlantic,Eastern,10,2,22,0.45454545454545453,16,-6,13,-3
2018-19,2018-11-01,Ottawa Senators,2,Atlantic,Eastern,12,2,24,0.5,16,-4,13,-1
2018-19,2018-11-03,Ottawa Senators,0,Atlantic,Eastern,12,2,26,0.46153846153846156,16,-4,14,-2
2018-19,2018-11-05,Ottawa Senators,1,Atlantic,Eastern,13,2,28,0.4642857142857143,16,-3,15,-2
2018-19,2018-11-07,Ottawa Senators,2,Atlantic,Eastern,15,2,30,0.5,18,-3,15,0
2018-19,2018-11-09,Ottawa Senators,0,Atlantic,Eastern,15,2,32,0.46875,19,-4,17,-2
2018-19,2018-11-11,Ottawa Senators,0,Atlantic,Eastern,15,2,34,0.4411764705882353,21,-6,18,-3
2018-19,2018-11-11,Ottawa Senators,2,Atlantic,Eastern,17,2,36,0.4722222222222222,21,-4,18,-1
2018-19,2018-11-16,Ottawa Senators,2,Atlantic,Eastern,19,2,38,0.5,23,-4,20,-1
2018-19,2018-11-18,Ottawa Senators,2,Atlantic,Eastern,21,2,40,0.525,26,-5,22,-1
2018-19,2018-11-20,Ottawa Senators,0,Atlantic,Eastern,21,2,42,0.5,28,-7,23,-2
2018-19,2018-11-22,Ottawa Senators,0,Atlantic,Eastern,21,2,44,0.4772727272727273,30,-9,25,-4
2018-19,2018-11-24,Ottawa Senators,0,Atlantic,Eastern,21,2,46,0.45652173913043476,30,-9,26,-5
2018-19,2018-11-27,Ottawa Senators,0,Atlantic,Eastern,21,2,48,0.4375,34,-13,27,-6
2018-19,2018-11-28,Ottawa Senators,2,Atlantic,Eastern,23,2,50,0.46,34,-11,27,-4
2018-19,2018-11-30,Ottawa Senators,2,Atlantic,Eastern,25,2,52,0.4807692307692308,36,-11,27,-2
2018-19,2018-12-01,Ottawa Senators,2,Atlantic,Eastern,27,2,54,0.5,36,-9,28,-1
2018-19,2018-12-05,Ottawa Senators,0,Atlantic,Eastern,27,2,56,0.48214285714285715,38,-11,29,-2
2018-19,2018-12-07,Ottawa Senators,0,Atlantic,Eastern,27,2,58,0.46551724137931033,38,-11,30,-3
2018-19,2018-12-09,Ottawa Senators,1,Atlantic,Eastern,28,2,60,0.4666666666666667,38,-10,31,-3
2018-19,2018-12-09,Ottawa Senators,2,Atlantic,Eastern,30,2,62,0.4838709677419355,38,-8,31,-1
2018-19,2018-12-12,Ottawa Senators,0,Atlantic,Eastern,30,2,64,0.46875,40,-10,32,-2
2018-19,2018-12-15,Ottawa Senators,2,Atlantic,Eastern,32,2,66,0.48484848484848486,42,-10,34,-2
2018-19,2018-12-16,Ottawa Senators,0,Atlantic,Eastern,32,2,68,0.47058823529411764,44,-12,36,-4
2018-19,2018-12-18,Ottawa Senators,2,Atlantic,Eastern,34,2,70,0.4857142857142857,43,-9,36,-2
2018-19,2018-12-22,Ottawa Senators,0,Atlantic,Eastern,34,2,72,0.4722222222222222,45,-11,40,-6
2018-19,2018-12-23,Ottawa Senators,0,Atlantic,Eastern,34,2,74,0.4594594594594595,47,-13,42,-8
2018-19,2018-12-29,Ottawa Senators,0,Atlantic,Eastern,34,2,76,0.4473684210526316,47,-13,44,-10
2018-19,2018-12-30,Ottawa Senators,0,Atlantic,Eastern,34,2,78,0.4358974358974359,48,-14,45,-11
2018-19,2019-01-01,Ottawa Senators,0,Atlantic,Eastern,34,2,80,0.425,48,-14,47,-13
2018-19,2019-01-03,Ottawa Senators,1,Atlantic,Eastern,35,2,82,0.4268292682926829,48,-13,47,-12
2018-19,2019-01-05,Ottawa Senators,0,Atlantic,Eastern,35,2,84,0.4166666666666667,50,-15,49,-14
2018-19,2019-01-06,Ottawa Senators,0,Atlantic,Eastern,35,2,86,0.4069767441860465,52,-17,50,-15
2018-19,2019-01-10,Ottawa Senators,2,Atlantic,Eastern,37,2,88,0.42045454545454547,54,-17,51,-14
2018-19,2019-01-11,Ottawa Senators,2,Atlantic,Eastern,39,2,90,0.43333333333333335,54,-15,52,-13
2018-19,2019-01-13,Ottawa Senators,0,Atlantic,Eastern,39,2,92,0.42391304347826086,56,-17,52,-13
2018-19,2019-01-17,Ottawa Senators,2,Atlantic,Eastern,41,2,94,0.43617021276595747,57,-16,56,-15
2018-19,2019-01-19,Ottawa Senators,2,Atlantic,Eastern,43,2,96,0.4479166666666667,59,-16,58,-15
2018-19,2019-01-20,Ottawa Senators,0,Atlantic,Eastern,43,2,98,0.4387755102040816,59,-16,58,-15
2018-19,2019-01-23,Ottawa Senators,0,Atlantic,Eastern,43,2,100,0.43,59,-16,58,-15
2018-19,2019-02-02,Ottawa Senators,0,Atlantic,Eastern,43,2,102,0.4215686274509804,62,-19,59,-16
2018-19,2019-02-03,Ottawa Senators,0,Atlantic,Eastern,43,2,104,0.41346153846153844,64,-21,59,-16
2018-19,2019-02-07,Ottawa Senators,0,Atlantic,Eastern,43,2,106,0.4056603773584906,66,-23,61,-18
2018-19,2019-02-08,Ottawa Senators,2,Atlantic,Eastern,45,2,108,0.4166666666666667,68,-23,63,-18
2018-19,2019-02-09,Ottawa Senators,2,Atlantic,Eastern,47,2,110,0.42727272727272725,68,-21,63,-16
2018-19,2019-02-13,Ottawa Senators,0,Atlantic,Eastern,47,2,112,0.41964285714285715,72,-25,65,-18
2018-19,2019-02-15,Ottawa Senators,0,Atlantic,Eastern,47,2,114,0.41228070175438597,72,-25,67,-20
2018-19,2019-02-17,Ottawa Senators,2,Atlantic,Eastern,49,2,116,0.4224137931034483,75,-26,69,-20
2018-19,2019-02-19,Ottawa Senators,0,Atlantic,Eastern,49,2,118,0.4152542372881356,75,-26,69,-20
2018-19,2019-02-22,Ottawa Senators,0,Atlantic,Eastern,49,2,120,0.4083333333333333,76,-27,70,-21
2018-19,2019-02-23,Ottawa Senators,0,Atlantic,Eastern,49,2,122,0.4016393442622951,76,-27,71,-22
2018-19,2019-02-25,Ottawa Senators,0,Atlantic,Eastern,49,2,124,0.3951612903225806,78,-29,72,-23
2018-19,2019-02-27,Ottawa Senators,0,Atlantic,Eastern,49,2,126,0.3888888888888889,80,-31,74,-25
2018-19,2019-03-01,Ottawa Senators,0,Atlantic,Eastern,49,2,128,0.3828125,82,-33,74,-25
2018-19,2019-03-03,Ottawa Senators,0,Atlantic,Eastern,49,2,130,0.3769230769230769,84,-35,77,-28
2018-19,2019-03-03,Ottawa Senators,2,Atlantic,Eastern,51,2,132,0.38636363636363635,84,-33,77,-26
2018-19,2019-03-06,Ottawa Senators,1,Atlantic,Eastern,52,2,134,0.3880597014925373,86,-34,79,-27
2018-19,2019-03-08,Ottawa Senators,0,Atlantic,Eastern,52,2,136,0.38235294117647056,87,-35,79,-27
2018-19,2019-03-10,Ottawa Senators,0,Atlantic,Eastern,52,2,138,0.37681159420289856,89,-37,79,-27
2018-19,2019-03-11,Ottawa Senators,0,Atlantic,Eastern,52,2,140,0.37142857142857144,89,-37,79,-27
2018-19,2019-03-14,Ottawa Senators,2,Atlantic,Eastern,54,2,142,0.38028169014084506,89,-35,81,-27
2018-19,2019-03-16,Ottawa Senators,2,Atlantic,Eastern,56,2,144,0.3888888888888889,91,-35,84,-28
2018-19,2019-03-21,Ottawa Senators,0,Atlantic,Eastern,56,2,146,0.3835616438356164,93,-37,85,-29
2018-19,2019-03-22,Ottawa Senators,0,Atlantic,Eastern,56,2,148,0.3783783783783784,93,-37,85,-29
2018-19,2019-03-23,Ottawa Senators,2,Atlantic,Eastern,58,2,150,0.38666666666666666,94,-36,87,-29
2018-19,2019-03-26,Ottawa Senators,2,Atlantic,Eastern,60,2,152,0.39473684210526316,96,-36,90,-30
2018-19,2019-03-28,Ottawa Senators,0,Atlantic,Eastern,60,2,154,0.38961038961038963,97,-37,90,-30
2018-19,2019-03-30,Ottawa Senators,2,Atlantic,Eastern,62,2,156,0.3974358974358974,97,-35,92,-30
2018-19,2019-04-01,Ottawa Senators,0,Atlantic,Eastern,62,2,158,0.3924050632911392,99,-37,92,-30
2018-19,2019-04-03,Ottawa Senators,2,Atlantic,Eastern,64,2,160,0.4,99,-35,94,-30
2018-19,2019-04-04,Ottawa Senators,0,Atlantic,Eastern,64,2,162,0.3950617283950617,99,-35,94,-30
2018-19,2019-04-06,Ottawa Senators,0,Atlantic,Eastern,64,2,164,0.3902439024390244,100,-36,98,-34
2018-19,2018-10-05,Philadelphia Flyers,2,Metropolitan,Eastern,2,2,2,1.0,2,0,2,0
2018-19,2018-10-07,Philadelphia Flyers,0,Metropolitan,Eastern,2,2,4,0.5,2,0,2,0
2018-19,2018-10-09,Philadelphia Flyers,0,Metropolitan,Eastern,2,2,6,0.3333333333333333,4,-2,3,-1
2018-19,2018-10-10,Philadelphia Flyers,2,Metropolitan,Eastern,4,2,8,0.5,4,0,3,1
2018-19,2018-10-13,Philadelphia Flyers,0,Metropolitan,Eastern,4,2,10,0.4,5,-1,5,-1
2018-19,2018-10-16,Philadelphia Flyers,2,Metropolitan,Eastern,6,2,12,0.5,6,0,6,0
2018-19,2018-10-18,Philadelphia Flyers,0,Metropolitan,Eastern,6,2,14,0.42857142857142855,8,-2,8,-2
2018-19,2018-10-20,Philadelphia Flyers,2,Metropolitan,Eastern,8,2,16,0.5,8,0,8,0
2018-19,2018-10-22,Philadelphia Flyers,0,Metropolitan,Eastern,8,2,18,0.4444444444444444,8,0,8,0
2018-19,2018-10-25,Philadelphia Flyers,0,Metropolitan,Eastern,8,2,20,0.4,10,-2,10,-2
2018-19,2018-10-27,Philadelphia Flyers,0,Metropolitan,Eastern,8,2,22,0.36363636363636365,12,-4,12,-4
2018-19,2018-10-31,Philadelphia Flyers,2,Metropolitan,Eastern,10,2,24,0.4166666666666667,13,-3,13,-3
2018-19,2018-11-02,Philadelphia Flyers,2,Metropolitan,Eastern,12,2,26,0.46153846153846156,14,-2,14,-2
2018-19,2018-11-04,Philadelphia Flyers,1,Metropolitan,Eastern,13,2,28,0.4642857142857143,14,-1,14,-1
2018-19,2018-11-06,Philadelphia Flyers,2,Metropolitan,Eastern,15,2,30,0.5,15,0,15,0
2018-19,2018-11-09,Philadelphia Flyers,2,Metropolitan,Eastern,17,2,32,0.53125,17,0,17,0
2018-19,2018-11-10,Philadelphia Flyers,2,Metropolitan,Eastern,19,2,34,0.5588235294117647,18,1,18,1
2018-19,2018-11-14,Philadelphia Flyers,0,Metropolitan,Eastern,19,2,36,0.5277777777777778,20,-1,20,-1
2018-19,2018-11-16,Philadelphia Flyers,0,Metropolitan,Eastern,19,2,38,0.5,20,-1,20,-1
2018-19,2018-11-17,Philadelphia Flyers,1,Metropolitan,Eastern,20,2,40,0.5,21,-1,21,-1
2018-19,2018-11-22,Philadelphia Flyers,0,Metropolitan,Eastern,20,2,42,0.47619047619047616,25,-5,25,-5
2018-19,2018-11-23,Philadelphia Flyers,2,Metropolitan,Eastern,22,2,44,0.5,26,-4,26,-4
2018-19,2018-11-25,Philadelphia Flyers,0,Metropolitan,Eastern,22,2,46,0.4782608695652174,26,-4,26,-4
2018-19,2018-11-28,Philadelphia Flyers,0,Metropolitan,Eastern,22,2,48,0.4583333333333333,28,-6,27,-5
2018-19,2018-12-02,Philadelphia Flyers,2,Metropolitan,Eastern,24,2,50,0.48,29,-5,29,-5
2018-19,2018-12-07,Philadelphia Flyers,1,Metropolitan,Eastern,25,2,52,0.4807692307692308,29,-4,30,-5
2018-19,2018-12-08,Philadelphia Flyers,2,Metropolitan,Eastern,27,2,54,0.5,30,-3,30,-3
2018-19,2018-12-09,Philadelphia Flyers,0,Metropolitan,Eastern,27,2,56,0.48214285714285715,31,-4,31,-4
2018-19,2018-12-13,Philadelphia Flyers,1,Metropolitan,Eastern,28,2,58,0.4827586206896552,32,-4,32,-4
2018-19,2018-12-15,Philadelphia Flyers,0,Metropolitan,Eastern,28,2,60,0.4666666666666667,34,-6,34,-6
2018-19,2018-12-16,Philadelphia Flyers,0,Metropolitan,Eastern,28,2,62,0.45161290322580644,36,-8,36,-8
2018-19,2018-12-19,Philadelphia Flyers,2,Metropolitan,Eastern,30,2,64,0.46875,38,-8,38,-8
2018-19,2018-12-21,Philadelphia Flyers,2,Metropolitan,Eastern,32,2,66,0.48484848484848486,40,-8,40,-8
2018-19,2018-12-22,Philadelphia Flyers,0,Metropolitan,Eastern,32,2,68,0.47058823529411764,40,-8,40,-8
2018-19,2018-12-24,Philadelphia Flyers,2,Metropolitan,Eastern,34,2,70,0.4857142857142857,42,-8,42,-8
2018-19,2018-12-28,Philadelphia Flyers,1,Metropolitan,Eastern,35,2,72,0.4861111111111111,44,-9,43,-8
2018-19,2018-12-30,Philadelphia Flyers,0,Metropolitan,Eastern,35,2,74,0.47297297297297297,46,-11,45,-10
2018-19,2018-12-31,Philadelphia Flyers,0,Metropolitan,Eastern,35,2,76,0.4605263157894737,47,-12,46,-11
2018-19,2019-01-02,Philadelphia Flyers,0,Metropolitan,Eastern,35,2,78,0.44871794871794873,48,-13,47,-12
2018-19,2019-01-04,Philadelphia Flyers,0,Metropolitan,Eastern,35,2,80,0.4375,49,-14,49,-14
2018-19,2019-01-05,Philadelphia Flyers,1,Metropolitan,Eastern,36,2,82,0.43902439024390244,49,-13,49,-13
2018-19,2019-01-08,Philadelphia Flyers,0,Metropolitan,Eastern,36,2,84,0.42857142857142855,51,-15,50,-14
2018-19,2019-01-09,Philadelphia Flyers,0,Metropolitan,Eastern,36,2,86,0.4186046511627907,51,-15,51,-15
2018-19,2019-01-11,Philadelphia Flyers,2,Metropolitan,Eastern,38,2,88,0.4318181818181818,53,-15,52,-14
2018-19,2019-01-12,Philadelphia Flyers,0,Metropolitan,Eastern,38,2,90,0.4222222222222222,53,-15,52,-14
2018-19,2019-01-15,Philadelphia Flyers,2,Metropolitan,Eastern,40,2,92,0.43478260869565216,56,-16,54,-14
2018-19,2019-01-17,Philadelphia Flyers,2,Metropolitan,Eastern,42,2,94,0.44680851063829785,56,-14,56,-14
2018-19,2019-01-20,Philadelphia Flyers,2,Metropolitan,Eastern,44,2,96,0.4583333333333333,59,-15,58,-14
2018-19,2019-01-29,Philadelphia Flyers,2,Metropolitan,Eastern,46,2,98,0.46938775510204084,59,-13,58,-12
2018-19,2019-01-30,Philadelphia Flyers,2,Metropolitan,Eastern,48,2,100,0.48,59,-11,58,-10
2018-19,2019-02-01,Philadelphia Flyers,2,Metropolitan,Eastern,50,2,102,0.49019607843137253,60,-10,59,-9
2018-19,2019-02-02,Philadelphia Flyers,2,Metropolitan,Eastern,52,2,104,0.5,62,-10,59,-7
2018-19,2019-02-05,Philadelphia Flyers,2,Metropolitan,Eastern,54,2,106,0.5094339622641509,62,-8,59,-5
2018-19,2019-02-08,Philadelphia Flyers,1,Metropolitan,Eastern,55,2,108,0.5092592592592593,63,-8,63,-8
2018-19,2019-02-09,Philadelphia Flyers,2,Metropolitan,Eastern,57,2,110,0.5181818181818182,63,-6,63,-6
2018-19,2019-02-12,Philadelphia Flyers,0,Metropolitan,Eastern,57,2,112,0.5089285714285714,65,-8,65,-8
2018-19,2019-02-13,Philadelphia Flyers,2,Metropolitan,Eastern,59,2,114,0.5175438596491229,67,-8,65,-6
2018-19,2019-02-16,Philadelphia Flyers,2,Metropolitan,Eastern,61,2,116,0.5258620689655172,67,-6,67,-6
2018-19,2019-02-17,Philadelphia Flyers,2,Metropolitan,Eastern,63,2,118,0.5338983050847458,69,-6,69,-6
2018-19,2019-02-20,Philadelphia Flyers,0,Metropolitan,Eastern,63,2,120,0.525,71,-8,69,-6
2018-19,2019-02-22,Philadelphia Flyers,0,Metropolitan,Eastern,63,2,122,0.5163934426229508,71,-8,70,-7
2018-19,2019-02-24,Philadelphia Flyers,2,Metropolitan,Eastern,65,2,124,0.5241935483870968,73,-8,72,-7
2018-19,2019-02-27,Philadelphia Flyers,2,Metropolitan,Eastern,67,2,126,0.5317460317460317,74,-7,74,-7
2018-19,2019-03-01,Philadelphia Flyers,1,Metropolitan,Eastern,68,2,128,0.53125,75,-7,74,-6
2018-19,2019-03-02,Philadelphia Flyers,2,Metropolitan,Eastern,70,2,130,0.5384615384615384,76,-6,75,-5
2018-19,2019-03-03,Philadelphia Flyers,2,Metropolitan,Eastern,72,2,132,0.5454545454545454,78,-6,77,-5
2018-19,2019-03-07,Philadelphia Flyers,0,Metropolitan,Eastern,72,2,134,0.5373134328358209,79,-7,79,-7
2018-19,2019-03-10,Philadelphia Flyers,2,Metropolitan,Eastern,74,2,136,0.5441176470588235,81,-7,79,-5
2018-19,2019-03-11,Philadelphia Flyers,2,Metropolitan,Eastern,76,2,138,0.5507246376811594,81,-5,79,-3
2018-19,2019-03-14,Philadelphia Flyers,0,Metropolitan,Eastern,76,2,140,0.5428571428571428,87,-11,81,-5
2018-19,2019-03-15,Philadelphia Flyers,0,Metropolitan,Eastern,76,2,142,0.5352112676056338,87,-11,83,-7
2018-19,2019-03-17,Philadelphia Flyers,2,Metropolitan,Eastern,78,2,144,0.5416666666666666,88,-10,84,-6
2018-19,2019-03-19,Philadelphia Flyers,0,Metropolitan,Eastern,78,2,146,0.5342465753424658,89,-11,84,-6
2018-19,2019-03-22,Philadelphia Flyers,2,Metropolitan,Eastern,80,2,148,0.5405405405405406,91,-11,85,-5
2018-19,2019-03-23,Philadelphia Flyers,0,Metropolitan,Eastern,80,2,150,0.5333333333333333,91,-11,87,-7
2018-19,2019-03-24,Philadelphia Flyers,0,Metropolitan,Eastern,80,2,152,0.5263157894736842,93,-13,88,-8
2018-19,2019-03-27,Philadelphia Flyers,2,Metropolitan,Eastern,82,2,154,0.5324675324675324,95,-13,90,-8
2018-19,2019-03-30,Philadelphia Flyers,0,Metropolitan,Eastern,82,2,156,0.5256410256410257,95,-13,92,-10
2018-19,2019-03-31,Philadelphia Flyers,0,Metropolitan,Eastern,82,2,158,0.5189873417721519,97,-15,92,-10
2018-19,2019-04-03,Philadelphia Flyers,0,Metropolitan,Eastern,82,2,160,0.5125,97,-15,94,-12
2018-19,2019-04-05,Philadelphia Flyers,0,Metropolitan,Eastern,82,2,162,0.5061728395061729,99,-17,96,-14
2018-19,2019-04-06,Philadelphia Flyers,0,Metropolitan,Eastern,82,2,164,0.5,100,-18,98,-16
2018-19,2018-10-04,Pittsburgh Penguins,2,Metropolitan,Eastern,2,2,2,1.0,2,0,1,1
2018-19,2018-10-06,Pittsburgh Penguins,0,Metropolitan,Eastern,2,2,4,0.5,2,0,2,0
2018-19,2018-10-11,Pittsburgh Penguins,2,Metropolitan,Eastern,4,2,6,0.6666666666666666,5,-1,4,0
2018-19,2018-10-13,Pittsburgh Penguins,1,Metropolitan,Eastern,5,2,8,0.625,5,0,5,0
2018-19,2018-10-16,Pittsburgh Penguins,1,Metropolitan,Eastern,6,2,10,0.6,6,0,6,0
2018-19,2018-10-18,Pittsburgh Penguins,2,Metropolitan,Eastern,8,2,12,0.6666666666666666,8,0,8,0
2018-19,2018-10-24,Pittsburgh Penguins,2,Metropolitan,Eastern,10,2,14,0.7142857142857143,10,0,10,0
2018-19,2018-10-26,Pittsburgh Penguins,2,Metropolitan,Eastern,12,2,16,0.75,10,2,10,2
2018-19,2018-10-28,Pittsburgh Penguins,2,Metropolitan,Eastern,14,2,18,0.7777777777777778,12,2,12,2
2018-19,2018-10-30,Pittsburgh Penguins,0,Metropolitan,Eastern,14,2,20,0.7,13,1,13,1
2018-19,2018-11-01,Pittsburgh Penguins,1,Metropolitan,Eastern,15,2,22,0.6818181818181818,13,2,13,2
2018-19,2018-11-03,Pittsburgh Penguins,0,Metropolitan,Eastern,15,2,24,0.625,14,1,14,1
2018-19,2018-11-06,Pittsburgh Penguins,0,Metropolitan,Eastern,15,2,26,0.5769230769230769,15,0,15,0
2018-19,2018-11-08,Pittsburgh Penguins,0,Metropolitan,Eastern,15,2,28,0.5357142857142857,17,-2,16,-1
2018-19,2018-11-11,Pittsburgh Penguins,2,Metropolitan,Eastern,17,2,30,0.5666666666666667,18,-1,18,-1
2018-19,2018-11-14,Pittsburgh Penguins,0,Metropolitan,Eastern,17,2,32,0.53125,20,-3,20,-3
2018-19,2018-11-16,Pittsburgh Penguins,0,Metropolitan,Eastern,17,2,34,0.5,20,-3,20,-3
2018-19,2018-11-18,Pittsburgh Penguins,0,Metropolitan,Eastern,17,2,36,0.4722222222222222,22,-5,22,-5
2018-19,2018-11-20,Pittsburgh Penguins,1,Metropolitan,Eastern,18,2,38,0.47368421052631576,23,-5,23,-5
2018-19,2018-11-22,Pittsburgh Penguins,2,Metropolitan,Eastern,20,2,40,0.5,25,-5,25,-5
2018-19,2018-11-24,Pittsburgh Penguins,1,Metropolitan,Eastern,21,2,42,0.5,26,-5,26,-5
2018-19,2018-11-25,Pittsburgh Penguins,2,Metropolitan,Eastern,23,2,44,0.5227272727272727,26,-3,26,-3
2018-19,2018-11-28,Pittsburgh Penguins,2,Metropolitan,Eastern,25,2,46,0.5434782608695652,28,-3,27,-2
2018-19,2018-11-29,Pittsburgh Penguins,0,Metropolitan,Eastern,25,2,48,0.5208333333333334,28,-3,27,-2
2018-19,2018-12-02,Pittsburgh Penguins,0,Metropolitan,Eastern,25,2,50,0.5,29,-4,29,-4
2018-19,2018-12-05,Pittsburgh Penguins,2,Metropolitan,Eastern,27,2,52,0.5192307692307693,29,-2,29,-2
2018-19,2018-12-07,Pittsburgh Penguins,2,Metropolitan,Eastern,29,2,54,0.5370370370370371,29,0,30,-1
2018-19,2018-12-09,Pittsburgh Penguins,1,Metropolitan,Eastern,30,2,56,0.5357142857142857,31,-1,31,-1
2018-19,2018-12-11,Pittsburgh Penguins,2,Metropolitan,Eastern,32,2,58,0.5517241379310345,32,0,32,0
2018-19,2018-12-13,Pittsburgh Penguins,0,Metropolitan,Eastern,32,2,60,0.5333333333333333,32,0,32,0
2018-19,2018-12-15,Pittsburgh Penguins,2,Metropolitan,Eastern,34,2,62,0.5483870967741935,34,0,34,0
2018-19,2018-12-16,Pittsburgh Penguins,2,Metropolitan,Eastern,36,2,64,0.5625,36,0,36,0
2018-19,2018-12-18,Pittsburgh Penguins,0,Metropolitan,Eastern,36,2,66,0.5454545454545454,36,0,36,0
2018-19,2018-12-20,Pittsburgh Penguins,2,Metropolitan,Eastern,38,2,68,0.5588235294117647,38,0,38,0
2018-19,2018-12-21,Pittsburgh Penguins,2,Metropolitan,Eastern,40,2,70,0.5714285714285714,40,0,40,0
2018-19,2018-12-23,Pittsburgh Penguins,2,Metropolitan,Eastern,42,2,72,0.5833333333333334,42,0,42,0
2018-19,2018-12-28,Pittsburgh Penguins,2,Metropolitan,Eastern,44,2,74,0.5945945945945946,44,0,43,1
2018-19,2018-12-30,Pittsburgh Penguins,2,Metropolitan,Eastern,46,2,76,0.6052631578947368,46,0,45,1
2018-19,2018-12-31,Pittsburgh Penguins,2,Metropolitan,Eastern,48,2,78,0.6153846153846154,47,1,46,2
2018-19,2019-01-03,Pittsburgh Penguins,2,Metropolitan,Eastern,50,2,80,0.625,49,1,47,3
2018-19,2019-01-05,Pittsburgh Penguins,2,Metropolitan,Eastern,52,2,82,0.6341463414634146,49,3,49,3
2018-19,2019-01-07,Pittsburgh Penguins,0,Metropolitan,Eastern,52,2,84,0.6190476190476191,51,1,50,2
2018-19,2019-01-09,Pittsburgh Penguins,2,Metropolitan,Eastern,54,2,86,0.627906976744186,51,3,51,3
2018-19,2019-01-12,Pittsburgh Penguins,2,Metropolitan,Eastern,56,2,88,0.6363636363636364,53,3,52,4
2018-19,2019-01-13,Pittsburgh Penguins,0,Metropolitan,Eastern,56,2,90,0.6222222222222222,55,1,52,4
2018-19,2019-01-16,Pittsburgh Penguins,0,Metropolitan,Eastern,56,2,92,0.6086956521739131,56,0,56,0
2018-19,2019-01-19,Pittsburgh Penguins,2,Metropolitan,Eastern,58,2,94,0.6170212765957447,59,-1,58,0
2018-19,2019-01-20,Pittsburgh Penguins,0,Metropolitan,Eastern,58,2,96,0.6041666666666666,59,-1,58,0
2018-19,2019-01-29,Pittsburgh Penguins,0,Metropolitan,Eastern,58,2,98,0.5918367346938775,59,-1,58,0
2018-19,2019-01-31,Pittsburgh Penguins,2,Metropolitan,Eastern,60,2,100,0.6,60,0,59,1
2018-19,2019-02-02,Pittsburgh Penguins,2,Metropolitan,Eastern,62,2,102,0.6078431372549019,62,0,59,3
2018-19,2019-02-03,Pittsburgh Penguins,0,Metropolitan,Eastern,62,2,104,0.5961538461538461,62,0,59,3
2018-19,2019-02-06,Pittsburgh Penguins,0,Metropolitan,Eastern,62,2,106,0.5849056603773585,62,0,61,1
2018-19,2019-02-08,Pittsburgh Penguins,1,Metropolitan,Eastern,63,2,108,0.5833333333333334,63,0,63,0
2018-19,2019-02-10,Pittsburgh Penguins,0,Metropolitan,Eastern,63,2,110,0.5727272727272728,65,-2,63,0
2018-19,2019-02-12,Pittsburgh Penguins,2,Metropolitan,Eastern,65,2,112,0.5803571428571429,65,0,65,0
2018-19,2019-02-14,Pittsburgh Penguins,2,Metropolitan,Eastern,67,2,114,0.5877192982456141,67,0,67,0
2018-19,2019-02-16,Pittsburgh Penguins,0,Metropolitan,Eastern,67,2,116,0.5775862068965517,67,0,67,0
2018-19,2019-02-17,Pittsburgh Penguins,2,Metropolitan,Eastern,69,2,118,0.5847457627118644,69,0,69,0
2018-19,2019-02-20,Pittsburgh Penguins,2,Metropolitan,Eastern,71,2,120,0.5916666666666667,71,0,69,2
2018-19,2019-02-22,Pittsburgh Penguins,0,Metropolitan,Eastern,71,2,122,0.5819672131147541,71,0,70,1
2018-19,2019-02-24,Pittsburgh Penguins,1,Metropolitan,Eastern,72,2,124,0.5806451612903226,73,-1,72,0
2018-19,2019-02-27,Pittsburgh Penguins,2,Metropolitan,Eastern,74,2,126,0.5873015873015873,74,0,74,0
2018-19,2019-03-02,Pittsburgh Penguins,1,Metropolitan,Eastern,75,2,128,0.5859375,76,-1,75,0
2018-19,2019-03-03,Pittsburgh Penguins,2,Metropolitan,Eastern,77,2,130,0.5923076923076923,78,-1,77,0
2018-19,2019-03-06,Pittsburgh Penguins,2,Metropolitan,Eastern,79,2,132,0.5984848484848485,79,0,79,0
2018-19,2019-03-08,Pittsburgh Penguins,2,Metropolitan,Eastern,81,2,134,0.6044776119402985,81,0,79,2
2018-19,2019-03-10,Pittsburgh Penguins,0,Metropolitan,Eastern,81,2,136,0.5955882352941176,81,0,79,2
2018-19,2019-03-10,Pittsburgh Penguins,2,Metropolitan,Eastern,83,2,138,0.6014492753623188,81,2,79,4
2018-19,2019-03-12,Pittsburgh Penguins,2,Metropolitan,Eastern,85,2,140,0.6071428571428571,85,0,81,4
2018-19,2019-03-14,Pittsburgh Penguins,2,Metropolitan,Eastern,87,2,142,0.6126760563380281,87,0,81,6
2018-19,2019-03-16,Pittsburgh Penguins,0,Metropolitan,Eastern,87,2,144,0.6041666666666666,87,0,84,3
2018-19,2019-03-17,Pittsburgh Penguins,1,Metropolitan,Eastern,88,2,146,0.6027397260273972,88,0,84,4
2018-19,2019-03-19,Pittsburgh Penguins,1,Metropolitan,Eastern,89,2,148,0.6013513513513513,89,0,84,5
2018-19,2019-03-22,Pittsburgh Penguins,2,Metropolitan,Eastern,91,2,150,0.6066666666666667,91,0,85,6
2018-19,2019-03-24,Pittsburgh Penguins,2,Metropolitan,Eastern,93,2,152,0.6118421052631579,93,0,88,5
2018-19,2019-03-25,Pittsburgh Penguins,2,Metropolitan,Eastern,95,2,154,0.6168831168831169,95,0,88,7
2018-19,2019-03-29,Pittsburgh Penguins,0,Metropolitan,Eastern,95,2,156,0.6089743589743589,95,0,90,5
2018-19,2019-03-31,Pittsburgh Penguins,2,Metropolitan,Eastern,97,2,158,0.6139240506329114,97,0,92,5
2018-19,2019-04-02,Pittsburgh Penguins,0,Metropolitan,Eastern,97,2,160,0.60625,97,0,94,3
2018-19,2019-04-04,Pittsburgh Penguins,2,Metropolitan,Eastern,99,2,162,0.6111111111111112,99,0,94,5
2018-19,2019-04-06,Pittsburgh Penguins,1,Metropolitan,Eastern,100,2,164,0.6097560975609756,100,0,98,2
2018-19,2018-10-04,San Jose Sharks,0,Pacific,Western,0,2,2,0.0,0,0,0,0
2018-19,2018-10-06,San Jose Sharks,2,Pacific,Western,2,2,4,0.5,2,0,2,0
2018-19,2018-10-08,San Jose Sharks,0,Pacific,Western,2,2,6,0.3333333333333333,2,0,2,0
2018-19,2018-10-09,San Jose Sharks,2,Pacific,Western,4,2,8,0.5,3,1,2,2
2018-19,2018-10-11,San Jose Sharks,1,Pacific,Western,5,2,10,0.5,5,0,4,1
2018-19,2018-10-14,San Jose Sharks,0,Pacific,Western,5,2,12,0.4166666666666667,6,-1,6,-1
2018-19,2018-10-19,San Jose Sharks,2,Pacific,Western,7,2,14,0.5,8,-1,7,0
2018-19,2018-10-21,San Jose Sharks,2,Pacific,Western,9,2,16,0.5625,10,-1,10,-1
2018-19,2018-10-24,San Jose Sharks,2,Pacific,Western,11,2,18,0.6111111111111112,10,1,10,1
2018-19,2018-10-26,San Jose Sharks,1,Pacific,Western,12,2,20,0.6,11,1,11,1
2018-19,2018-10-29,San Jose Sharks,2,Pacific,Western,14,2,22,0.6363636363636364,13,1,13,1
2018-19,2018-10-31,San Jose Sharks,1,Pacific,Western,15,2,24,0.625,14,1,14,1
2018-19,2018-11-02,San Jose Sharks,0,Pacific,Western,15,2,26,0.5769230769230769,15,0,15,0
2018-19,2018-11-04,San Jose Sharks,2,Pacific,Western,17,2,28,0.6071428571428571,17,0,17,0
2018-19,2018-11-07,San Jose Sharks,2,Pacific,Western,19,2,30,0.6333333333333333,19,0,17,2
2018-19,2018-11-09,San Jose Sharks,0,Pacific,Western,19,2,32,0.59375,19,0,17,2
2018-19,2018-11-10,San Jose Sharks,0,Pacific,Western,19,2,34,0.5588235294117647,19,0,17,2
2018-19,2018-11-12,San Jose Sharks,2,Pacific,Western,21,2,36,0.5833333333333334,21,0,19,2
2018-19,2018-11-14,San Jose Sharks,2,Pacific,Western,23,2,38,0.6052631578947368,21,2,19,4
2018-19,2018-11-16,San Jose Sharks,0,Pacific,Western,23,2,40,0.575,21,2,20,3
2018-19,2018-11-18,San Jose Sharks,2,Pacific,Western,25,2,42,0.5952380952380952,22,3,22,3
2018-19,2018-11-21,San Jose Sharks,1,Pacific,Western,26,2,44,0.5909090909090909,22,4,22,4
2018-19,2018-11-24,San Jose Sharks,2,Pacific,Western,28,2,46,0.6086956521739131,25,3,25,3
2018-19,2018-11-25,San Jose Sharks,0,Pacific,Western,28,2,48,0.5833333333333334,25,3,25,3
2018-19,2018-11-28,San Jose Sharks,1,Pacific,Western,29,2,50,0.58,27,2,27,2
2018-19,2018-11-29,San Jose Sharks,0,Pacific,Western,29,2,52,0.5576923076923077,29,0,28,1
2018-19,2018-12-01,San Jose Sharks,0,Pacific,Western,29,2,54,0.5370370370370371,29,0,29,0
2018-19,2018-12-03,San Jose Sharks,2,Pacific,Western,31,2,56,0.5535714285714286,31,0,30,1
2018-19,2018-12-06,San Jose Sharks,2,Pacific,Western,33,2,58,0.5689655172413793,33,0,32,1
2018-19,2018-12-08,San Jose Sharks,0,Pacific,Western,33,2,60,0.55,33,0,33,0
2018-19,2018-12-09,San Jose Sharks,2,Pacific,Western,35,2,62,0.5645161290322581,35,0,33,2
2018-19,2018-12-11,San Jose Sharks,2,Pacific,Western,37,2,64,0.578125,37,0,35,2
2018-19,2018-12-14,San Jose Sharks,2,Pacific,Western,39,2,66,0.5909090909090909,39,0,37,2
2018-19,2018-12-17,San Jose Sharks,2,Pacific,Western,41,2,68,0.6029411764705882,41,0,39,2
2018-19,2018-12-19,San Jose Sharks,2,Pacific,Western,43,2,70,0.6142857142857143,43,0,39,4
2018-19,2018-12-21,San Jose Sharks,0,Pacific,Western,43,2,72,0.5972222222222222,43,0,39,4
2018-19,2018-12-22,San Jose Sharks,1,Pacific,Western,44,2,74,0.5945945945945946,43,1,39,5
2018-19,2018-12-24,San Jose Sharks,1,Pacific,Western,45,2,76,0.5921052631578947,44,1,39,6
2018-19,2018-12-28,San Jose Sharks,2,Pacific,Western,47,2,78,0.6025641025641025,46,1,41,6
2018-19,2018-12-29,San Jose Sharks,2,Pacific,Western,49,2,80,0.6125,48,1,41,8
2018-19,2019-01-01,San Jose Sharks,0,Pacific,Western,49,2,82,0.5975609756097561,49,0,44,5
2018-19,2019-01-03,San Jose Sharks,2,Pacific,Western,51,2,84,0.6071428571428571,51,0,45,6
2018-19,2019-01-06,San Jose Sharks,2,Pacific,Western,53,2,86,0.6162790697674418,53,0,45,8
2018-19,2019-01-08,San Jose Sharks,2,Pacific,Western,55,2,88,0.625,55,0,45,10
2018-19,2019-01-09,San Jose Sharks,2,Pacific,Western,57,2,90,0.6333333333333333,57,0,45,12
2018-19,2019-01-11,San Jose Sharks,2,Pacific,Western,59,2,92,0.6413043478260869,58,1,47,12
2018-19,2019-01-13,San Jose Sharks,2,Pacific,Western,61,2,94,0.648936170212766,60,1,47,14
2018-19,2019-01-16,San Jose Sharks,2,Pacific,Western,63,2,96,0.65625,60,3,49,14
2018-19,2019-01-17,San Jose Sharks,0,Pacific,Western,63,2,98,0.6428571428571429,60,3,49,14
2018-19,2019-01-20,San Jose Sharks,0,Pacific,Western,63,2,100,0.63,62,1,52,11
2018-19,2019-01-22,San Jose Sharks,0,Pacific,Western,63,2,102,0.6176470588235294,62,1,52,11
2018-19,2019-01-23,San Jose Sharks,2,Pacific,Western,65,2,104,0.625,62,3,52,13
2018-19,2019-02-03,San Jose Sharks,2,Pacific,Western,67,2,106,0.6320754716981132,62,5,54,13
2018-19,2019-02-06,San Jose Sharks,2,Pacific,Western,69,2,108,0.6388888888888888,64,5,54,15
2018-19,2019-02-08,San Jose Sharks,2,Pacific,Western,71,2,110,0.6454545454545455,66,5,55,16
2018-19,2019-02-10,San Jose Sharks,2,Pacific,Western,73,2,112,0.6517857142857143,66,7,59,14
2018-19,2019-02-12,San Jose Sharks,2,Pacific,Western,75,2,114,0.6578947368421053,66,9,59,16
2018-19,2019-02-15,San Jose Sharks,0,Pacific,Western,75,2,116,0.646551724137931,66,9,59,16
2018-19,2019-02-17,San Jose Sharks,2,Pacific,Western,77,2,118,0.652542372881356,68,9,60,17
2018-19,2019-02-19,San Jose Sharks,1,Pacific,Western,78,2,120,0.65,68,10,60,18
2018-19,2019-02-22,San Jose Sharks,2,Pacific,Western,80,2,122,0.6557377049180327,69,11,62,18
2018-19,2019-02-23,San Jose Sharks,0,Pacific,Western,80,2,124,0.6451612903225806,69,11,64,16
2018-19,2019-02-24,San Jose Sharks,2,Pacific,Western,82,2,126,0.6507936507936508,69,13,65,17
2018-19,2019-02-27,San Jose Sharks,0,Pacific,Western,82,2,128,0.640625,71,11,67,15
2018-19,2019-03-02,San Jose Sharks,2,Pacific,Western,84,2,130,0.6461538461538462,75,9,68,16
2018-19,2019-03-04,San Jose Sharks,2,Pacific,Western,86,2,132,0.6515151515151515,77,9,71,15
2018-19,2019-03-08,San Jose Sharks,2,Pacific,Western,88,2,134,0.6567164179104478,79,9,74,14
2018-19,2019-03-09,San Jose Sharks,2,Pacific,Western,90,2,136,0.6617647058823529,79,11,74,16
2018-19,2019-03-12,San Jose Sharks,2,Pacific,Western,92,2,138,0.6666666666666666,81,11,74,18
2018-19,2019-03-13,San Jose Sharks,2,Pacific,Western,94,2,140,0.6714285714285714,81,13,75,19
2018-19,2019-03-15,San Jose Sharks,0,Pacific,Western,94,2,142,0.6619718309859155,81,13,77,17
2018-19,2019-03-17,San Jose Sharks,0,Pacific,Western,94,2,144,0.6527777777777778,83,11,78,16
2018-19,2019-03-19,San Jose Sharks,0,Pacific,Western,94,2,146,0.6438356164383562,87,7,78,16
2018-19,2019-03-22,San Jose Sharks,0,Pacific,Western,94,2,148,0.6351351351351351,89,5,79,15
2018-19,2019-03-23,San Jose Sharks,1,Pacific,Western,95,2,150,0.6333333333333333,89,6,80,15
2018-19,2019-03-26,San Jose Sharks,0,Pacific,Western,95,2,152,0.625,90,5,81,14
2018-19,2019-03-29,San Jose Sharks,0,Pacific,Western,95,2,154,0.6168831168831169,90,5,83,12
2018-19,2019-03-31,San Jose Sharks,2,Pacific,Western,97,2,156,0.6217948717948718,91,6,85,12
2018-19,2019-04-01,San Jose Sharks,0,Pacific,Western,97,2,158,0.6139240506329114,91,6,85,12
2018-19,2019-04-03,San Jose Sharks,0,Pacific,Western,97,2,160,0.60625,93,4,88,9
2018-19,2019-04-05,San Jose Sharks,2,Pacific,Western,99,2,162,0.6111111111111112,93,6,90,9
2018-19,2019-04-07,San Jose Sharks,2,Pacific,Western,101,2,164,0.6158536585365854,93,8,90,11
2018-19,2018-10-05,St. Louis Blues,0,Central,Western,0,2,2,0.0,2,-2,0,0
2018-19,2018-10-07,St. Louis Blues,1,Central,Western,1,2,4,0.25,4,-3,2,-1
2018-19,2018-10-12,St. Louis Blues,2,Central,Western,3,2,6,0.5,6,-3,4,-1
2018-19,2018-10-14,St. Louis Blues,1,Central,Western,4,2,8,0.5,7,-3,6,-2
2018-19,2018-10-14,St. Louis Blues,0,Central,Western,4,2,10,0.4,7,-3,6,-2
2018-19,2018-10-17,St. Louis Blues,0,Central,Western,4,2,12,0.3333333333333333,8,-4,6,-2
2018-19,2018-10-20,St. Louis Blues,2,Central,Western,6,2,14,0.42857142857142855,11,-5,8,-2
2018-19,2018-10-23,St. Louis Blues,1,Central,Western,7,2,16,0.4375,13,-6,10,-3
2018-19,2018-10-26,St. Louis Blues,0,Central,Western,7,2,18,0.3888888888888889,14,-7,11,-4
2018-19,2018-10-28,St. Louis Blues,2,Central,Western,9,2,20,0.45,15,-6,12,-3
2018-19,2018-11-02,St. Louis Blues,2,Central,Western,11,2,22,0.5,16,-5,15,-4
2018-19,2018-11-04,St. Louis Blues,0,Central,Western,11,2,24,0.4583333333333333,17,-6,17,-6
2018-19,2018-11-07,St. Louis Blues,2,Central,Western,13,2,26,0.5,17,-4,17,-4
2018-19,2018-11-10,St. Louis Blues,2,Central,Western,15,2,28,0.5357142857142857,20,-5,17,-2
2018-19,2018-11-11,St. Louis Blues,0,Central,Western,15,2,30,0.5,20,-5,17,-2
2018-19,2018-11-15,St. Louis Blues,0,Central,Western,15,2,32,0.46875,23,-8,20,-5
2018-19,2018-11-17,St. Louis Blues,2,Central,Western,17,2,34,0.5,24,-7,21,-4
2018-19,2018-11-18,St. Louis Blues,0,Central,Western,17,2,36,0.4722222222222222,24,-7,22,-5
2018-19,2018-11-20,St. Louis Blues,0,Central,Western,17,2,38,0.4473684210526316,26,-9,22,-5
2018-19,2018-11-22,St. Louis Blues,0,Central,Western,17,2,40,0.425,26,-9,23,-6
2018-19,2018-11-24,St. Louis Blues,2,Central,Western,19,2,42,0.4523809523809524,28,-9,25,-6
2018-19,2018-11-25,St. Louis Blues,0,Central,Western,19,2,44,0.4318181818181818,30,-11,25,-6
2018-19,2018-11-29,St. Louis Blues,0,Central,Western,19,2,46,0.41304347826086957,30,-11,28,-9
2018-19,2018-12-01,St. Louis Blues,2,Central,Western,21,2,48,0.4375,31,-10,29,-8
2018-19,2018-12-02,St. Louis Blues,0,Central,Western,21,2,50,0.42,34,-13,29,-8
2018-19,2018-12-06,St. Louis Blues,1,Central,Western,22,2,52,0.4230769230769231,36,-14,32,-10
2018-19,2018-12-08,St. Louis Blues,2,Central,Western,24,2,54,0.4444444444444444,36,-12,33,-9
2018-19,2018-12-09,St. Louis Blues,0,Central,Western,24,2,56,0.42857142857142855,38,-14,33,-9
2018-19,2018-12-12,St. Louis Blues,2,Central,Western,26,2,58,0.4482758620689655,39,-13,35,-9
2018-19,2018-12-15,St. Louis Blues,2,Central,Western,28,2,60,0.4666666666666667,40,-12,38,-10
2018-19,2018-12-16,St. Louis Blues,0,Central,Western,28,2,62,0.45161290322580644,42,-14,39,-11
2018-19,2018-12-19,St. Louis Blues,2,Central,Western,30,2,64,0.46875,42,-12,39,-9
2018-19,2018-12-21,St. Louis Blues,0,Central,Western,30,2,66,0.45454545454545453,44,-14,39,-9
2018-19,2018-12-22,St. Louis Blues,2,Central,Western,32,2,68,0.47058823529411764,44,-12,39,-7
2018-19,2018-12-28,St. Louis Blues,2,Central,Western,34,2,70,0.4857142857142857,44,-10,41,-7
2018-19,2018-12-30,St. Louis Blues,0,Central,Western,34,2,72,0.4722222222222222,45,-11,43,-9
2018-19,2019-01-01,St. Louis Blues,0,Central,Western,34,2,74,0.4594594594594595,46,-12,44,-10
2018-19,2019-01-04,St. Louis Blues,2,Central,Western,36,2,76,0.47368421052631576,46,-10,45,-9
2018-19,2019-01-06,St. Louis Blues,0,Central,Western,36,2,78,0.46153846153846156,48,-12,45,-9
2018-19,2019-01-08,St. Louis Blues,2,Central,Western,38,2,80,0.475,48,-10,45,-7
2018-19,2019-01-09,St. Louis Blues,0,Central,Western,38,2,82,0.4634146341463415,50,-12,45,-7
2018-19,2019-01-11,St. Louis Blues,2,Central,Western,40,2,84,0.47619047619047616,50,-10,47,-7
2018-19,2019-01-13,St. Louis Blues,2,Central,Western,42,2,86,0.4883720930232558,50,-8,47,-5
2018-19,2019-01-15,St. Louis Blues,2,Central,Western,44,2,88,0.5,50,-6,47,-3
2018-19,2019-01-16,St. Louis Blues,1,Central,Western,45,2,90,0.5,50,-5,49,-4
2018-19,2019-01-18,St. Louis Blues,0,Central,Western,45,2,92,0.4891304347826087,50,-5,49,-4
2018-19,2019-01-20,St. Louis Blues,2,Central,Western,47,2,94,0.5,52,-5,52,-5
2018-19,2019-01-21,St. Louis Blues,0,Central,Western,47,2,96,0.4895833333333333,53,-6,52,-5
2018-19,2019-01-24,St. Louis Blues,2,Central,Western,49,2,98,0.5,55,-6,52,-3
2018-19,2019-02-03,St. Louis Blues,2,Central,Western,51,2,100,0.51,58,-7,54,-3
2018-19,2019-02-06,St. Louis Blues,2,Central,Western,53,2,102,0.5196078431372549,60,-7,54,-1
2018-19,2019-02-08,St. Louis Blues,2,Central,Western,55,2,104,0.5288461538461539,61,-6,55,0
2018-19,2019-02-09,St. Louis Blues,2,Central,Western,57,2,106,0.5377358490566038,61,-4,57,0
2018-19,2019-02-10,St. Louis Blues,2,Central,Western,59,2,108,0.5462962962962963,61,-2,59,0
2018-19,2019-02-13,St. Louis Blues,2,Central,Western,61,2,110,0.5545454545454546,63,-2,59,2
2018-19,2019-02-15,St. Louis Blues,2,Central,Western,63,2,112,0.5625,63,0,59,4
2018-19,2019-02-16,St. Louis Blues,2,Central,Western,65,2,114,0.5701754385964912,65,0,60,5
2018-19,2019-02-17,St. Louis Blues,2,Central,Western,67,2,116,0.5775862068965517,67,0,60,7
2018-19,2019-02-20,St. Louis Blues,2,Central,Western,69,2,118,0.5847457627118644,69,0,60,9
2018-19,2019-02-22,St. Louis Blues,0,Central,Western,69,2,120,0.575,69,0,62,7
2018-19,2019-02-23,St. Louis Blues,2,Central,Western,71,2,122,0.5819672131147541,71,0,64,7
2018-19,2019-02-25,St. Louis Blues,1,Central,Western,72,2,124,0.5806451612903226,72,0,66,6
2018-19,2019-02-27,St. Louis Blues,2,Central,Western,74,2,126,0.5873015873015873,74,0,67,7
2018-19,2019-03-02,St. Louis Blues,0,Central,Western,74,2,128,0.578125,74,0,68,6
2018-19,2019-03-03,St. Louis Blues,0,Central,Western,74,2,130,0.5692307692307692,74,0,70,4
2018-19,2019-03-07,St. Louis Blues,2,Central,Western,76,2,132,0.5757575757575758,76,0,72,4
2018-19,2019-03-08,St. Louis Blues,2,Central,Western,78,2,134,0.582089552238806,78,0,74,4
2018-19,2019-03-09,St. Louis Blues,1,Central,Western,79,2,136,0.5808823529411765,79,0,74,5
2018-19,2019-03-13,St. Louis Blues,0,Central,Western,79,2,138,0.572463768115942,79,0,75,4
2018-19,2019-03-14,St. Louis Blues,0,Central,Western,79,2,140,0.5642857142857143,79,0,75,4
2018-19,2019-03-16,St. Louis Blues,2,Central,Western,81,2,142,0.5704225352112676,81,0,77,4
2018-19,2019-03-17,St. Louis Blues,1,Central,Western,82,2,144,0.5694444444444444,82,0,78,4
2018-19,2019-03-20,St. Louis Blues,2,Central,Western,84,2,146,0.5753424657534246,84,0,78,6
2018-19,2019-03-22,St. Louis Blues,2,Central,Western,86,2,148,0.581081081081081,86,0,79,7
2018-19,2019-03-24,St. Louis Blues,2,Central,Western,88,2,150,0.5866666666666667,88,0,80,8
2018-19,2019-03-26,St. Louis Blues,2,Central,Western,90,2,152,0.5921052631578947,90,0,81,9
2018-19,2019-03-29,St. Louis Blues,0,Central,Western,90,2,154,0.5844155844155844,90,0,83,7
2018-19,2019-03-30,St. Louis Blues,2,Central,Western,92,2,156,0.5897435897435898,92,0,85,7
2018-19,2019-04-02,St. Louis Blues,2,Central,Western,94,2,158,0.5949367088607594,94,0,86,8
2018-19,2019-04-04,St. Louis Blues,1,Central,Western,95,2,160,0.59375,95,0,88,7
2018-19,2019-04-05,St. Louis Blues,2,Central,Western,97,2,162,0.5987654320987654,97,0,90,7
2018-19,2019-04-06,St. Louis Blues,2,Central,Western,99,2,164,0.6036585365853658,97,2,90,9
2018-19,2018-10-06,Tampa Bay Lightning,2,Atlantic,Eastern,2,2,2,1.0,2,0,2,0
2018-19,2018-10-11,Tampa Bay Lightning,0,Atlantic,Eastern,2,2,4,0.5,4,-2,4,-2
2018-19,2018-10-13,Tampa Bay Lightning,2,Atlantic,Eastern,4,2,6,0.6666666666666666,5,-1,5,-1
2018-19,2018-10-16,Tampa Bay Lightning,2,Atlantic,Eastern,6,2,8,0.75,7,-1,6,0
2018-19,2018-10-18,Tampa Bay Lightning,2,Atlantic,Eastern,8,2,10,0.8,8,0,8,0
2018-19,2018-10-21,Tampa Bay Lightning,2,Atlantic,Eastern,10,2,12,0.8333333333333334,10,0,8,2
2018-19,2018-10-21,Tampa Bay Lightning,1,Atlantic,Eastern,11,2,14,0.7857142857142857,10,1,8,3
2018-19,2018-10-25,Tampa Bay Lightning,2,Atlantic,Eastern,13,2,16,0.8125,13,0,10,3
2018-19,2018-10-26,Tampa Bay Lightning,2,Atlantic,Eastern,15,2,18,0.8333333333333334,14,1,10,5
2018-19,2018-10-28,Tampa Bay Lightning,0,Atlantic,Eastern,15,2,20,0.75,14,1,12,3
2018-19,2018-10-30,Tampa Bay Lightning,2,Atlantic,Eastern,17,2,22,0.7727272727272727,16,1,13,4
2018-19,2018-11-01,Tampa Bay Lightning,0,Atlantic,Eastern,17,2,24,0.7083333333333334,16,1,13,4
2018-19,2018-11-03,Tampa Bay Lightning,2,Atlantic,Eastern,19,2,26,0.7307692307692307,16,3,14,5
2018-19,2018-11-05,Tampa Bay Lightning,2,Atlantic,Eastern,21,2,28,0.75,16,5,15,6
2018-19,2018-11-07,Tampa Bay Lightning,2,Atlantic,Eastern,23,2,30,0.7666666666666667,18,5,15,8
2018-19,2018-11-09,Tampa Bay Lightning,2,Atlantic,Eastern,25,2,32,0.78125,19,6,17,8
2018-19,2018-11-11,Tampa Bay Lightning,0,Atlantic,Eastern,25,2,34,0.7352941176470589,21,4,18,7
2018-19,2018-11-14,Tampa Bay Lightning,0,Atlantic,Eastern,25,2,36,0.6944444444444444,22,3,20,5
2018-19,2018-11-16,Tampa Bay Lightning,2,Atlantic,Eastern,27,2,38,0.7105263157894737,23,4,20,7
2018-19,2018-11-17,Tampa Bay Lightning,2,Atlantic,Eastern,29,2,40,0.725,24,5,21,8
2018-19,2018-11-20,Tampa Bay Lightning,0,Atlantic,Eastern,29,2,42,0.6904761904761905,28,1,23,6
2018-19,2018-11-22,Tampa Bay Lightning,2,Atlantic,Eastern,31,2,44,0.7045454545454546,30,1,25,6
2018-19,2018-11-24,Tampa Bay Lightning,2,Atlantic,Eastern,33,2,46,0.717391304347826,30,3,26,7
2018-19,2018-11-26,Tampa Bay Lightning,2,Atlantic,Eastern,35,2,48,0.7291666666666666,32,3,26,9
2018-19,2018-11-28,Tampa Bay Lightning,0,Atlantic,Eastern,35,2,50,0.7,34,1,27,8
2018-19,2018-11-30,Tampa Bay Lightning,2,Atlantic,Eastern,37,2,52,0.7115384615384616,36,1,27,10
2018-19,2018-12-02,Tampa Bay Lightning,2,Atlantic,Eastern,39,2,54,0.7222222222222222,37,2,29,10
2018-19,2018-12-04,Tampa Bay Lightning,2,Atlantic,Eastern,41,2,56,0.7321428571428571,37,4,29,12
2018-19,2018-12-05,Tampa Bay Lightning,2,Atlantic,Eastern,43,2,58,0.7413793103448276,38,5,29,14
2018-19,2018-12-07,Tampa Bay Lightning,2,Atlantic,Eastern,45,2,60,0.75,38,7,30,15
2018-19,2018-12-09,Tampa Bay Lightning,2,Atlantic,Eastern,47,2,62,0.7580645161290323,38,9,31,16
2018-19,2018-12-11,Tampa Bay Lightning,2,Atlantic,Eastern,49,2,64,0.765625,38,11,32,17
2018-19,2018-12-14,Tampa Bay Lightning,2,Atlantic,Eastern,51,2,66,0.7727272727272727,42,9,32,19
2018-19,2018-12-17,Tampa Bay Lightning,1,Atlantic,Eastern,52,2,68,0.7647058823529411,43,9,36,16
2018-19,2018-12-19,Tampa Bay Lightning,2,Atlantic,Eastern,54,2,70,0.7714285714285715,45,9,38,16
2018-19,2018-12-21,Tampa Bay Lightning,2,Atlantic,Eastern,56,2,72,0.7777777777777778,45,11,40,16
2018-19,2018-12-23,Tampa Bay Lightning,2,Atlantic,Eastern,58,2,74,0.7837837837837838,47,11,42,16
2018-19,2018-12-28,Tampa Bay Lightning,2,Atlantic,Eastern,60,2,76,0.7894736842105263,47,13,43,17
2018-19,2018-12-30,Tampa Bay Lightning,2,Atlantic,Eastern,62,2,78,0.7948717948717948,48,14,45,17
2018-19,2019-01-01,Tampa Bay Lightning,2,Atlantic,Eastern,64,2,80,0.8,48,16,47,17
2018-19,2019-01-04,Tampa Bay Lightning,2,Atlantic,Eastern,66,2,82,0.8048780487804879,50,16,49,17
2018-19,2019-01-06,Tampa Bay Lightning,0,Atlantic,Eastern,66,2,84,0.7857142857142857,52,14,50,16
2018-19,2019-01-09,Tampa Bay Lightning,2,Atlantic,Eastern,68,2,86,0.7906976744186046,54,14,51,17
2018-19,2019-01-11,Tampa Bay Lightning,2,Atlantic,Eastern,70,2,88,0.7954545454545454,54,16,52,18
2018-19,2019-01-13,Tampa Bay Lightning,2,Atlantic,Eastern,72,2,90,0.8,56,16,52,20
2018-19,2019-01-14,Tampa Bay Lightning,0,Atlantic,Eastern,72,2,92,0.782608695652174,56,16,53,19
2018-19,2019-01-16,Tampa Bay Lightning,2,Atlantic,Eastern,74,2,94,0.7872340425531915,57,17,56,18
2018-19,2019-01-18,Tampa Bay Lightning,0,Atlantic,Eastern,74,2,96,0.7708333333333334,59,15,56,18
2018-19,2019-01-20,Tampa Bay Lightning,2,Atlantic,Eastern,76,2,98,0.7755102040816326,59,17,58,18
2018-19,2019-01-31,Tampa Bay Lightning,0,Atlantic,Eastern,76,2,100,0.76,61,15,59,17
2018-19,2019-02-02,Tampa Bay Lightning,2,Atlantic,Eastern,78,2,102,0.7647058823529411,62,16,59,19
2018-19,2019-02-03,Tampa Bay Lightning,2,Atlantic,Eastern,80,2,104,0.7692307692307693,64,16,59,21
2018-19,2019-02-06,Tampa Bay Lightning,1,Atlantic,Eastern,81,2,106,0.7641509433962265,66,15,61,20
2018-19,2019-02-08,Tampa Bay Lightning,1,Atlantic,Eastern,82,2,108,0.7592592592592593,68,14,63,19
2018-19,2019-02-10,Tampa Bay Lightning,2,Atlantic,Eastern,84,2,110,0.7636363636363637,70,14,63,21
2018-19,2019-02-10,Tampa Bay Lightning,2,Atlantic,Eastern,86,2,112,0.7678571428571429,70,16,63,23
2018-19,2019-02-13,Tampa Bay Lightning,2,Atlantic,Eastern,88,2,114,0.7719298245614035,72,16,65,23
2018-19,2019-02-15,Tampa Bay Lightning,2,Atlantic,Eastern,90,2,116,0.7758620689655172,72,18,67,23
2018-19,2019-02-17,Tampa Bay Lightning,2,Atlantic,Eastern,92,2,118,0.7796610169491526,75,17,69,23
2018-19,2019-02-19,Tampa Bay Lightning,2,Atlantic,Eastern,94,2,120,0.7833333333333333,75,19,69,25
2018-19,2019-02-20,Tampa Bay Lightning,2,Atlantic,Eastern,96,2,122,0.7868852459016393,76,20,69,27
2018-19,2019-02-22,Tampa Bay Lightning,2,Atlantic,Eastern,98,2,124,0.7903225806451613,76,22,70,28
2018-19,2019-02-26,Tampa Bay Lightning,2,Atlantic,Eastern,100,2,126,0.7936507936507936,80,20,72,28
2018-19,2019-02-28,Tampa Bay Lightning,2,Atlantic,Eastern,102,2,128,0.796875,82,20,74,28
2018-19,2019-03-01,Tampa Bay Lightning,0,Atlantic,Eastern,102,2,130,0.7846153846153846,82,20,74,28
2018-19,2019-03-03,Tampa Bay Lightning,2,Atlantic,Eastern,104,2,132,0.7878787878787878,84,20,77,27
2018-19,2019-03-06,Tampa Bay Lightning,2,Atlantic,Eastern,106,2,134,0.7910447761194029,86,20,79,27
2018-19,2019-03-08,Tampa Bay Lightning,0,Atlantic,Eastern,106,2,136,0.7794117647058824,87,19,79,27
2018-19,2019-03-10,Tampa Bay Lightning,2,Atlantic,Eastern,108,2,138,0.782608695652174,89,19,79,29
2018-19,2019-03-11,Tampa Bay Lightning,2,Atlantic,Eastern,110,2,140,0.7857142857142857,89,21,79,31
2018-19,2019-03-14,Tampa Bay Lightning,2,Atlantic,Eastern,112,2,142,0.7887323943661971,89,23,81,31
2018-19,2019-03-16,Tampa Bay Lightning,2,Atlantic,Eastern,114,2,144,0.7916666666666666,91,23,84,30
2018-19,2019-03-18,Tampa Bay Lightning,2,Atlantic,Eastern,116,2,146,0.7945205479452054,91,25,84,32
2018-19,2019-03-20,Tampa Bay Lightning,2,Atlantic,Eastern,118,2,148,0.7972972972972973,93,25,84,34
2018-19,2019-03-21,Tampa Bay Lightning,2,Atlantic,Eastern,120,2,150,0.8,93,27,85,35
2018-19,2019-03-24,Tampa Bay Lightning,0,Atlantic,Eastern,120,2,152,0.7894736842105263,94,26,88,32
2018-19,2019-03-25,Tampa Bay Lightning,2,Atlantic,Eastern,122,2,154,0.7922077922077922,96,26,88,34
2018-19,2019-03-30,Tampa Bay Lightning,0,Atlantic,Eastern,122,2,156,0.782051282051282,97,25,92,30
2018-19,2019-04-01,Tampa Bay Lightning,2,Atlantic,Eastern,124,2,158,0.7848101265822784,99,25,92,32
2018-19,2019-04-02,Tampa Bay Lightning,0,Atlantic,Eastern,124,2,160,0.775,99,25,94,30
2018-19,2019-04-04,Tampa Bay Lightning,2,Atlantic,Eastern,126,2,162,0.7777777777777778,99,27,94,32
2018-19,2019-04-06,Tampa Bay Lightning,2,Atlantic,Eastern,128,2,164,0.7804878048780488,100,28,98,30
2018-19,2018-10-03,Toronto Maple Leafs,2,Atlantic,Eastern,2,2,2,1.0,0,2,0,2
2018-19,2018-10-06,Toronto Maple Leafs,0,Atlantic,Eastern,2,2,4,0.5,2,0,2,0
2018-19,2018-10-07,Toronto Maple Leafs,2,Atlantic,Eastern,4,2,6,0.6666666666666666,3,1,2,2
2018-19,2018-10-10,Toronto Maple Leafs,2,Atlantic,Eastern,6,2,8,0.75,4,2,3,3
2018-19,2018-10-11,Toronto Maple Leafs,2,Atlantic,Eastern,8,2,10,0.8,4,4,4,4
2018-19,2018-10-13,Toronto Maple Leafs,2,Atlantic,Eastern,10,2,12,0.8333333333333334,5,5,5,5
2018-19,2018-10-15,Toronto Maple Leafs,2,Atlantic,Eastern,12,2,14,0.8571428571428571,7,5,6,6
2018-19,2018-10-18,Toronto Maple Leafs,0,Atlantic,Eastern,12,2,16,0.75,8,4,8,4
2018-19,2018-10-20,Toronto Maple Leafs,0,Atlantic,Eastern,12,2,18,0.6666666666666666,9,3,8,4
2018-19,2018-10-24,Toronto Maple Leafs,2,Atlantic,Eastern,14,2,20,0.7,12,2,10,4
2018-19,2018-10-27,Toronto Maple Leafs,2,Atlantic,Eastern,16,2,22,0.7272727272727273,14,2,12,4
2018-19,2018-10-29,Toronto Maple Leafs,0,Atlantic,Eastern,16,2,24,0.6666666666666666,14,2,12,4
2018-19,2018-11-01,Toronto Maple Leafs,0,Atlantic,Eastern,16,2,26,0.6153846153846154,16,0,13,3
2018-19,2018-11-03,Toronto Maple Leafs,2,Atlantic,Eastern,18,2,28,0.6428571428571429,16,2,14,4
2018-19,2018-11-07,Toronto Maple Leafs,2,Atlantic,Eastern,20,2,30,0.6666666666666666,18,2,15,5
2018-19,2018-11-10,Toronto Maple Leafs,2,Atlantic,Eastern,22,2,32,0.6875,20,2,18,4
2018-19,2018-11-11,Toronto Maple Leafs,0,Atlantic,Eastern,22,2,34,0.6470588235294118,21,1,18,4
2018-19,2018-11-14,Toronto Maple Leafs,2,Atlantic,Eastern,24,2,36,0.6666666666666666,22,2,20,4
2018-19,2018-11-16,Toronto Maple Leafs,2,Atlantic,Eastern,26,2,38,0.6842105263157895,23,3,20,6
2018-19,2018-11-17,Toronto Maple Leafs,2,Atlantic,Eastern,28,2,40,0.7,24,4,21,7
2018-19,2018-11-20,Toronto Maple Leafs,2,Atlantic,Eastern,30,2,42,0.7142857142857143,28,2,23,7
2018-19,2018-11-22,Toronto Maple Leafs,0,Atlantic,Eastern,30,2,44,0.6818181818181818,30,0,25,5
2018-19,2018-11-24,Toronto Maple Leafs,0,Atlantic,Eastern,30,2,46,0.6521739130434783,30,0,26,4
2018-19,2018-11-25,Toronto Maple Leafs,2,Atlantic,Eastern,32,2,48,0.6666666666666666,32,0,26,6
2018-19,2018-11-27,Toronto Maple Leafs,2,Atlantic,Eastern,34,2,50,0.68,34,0,27,7
2018-19,2018-11-29,Toronto Maple Leafs,2,Atlantic,Eastern,36,2,52,0.6923076923076923,35,1,27,9
2018-19,2018-12-02,Toronto Maple Leafs,2,Atlantic,Eastern,38,2,54,0.7037037037037037,37,1,29,9
2018-19,2018-12-05,Toronto Maple Leafs,2,Atlantic,Eastern,40,2,56,0.7142857142857143,38,2,29,11
2018-19,2018-12-07,Toronto Maple Leafs,1,Atlantic,Eastern,41,2,58,0.7068965517241379,38,3,30,11
2018-19,2018-12-09,Toronto Maple Leafs,0,Atlantic,Eastern,41,2,60,0.6833333333333333,38,3,31,10
2018-19,2018-12-12,Toronto Maple Leafs,2,Atlantic,Eastern,43,2,62,0.6935483870967742,40,3,32,11
2018-19,2018-12-14,Toronto Maple Leafs,0,Atlantic,Eastern,43,2,64,0.671875,42,1,32,11
2018-19,2018-12-16,Toronto Maple Leafs,1,Atlantic,Eastern,44,2,66,0.6666666666666666,44,0,36,8
2018-19,2018-12-19,Toronto Maple Leafs,2,Atlantic,Eastern,46,2,68,0.6764705882352942,45,1,38,8
2018-19,2018-12-21,Toronto Maple Leafs,2,Atlantic,Eastern,48,2,70,0.6857142857142857,45,3,40,8
2018-19,2018-12-23,Toronto Maple Leafs,2,Atlantic,Eastern,50,2,72,0.6944444444444444,47,3,42,8
2018-19,2018-12-24,Toronto Maple Leafs,2,Atlantic,Eastern,52,2,74,0.7027027027027027,47,5,42,10
2018-19,2018-12-29,Toronto Maple Leafs,2,Atlantic,Eastern,54,2,76,0.7105263157894737,47,7,44,10
2018-19,2018-12-30,Toronto Maple Leafs,0,Atlantic,Eastern,54,2,78,0.6923076923076923,48,6,45,9
2018-19,2019-01-03,Toronto Maple Leafs,0,Atlantic,Eastern,54,2,80,0.675,48,6,47,7
2018-19,2019-01-06,Toronto Maple Leafs,2,Atlantic,Eastern,56,2,82,0.6829268292682927,52,4,50,6
2018-19,2019-01-08,Toronto Maple Leafs,0,Atlantic,Eastern,56,2,84,0.6666666666666666,52,4,50,6
2018-19,2019-01-11,Toronto Maple Leafs,2,Atlantic,Eastern,58,2,86,0.6744186046511628,54,4,52,6
2018-19,2019-01-13,Toronto Maple Leafs,0,Atlantic,Eastern,58,2,88,0.6590909090909091,56,2,52,6
2018-19,2019-01-15,Toronto Maple Leafs,0,Atlantic,Eastern,58,2,90,0.6444444444444445,57,1,54,4
2018-19,2019-01-18,Toronto Maple Leafs,2,Atlantic,Eastern,60,2,92,0.6521739130434783,59,1,56,4
2018-19,2019-01-19,Toronto Maple Leafs,0,Atlantic,Eastern,60,2,94,0.6382978723404256,59,1,58,2
2018-19,2019-01-21,Toronto Maple Leafs,0,Atlantic,Eastern,60,2,96,0.625,59,1,58,2
2018-19,2019-01-24,Toronto Maple Leafs,2,Atlantic,Eastern,62,2,98,0.6326530612244898,61,1,58,4
2018-19,2019-02-02,Toronto Maple Leafs,1,Atlantic,Eastern,63,2,100,0.63,62,1,59,4
2018-19,2019-02-03,Toronto Maple Leafs,2,Atlantic,Eastern,65,2,102,0.6372549019607843,64,1,59,6
2018-19,2019-02-05,Toronto Maple Leafs,2,Atlantic,Eastern,67,2,104,0.6442307692307693,64,3,59,8
2018-19,2019-02-07,Toronto Maple Leafs,2,Atlantic,Eastern,69,2,106,0.6509433962264151,66,3,61,8
2018-19,2019-02-10,Toronto Maple Leafs,2,Atlantic,Eastern,71,2,108,0.6574074074074074,70,1,63,8
2018-19,2019-02-11,Toronto Maple Leafs,0,Atlantic,Eastern,71,2,110,0.6454545454545455,70,1,63,8
2018-19,2019-02-13,Toronto Maple Leafs,2,Atlantic,Eastern,73,2,112,0.6517857142857143,72,1,65,8
2018-19,2019-02-15,Toronto Maple Leafs,2,Atlantic,Eastern,75,2,114,0.6578947368421053,72,3,67,8
2018-19,2019-02-17,Toronto Maple Leafs,0,Atlantic,Eastern,75,2,116,0.646551724137931,75,0,69,6
2018-19,2019-02-20,Toronto Maple Leafs,1,Atlantic,Eastern,76,2,118,0.6440677966101694,76,0,69,7
2018-19,2019-02-22,Toronto Maple Leafs,0,Atlantic,Eastern,76,2,120,0.6333333333333333,76,0,70,6
2018-19,2019-02-24,Toronto Maple Leafs,2,Atlantic,Eastern,78,2,122,0.639344262295082,78,0,72,6
2018-19,2019-02-26,Toronto Maple Leafs,2,Atlantic,Eastern,80,2,124,0.6451612903225806,80,0,72,8
2018-19,2019-02-28,Toronto Maple Leafs,2,Atlantic,Eastern,82,2,126,0.6507936507936508,82,0,74,8
2018-19,2019-03-01,Toronto Maple Leafs,0,Atlantic,Eastern,82,2,128,0.640625,82,0,74,8
2018-19,2019-03-03,Toronto Maple Leafs,2,Atlantic,Eastern,84,2,130,0.6461538461538462,84,0,77,7
2018-19,2019-03-05,Toronto Maple Leafs,2,Atlantic,Eastern,86,2,132,0.6515151515151515,86,0,77,9
2018-19,2019-03-07,Toronto Maple Leafs,1,Atlantic,Eastern,87,2,134,0.6492537313432836,87,0,79,8
2018-19,2019-03-10,Toronto Maple Leafs,2,Atlantic,Eastern,89,2,136,0.6544117647058824,89,0,79,10
2018-19,2019-03-11,Toronto Maple Leafs,0,Atlantic,Eastern,89,2,138,0.644927536231884,89,0,79,10
2018-19,2019-03-13,Toronto Maple Leafs,0,Atlantic,Eastern,89,2,140,0.6357142857142857,89,0,81,8
2018-19,2019-03-15,Toronto Maple Leafs,2,Atlantic,Eastern,91,2,142,0.6408450704225352,91,0,83,8
2018-19,2019-03-16,Toronto Maple Leafs,0,Atlantic,Eastern,91,2,144,0.6319444444444444,91,0,84,7
2018-19,2019-03-20,Toronto Maple Leafs,0,Atlantic,Eastern,91,2,146,0.6232876712328768,93,-2,84,7
2018-19,2019-03-20,Toronto Maple Leafs,2,Atlantic,Eastern,93,2,148,0.6283783783783784,93,0,84,9
2018-19,2019-03-23,Toronto Maple Leafs,1,Atlantic,Eastern,94,2,150,0.6266666666666667,94,0,87,7
2018-19,2019-03-25,Toronto Maple Leafs,2,Atlantic,Eastern,96,2,152,0.631578947368421,96,0,88,8
2018-19,2019-03-27,Toronto Maple Leafs,1,Atlantic,Eastern,97,2,154,0.6298701298701299,97,0,90,7
2018-19,2019-03-30,Toronto Maple Leafs,0,Atlantic,Eastern,97,2,156,0.6217948717948718,97,0,92,5
2018-19,2019-04-01,Toronto Maple Leafs,2,Atlantic,Eastern,99,2,158,0.6265822784810127,99,0,92,7
2018-19,2019-04-02,Toronto Maple Leafs,0,Atlantic,Eastern,99,2,160,0.61875,99,0,94,5
2018-19,2019-04-04,Toronto Maple Leafs,0,Atlantic,Eastern,99,2,162,0.6111111111111112,99,0,94,5
2018-19,2019-04-06,Toronto Maple Leafs,1,Atlantic,Eastern,100,2,164,0.6097560975609756,100,0,98,2
2018-19,2018-10-04,Vancouver Canucks,2,Pacific,Western,2,2,2,1.0,0,2,0,2
2018-19,2018-10-07,Vancouver Canucks,0,Pacific,Western,2,2,4,0.5,2,0,2,0
2018-19,2018-10-09,Vancouver Canucks,0,Pacific,Western,2,2,6,0.3333333333333333,3,-1,2,0
2018-19,2018-10-11,Vancouver Canucks,2,Pacific,Western,4,2,8,0.5,5,-1,4,0
2018-19,2018-10-13,Vancouver Canucks,2,Pacific,Western,6,2,10,0.6,5,1,4,2
2018-19,2018-10-16,Vancouver Canucks,2,Pacific,Western,8,2,12,0.6666666666666666,6,2,6,2
2018-19,2018-10-19,Vancouver Canucks,0,Pacific,Western,8,2,14,0.5714285714285714,8,0,7,1
2018-19,2018-10-21,Vancouver Canucks,2,Pacific,Western,10,2,16,0.625,10,0,10,0
2018-19,2018-10-23,Vancouver Canucks,0,Pacific,Western,10,2,18,0.5555555555555556,10,0,10,0
2018-19,2018-10-25,Vancouver Canucks,2,Pacific,Western,12,2,20,0.6,11,1,10,2
2018-19,2018-10-26,Vancouver Canucks,0,Pacific,Western,12,2,22,0.5454545454545454,11,1,11,1
2018-19,2018-10-28,Vancouver Canucks,0,Pacific,Western,12,2,24,0.5,12,0,12,0
2018-19,2018-10-30,Vancouver Canucks,2,Pacific,Western,14,2,26,0.5384615384615384,14,0,14,0
2018-19,2018-11-01,Vancouver Canucks,2,Pacific,Western,16,2,28,0.5714285714285714,15,1,15,1
2018-19,2018-11-03,Vancouver Canucks,2,Pacific,Western,18,2,30,0.6,17,1,16,2
2018-19,2018-11-07,Vancouver Canucks,1,Pacific,Western,19,2,32,0.59375,19,0,17,2
2018-19,2018-11-09,Vancouver Canucks,2,Pacific,Western,21,2,34,0.6176470588235294,19,2,17,4
2018-19,2018-11-10,Vancouver Canucks,1,Pacific,Western,22,2,36,0.6111111111111112,19,3,17,5
2018-19,2018-11-13,Vancouver Canucks,0,Pacific,Western,22,2,38,0.5789473684210527,21,1,19,3
2018-19,2018-11-14,Vancouver Canucks,0,Pacific,Western,22,2,40,0.55,21,1,19,3
2018-19,2018-11-16,Vancouver Canucks,0,Pacific,Western,22,2,42,0.5238095238095238,21,1,20,2
2018-19,2018-11-18,Vancouver Canucks,0,Pacific,Western,22,2,44,0.5,22,0,22,0
2018-19,2018-11-20,Vancouver Canucks,0,Pacific,Western,22,2,46,0.4782608695652174,22,0,22,0
2018-19,2018-11-22,Vancouver Canucks,0,Pacific,Western,22,2,48,0.4583333333333333,23,-1,23,-1
2018-19,2018-11-24,Vancouver Canucks,0,Pacific,Western,22,2,50,0.44,25,-3,25,-3
2018-19,2018-11-25,Vancouver Canucks,2,Pacific,Western,24,2,52,0.46153846153846156,25,-1,25,-1
2018-19,2018-11-28,Vancouver Canucks,1,Pacific,Western,25,2,54,0.46296296296296297,27,-2,27,-2
2018-19,2018-11-30,Vancouver Canucks,0,Pacific,Western,25,2,56,0.44642857142857145,29,-4,29,-4
2018-19,2018-12-01,Vancouver Canucks,0,Pacific,Western,25,2,58,0.43103448275862066,29,-4,29,-4
2018-19,2018-12-05,Vancouver Canucks,0,Pacific,Western,25,2,60,0.4166666666666667,31,-6,31,-6
2018-19,2018-12-07,Vancouver Canucks,2,Pacific,Western,27,2,62,0.43548387096774194,33,-6,33,-6
2018-19,2018-12-09,Vancouver Canucks,2,Pacific,Western,29,2,64,0.453125,35,-6,33,-4
2018-19,2018-12-12,Vancouver Canucks,2,Pacific,Western,31,2,66,0.4696969696969697,37,-6,35,-4
2018-19,2018-12-14,Vancouver Canucks,1,Pacific,Western,32,2,68,0.47058823529411764,39,-7,37,-5
2018-19,2018-12-16,Vancouver Canucks,2,Pacific,Western,34,2,70,0.4857142857142857,40,-6,39,-5
2018-19,2018-12-17,Vancouver Canucks,2,Pacific,Western,36,2,72,0.5,41,-5,39,-3
2018-19,2018-12-19,Vancouver Canucks,0,Pacific,Western,36,2,74,0.4864864864864865,43,-7,39,-3
2018-19,2018-12-21,Vancouver Canucks,2,Pacific,Western,38,2,76,0.5,43,-5,39,-1
2018-19,2018-12-23,Vancouver Canucks,0,Pacific,Western,38,2,78,0.48717948717948717,43,-5,39,-1
2018-19,2018-12-28,Vancouver Canucks,2,Pacific,Western,40,2,80,0.5,46,-6,41,-1
2018-19,2018-12-30,Vancouver Canucks,2,Pacific,Western,42,2,82,0.5121951219512195,48,-6,43,-1
2018-19,2018-12-31,Vancouver Canucks,0,Pacific,Western,42,2,84,0.5,49,-7,43,-1
2018-19,2019-01-03,Vancouver Canucks,2,Pacific,Western,44,2,86,0.5116279069767442,51,-7,45,-1
2018-19,2019-01-04,Vancouver Canucks,0,Pacific,Western,44,2,88,0.5,51,-7,45,-1
2018-19,2019-01-06,Vancouver Canucks,0,Pacific,Western,44,2,90,0.4888888888888889,53,-9,45,-1
2018-19,2019-01-11,Vancouver Canucks,1,Pacific,Western,45,2,92,0.4891304347826087,58,-13,47,-2
2018-19,2019-01-14,Vancouver Canucks,2,Pacific,Western,47,2,94,0.5,60,-13,47,0
2018-19,2019-01-17,Vancouver Canucks,1,Pacific,Western,48,2,96,0.5,60,-12,49,-1
2018-19,2019-01-19,Vancouver Canucks,2,Pacific,Western,50,2,98,0.5102040816326531,60,-10,50,0
2018-19,2019-01-20,Vancouver Canucks,2,Pacific,Western,52,2,100,0.52,62,-10,52,0
2018-19,2019-01-24,Vancouver Canucks,0,Pacific,Western,52,2,102,0.5098039215686274,62,-10,52,0
2018-19,2019-02-03,Vancouver Canucks,2,Pacific,Western,54,2,104,0.5192307692307693,62,-8,54,0
2018-19,2019-02-05,Vancouver Canucks,0,Pacific,Western,54,2,106,0.5094339622641509,62,-8,54,0
2018-19,2019-02-06,Vancouver Canucks,0,Pacific,Western,54,2,108,0.5,64,-10,54,0
2018-19,2019-02-08,Vancouver Canucks,1,Pacific,Western,55,2,110,0.5,66,-11,55,0
2018-19,2019-02-10,Vancouver Canucks,2,Pacific,Western,57,2,112,0.5089285714285714,66,-9,59,-2
2018-19,2019-02-12,Vancouver Canucks,0,Pacific,Western,57,2,114,0.5,66,-9,59,-2
2018-19,2019-02-14,Vancouver Canucks,0,Pacific,Western,57,2,116,0.49137931034482757,66,-9,59,-2
2018-19,2019-02-15,Vancouver Canucks,2,Pacific,Western,59,2,118,0.5,66,-7,59,0
2018-19,2019-02-17,Vancouver Canucks,0,Pacific,Western,59,2,120,0.49166666666666664,68,-9,60,-1
2018-19,2019-02-22,Vancouver Canucks,1,Pacific,Western,60,2,122,0.4918032786885246,69,-9,62,-2
2018-19,2019-02-24,Vancouver Canucks,0,Pacific,Western,60,2,124,0.4838709677419355,69,-9,65,-5
2018-19,2019-02-26,Vancouver Canucks,2,Pacific,Western,62,2,126,0.49206349206349204,69,-7,66,-4
2018-19,2019-02-28,Vancouver Canucks,1,Pacific,Western,63,2,128,0.4921875,71,-8,68,-5
2018-19,2019-03-01,Vancouver Canucks,0,Pacific,Western,63,2,130,0.4846153846153846,73,-10,68,-5
2018-19,2019-03-03,Vancouver Canucks,0,Pacific,Western,63,2,132,0.4772727272727273,77,-14,70,-7
2018-19,2019-03-07,Vancouver Canucks,2,Pacific,Western,65,2,134,0.48507462686567165,79,-14,72,-7
2018-19,2019-03-08,Vancouver Canucks,0,Pacific,Western,65,2,136,0.47794117647058826,79,-14,74,-9
2018-19,2019-03-10,Vancouver Canucks,0,Pacific,Western,65,2,138,0.47101449275362317,81,-16,74,-9
2018-19,2019-03-14,Vancouver Canucks,2,Pacific,Western,67,2,140,0.4785714285714286,81,-14,75,-8
2018-19,2019-03-16,Vancouver Canucks,1,Pacific,Western,68,2,142,0.4788732394366197,83,-15,77,-9
2018-19,2019-03-17,Vancouver Canucks,2,Pacific,Western,70,2,144,0.4861111111111111,83,-13,78,-8
2018-19,2019-03-19,Vancouver Canucks,2,Pacific,Western,72,2,146,0.4931506849315068,87,-15,78,-6
2018-19,2019-03-21,Vancouver Canucks,2,Pacific,Western,74,2,148,0.5,87,-13,78,-4
2018-19,2019-03-24,Vancouver Canucks,0,Pacific,Western,74,2,150,0.49333333333333335,90,-16,80,-6
2018-19,2019-03-25,Vancouver Canucks,0,Pacific,Western,74,2,152,0.4868421052631579,90,-16,81,-7
2018-19,2019-03-27,Vancouver Canucks,0,Pacific,Western,74,2,154,0.4805194805194805,90,-16,81,-7
2018-19,2019-03-29,Vancouver Canucks,2,Pacific,Western,76,2,156,0.48717948717948717,90,-14,83,-7
2018-19,2019-03-31,Vancouver Canucks,2,Pacific,Western,78,2,158,0.4936708860759494,91,-13,85,-7
2018-19,2019-04-03,Vancouver Canucks,2,Pacific,Western,80,2,160,0.5,93,-13,88,-8
2018-19,2019-04-05,Vancouver Canucks,0,Pacific,Western,80,2,162,0.49382716049382713,93,-13,90,-10
2018-19,2019-04-06,Vancouver Canucks,1,Pacific,Western,81,2,164,0.49390243902439024,93,-12,90,-9
2018-19,2018-10-05,Vegas Golden Knights,0,Pacific,Western,0,2,2,0.0,0,0,0,0
2018-19,2018-10-07,Vegas Golden Knights,2,Pacific,Western,2,2,4,0.5,2,0,2,0
2018-19,2018-10-08,Vegas Golden Knights,0,Pacific,Western,2,2,6,0.3333333333333333,2,0,2,0
2018-19,2018-10-11,Vegas Golden Knights,0,Pacific,Western,2,2,8,0.25,5,-3,4,-2
2018-19,2018-10-11,Vegas Golden Knights,0,Pacific,Western,2,2,10,0.2,5,-3,4,-2
2018-19,2018-10-13,Vegas Golden Knights,2,Pacific,Western,4,2,12,0.3333333333333333,5,-1,4,0
2018-19,2018-10-17,Vegas Golden Knights,2,Pacific,Western,6,2,14,0.42857142857142855,6,0,6,0
2018-19,2018-10-21,Vegas Golden Knights,2,Pacific,Western,8,2,16,0.5,10,-2,10,-2
2018-19,2018-10-25,Vegas Golden Knights,1,Pacific,Western,9,2,18,0.5,11,-2,10,-1
2018-19,2018-10-26,Vegas Golden Knights,0,Pacific,Western,9,2,20,0.45,11,-2,11,-2
2018-19,2018-10-29,Vegas Golden Knights,2,Pacific,Western,11,2,22,0.5,13,-2,13,-2
2018-19,2018-10-31,Vegas Golden Knights,0,Pacific,Western,11,2,24,0.4583333333333333,14,-3,14,-3
2018-19,2018-11-02,Vegas Golden Knights,0,Pacific,Western,11,2,26,0.4230769230769231,15,-4,15,-4
2018-19,2018-11-04,Vegas Golden Knights,2,Pacific,Western,13,2,28,0.4642857142857143,17,-4,17,-4
2018-19,2018-11-07,Vegas Golden Knights,0,Pacific,Western,13,2,30,0.43333333333333335,19,-6,17,-4
2018-19,2018-11-09,Vegas Golden Knights,2,Pacific,Western,15,2,32,0.46875,19,-4,17,-2
2018-19,2018-11-11,Vegas Golden Knights,0,Pacific,Western,15,2,34,0.4411764705882353,19,-4,17,-2
2018-19,2018-11-12,Vegas Golden Knights,0,Pacific,Western,15,2,36,0.4166666666666667,21,-6,19,-4
2018-19,2018-11-15,Vegas Golden Knights,2,Pacific,Western,17,2,38,0.4473684210526316,21,-4,20,-3
2018-19,2018-11-17,Vegas Golden Knights,0,Pacific,Western,17,2,40,0.425,21,-4,21,-4
2018-19,2018-11-19,Vegas Golden Knights,2,Pacific,Western,19,2,42,0.4523809523809524,22,-3,22,-3
2018-19,2018-11-20,Vegas Golden Knights,0,Pacific,Western,19,2,44,0.4318181818181818,22,-3,22,-3
2018-19,2018-11-22,Vegas Golden Knights,2,Pacific,Western,21,2,46,0.45652173913043476,23,-2,23,-2
2018-19,2018-11-23,Vegas Golden Knights,2,Pacific,Western,23,2,48,0.4791666666666667,25,-2,24,-1
2018-19,2018-11-25,Vegas Golden Knights,2,Pacific,Western,25,2,50,0.5,25,0,25,0
2018-19,2018-11-28,Vegas Golden Knights,2,Pacific,Western,27,2,52,0.5192307692307693,27,0,27,0
2018-19,2018-11-30,Vegas Golden Knights,2,Pacific,Western,29,2,54,0.5370370370370371,29,0,29,0
2018-19,2018-12-02,Vegas Golden Knights,0,Pacific,Western,29,2,56,0.5178571428571429,29,0,29,0
2018-19,2018-12-05,Vegas Golden Knights,2,Pacific,Western,31,2,58,0.5344827586206896,31,0,31,0
2018-19,2018-12-07,Vegas Golden Knights,2,Pacific,Western,33,2,60,0.55,33,0,33,0
2018-19,2018-12-08,Vegas Golden Knights,0,Pacific,Western,33,2,62,0.532258064516129,33,0,33,0
2018-19,2018-12-10,Vegas Golden Knights,2,Pacific,Western,35,2,64,0.546875,35,0,35,0
2018-19,2018-12-13,Vegas Golden Knights,2,Pacific,Western,37,2,66,0.5606060606060606,37,0,36,1
2018-19,2018-12-15,Vegas Golden Knights,1,Pacific,Western,38,2,68,0.5588235294117647,39,-1,38,0
2018-19,2018-12-16,Vegas Golden Knights,2,Pacific,Western,40,2,70,0.5714285714285714,40,0,39,1
2018-19,2018-12-18,Vegas Golden Knights,0,Pacific,Western,40,2,72,0.5555555555555556,41,-1,39,1
2018-19,2018-12-21,Vegas Golden Knights,2,Pacific,Western,42,2,74,0.5675675675675675,43,-1,39,3
2018-19,2018-12-22,Vegas Golden Knights,1,Pacific,Western,43,2,76,0.5657894736842105,43,0,39,4
2018-19,2018-12-24,Vegas Golden Knights,1,Pacific,Western,44,2,78,0.5641025641025641,44,0,39,5
2018-19,2018-12-28,Vegas Golden Knights,2,Pacific,Western,46,2,80,0.575,46,0,41,5
2018-19,2018-12-29,Vegas Golden Knights,2,Pacific,Western,48,2,82,0.5853658536585366,48,0,41,7
2018-19,2018-12-31,Vegas Golden Knights,2,Pacific,Western,50,2,84,0.5952380952380952,49,1,43,7
2018-19,2019-01-02,Vegas Golden Knights,2,Pacific,Western,52,2,86,0.6046511627906976,49,3,44,8
2018-19,2019-01-05,Vegas Golden Knights,2,Pacific,Western,54,2,88,0.6136363636363636,51,3,45,9
2018-19,2019-01-06,Vegas Golden Knights,2,Pacific,Western,56,2,90,0.6222222222222222,53,3,45,11
2018-19,2019-01-09,Vegas Golden Knights,2,Pacific,Western,58,2,92,0.6304347826086957,57,1,45,13
2018-19,2019-01-11,Vegas Golden Knights,0,Pacific,Western,58,2,94,0.6170212765957447,58,0,47,11
2018-19,2019-01-13,Vegas Golden Knights,2,Pacific,Western,60,2,96,0.625,60,0,47,13
2018-19,2019-01-16,Vegas Golden Knights,0,Pacific,Western,60,2,98,0.6122448979591837,60,0,49,11
2018-19,2019-01-20,Vegas Golden Knights,2,Pacific,Western,62,2,100,0.62,62,0,52,10
2018-19,2019-01-21,Vegas Golden Knights,0,Pacific,Western,62,2,102,0.6078431372549019,62,0,52,10
2018-19,2019-01-24,Vegas Golden Knights,0,Pacific,Western,62,2,104,0.5961538461538461,62,0,52,10
2018-19,2019-02-02,Vegas Golden Knights,0,Pacific,Western,62,2,106,0.5849056603773585,62,0,52,10
2018-19,2019-02-03,Vegas Golden Knights,0,Pacific,Western,62,2,108,0.5740740740740741,62,0,54,8
2018-19,2019-02-06,Vegas Golden Knights,2,Pacific,Western,64,2,110,0.5818181818181818,64,0,54,10
2018-19,2019-02-08,Vegas Golden Knights,2,Pacific,Western,66,2,112,0.5892857142857143,66,0,55,11
2018-19,2019-02-10,Vegas Golden Knights,0,Pacific,Western,66,2,114,0.5789473684210527,66,0,59,7
2018-19,2019-02-13,Vegas Golden Knights,0,Pacific,Western,66,2,116,0.5689655172413793,66,0,59,7
2018-19,2019-02-15,Vegas Golden Knights,0,Pacific,Western,66,2,118,0.559322033898305,66,0,59,7
2018-19,2019-02-17,Vegas Golden Knights,2,Pacific,Western,68,2,120,0.5666666666666667,68,0,60,8
2018-19,2019-02-19,Vegas Golden Knights,0,Pacific,Western,68,2,122,0.5573770491803278,68,0,60,8
2018-19,2019-02-21,Vegas Golden Knights,1,Pacific,Western,69,2,124,0.5564516129032258,69,0,61,8
2018-19,2019-02-23,Vegas Golden Knights,0,Pacific,Western,69,2,126,0.5476190476190477,69,0,64,5
2018-19,2019-02-27,Vegas Golden Knights,2,Pacific,Western,71,2,128,0.5546875,71,0,67,4
2018-19,2019-03-01,Vegas Golden Knights,2,Pacific,Western,73,2,130,0.5615384615384615,73,0,68,5
2018-19,2019-03-02,Vegas Golden Knights,2,Pacific,Western,75,2,132,0.5681818181818182,75,0,68,7
2018-19,2019-03-03,Vegas Golden Knights,2,Pacific,Western,77,2,134,0.5746268656716418,77,0,70,7
2018-19,2019-03-07,Vegas Golden Knights,2,Pacific,Western,79,2,136,0.5808823529411765,79,0,72,7
2018-19,2019-03-10,Vegas Golden Knights,2,Pacific,Western,81,2,138,0.5869565217391305,81,0,74,7
2018-19,2019-03-11,Vegas Golden Knights,0,Pacific,Western,81,2,140,0.5785714285714286,81,0,74,7
2018-19,2019-03-16,Vegas Golden Knights,2,Pacific,Western,83,2,142,0.5845070422535211,83,0,77,6
2018-19,2019-03-18,Vegas Golden Knights,2,Pacific,Western,85,2,144,0.5902777777777778,85,0,78,7
2018-19,2019-03-19,Vegas Golden Knights,2,Pacific,Western,87,2,146,0.5958904109589042,87,0,78,9
2018-19,2019-03-22,Vegas Golden Knights,2,Pacific,Western,89,2,148,0.6013513513513513,89,0,79,10
2018-19,2019-03-24,Vegas Golden Knights,1,Pacific,Western,90,2,150,0.6,90,0,80,10
2018-19,2019-03-26,Vegas Golden Knights,0,Pacific,Western,90,2,152,0.5921052631578947,90,0,81,9
2018-19,2019-03-28,Vegas Golden Knights,0,Pacific,Western,90,2,154,0.5844155844155844,90,0,83,7
2018-19,2019-03-30,Vegas Golden Knights,0,Pacific,Western,90,2,156,0.5769230769230769,90,0,85,5
2018-19,2019-03-31,Vegas Golden Knights,1,Pacific,Western,91,2,158,0.5759493670886076,91,0,85,6
2018-19,2019-04-02,Vegas Golden Knights,2,Pacific,Western,93,2,160,0.58125,93,0,86,7
2018-19,2019-04-05,Vegas Golden Knights,0,Pacific,Western,93,2,162,0.5740740740740741,93,0,90,3
2018-19,2019-04-07,Vegas Golden Knights,0,Pacific,Western,93,2,164,0.5670731707317073,93,0,90,3
2018-19,2018-10-03,Washington Capitals,2,Metropolitan,Eastern,2,2,2,1.0,0,2,0,2
2018-19,2018-10-04,Washington Capitals,1,Metropolitan,Eastern,3,2,4,0.75,2,1,1,2
2018-19,2018-10-11,Washington Capitals,2,Metropolitan,Eastern,5,2,6,0.8333333333333334,5,0,4,1
2018-19,2018-10-11,Washington Capitals,0,Metropolitan,Eastern,5,2,8,0.625,5,0,4,1
2018-19,2018-10-13,Washington Capitals,0,Metropolitan,Eastern,5,2,10,0.5,5,0,5,0
2018-19,2018-10-17,Washington Capitals,2,Metropolitan,Eastern,7,2,12,0.5833333333333334,7,0,6,1
2018-19,2018-10-19,Washington Capitals,1,Metropolitan,Eastern,8,2,14,0.5714285714285714,8,0,8,0
2018-19,2018-10-23,Washington Capitals,2,Metropolitan,Eastern,10,2,16,0.625,8,2,9,1
2018-19,2018-10-26,Washington Capitals,0,Metropolitan,Eastern,10,2,18,0.5555555555555556,10,0,10,0
2018-19,2018-10-27,Washington Capitals,2,Metropolitan,Eastern,12,2,20,0.6,12,0,12,0
2018-19,2018-11-01,Washington Capitals,0,Metropolitan,Eastern,12,2,22,0.5454545454545454,13,-1,13,-1
2018-19,2018-11-03,Washington Capitals,1,Metropolitan,Eastern,13,2,24,0.5416666666666666,14,-1,14,-1
2018-19,2018-11-06,Washington Capitals,2,Metropolitan,Eastern,15,2,26,0.5769230769230769,15,0,15,0
2018-19,2018-11-08,Washington Capitals,2,Metropolitan,Eastern,17,2,28,0.6071428571428571,17,0,16,1
2018-19,2018-11-10,Washington Capitals,0,Metropolitan,Eastern,17,2,30,0.5666666666666667,18,-1,18,-1
2018-19,2018-11-11,Washington Capitals,0,Metropolitan,Eastern,17,2,32,0.53125,18,-1,18,-1
2018-19,2018-11-14,Washington Capitals,2,Metropolitan,Eastern,19,2,34,0.5588235294117647,20,-1,20,-1
2018-19,2018-11-15,Washington Capitals,0,Metropolitan,Eastern,19,2,36,0.5277777777777778,20,-1,20,-1
2018-19,2018-11-17,Washington Capitals,2,Metropolitan,Eastern,21,2,38,0.5526315789473685,21,0,21,0
2018-19,2018-11-20,Washington Capitals,2,Metropolitan,Eastern,23,2,40,0.575,23,0,23,0
2018-19,2018-11-22,Washington Capitals,2,Metropolitan,Eastern,25,2,42,0.5952380952380952,25,0,25,0
2018-19,2018-11-23,Washington Capitals,2,Metropolitan,Eastern,27,2,44,0.6136363636363636,26,1,26,1
2018-19,2018-11-24,Washington Capitals,2,Metropolitan,Eastern,29,2,46,0.6304347826086957,26,3,26,3
2018-19,2018-11-27,Washington Capitals,2,Metropolitan,Eastern,31,2,48,0.6458333333333334,28,3,27,4
2018-19,2018-12-01,Washington Capitals,2,Metropolitan,Eastern,33,2,50,0.66,28,5,28,5
2018-19,2018-12-02,Washington Capitals,0,Metropolitan,Eastern,33,2,52,0.6346153846153846,29,4,29,4
2018-19,2018-12-05,Washington Capitals,0,Metropolitan,Eastern,33,2,54,0.6111111111111112,29,4,29,4
2018-19,2018-12-07,Washington Capitals,2,Metropolitan,Eastern,35,2,56,0.625,29,6,30,5
2018-19,2018-12-09,Washington Capitals,2,Metropolitan,Eastern,37,2,58,0.6379310344827587,31,6,31,6
2018-19,2018-12-12,Washington Capitals,2,Metropolitan,Eastern,39,2,60,0.65,32,7,32,7
2018-19,2018-12-15,Washington Capitals,2,Metropolitan,Eastern,41,2,62,0.6612903225806451,34,7,34,7
2018-19,2018-12-16,Washington Capitals,2,Metropolitan,Eastern,43,2,64,0.671875,36,7,36,7
2018-19,2018-12-20,Washington Capitals,0,Metropolitan,Eastern,43,2,66,0.6515151515151515,38,5,38,5
2018-19,2018-12-22,Washington Capitals,2,Metropolitan,Eastern,45,2,68,0.6617647058823529,40,5,40,5
2018-19,2018-12-23,Washington Capitals,2,Metropolitan,Eastern,47,2,70,0.6714285714285714,42,5,42,5
2018-19,2018-12-28,Washington Capitals,2,Metropolitan,Eastern,49,2,72,0.6805555555555556,44,5,43,6
2018-19,2018-12-30,Washington Capitals,2,Metropolitan,Eastern,51,2,74,0.6891891891891891,46,5,45,6
2018-19,2018-12-31,Washington Capitals,0,Metropolitan,Eastern,51,2,76,0.6710526315789473,47,4,46,5
2018-19,2019-01-04,Washington Capitals,0,Metropolitan,Eastern,51,2,78,0.6538461538461539,49,2,49,2
2018-19,2019-01-05,Washington Capitals,1,Metropolitan,Eastern,52,2,80,0.65,49,3,49,3
2018-19,2019-01-06,Washington Capitals,2,Metropolitan,Eastern,54,2,82,0.6585365853658537,51,3,50,4
2018-19,2019-01-09,Washington Capitals,2,Metropolitan,Eastern,56,2,84,0.6666666666666666,51,5,51,5
2018-19,2019-01-11,Washington Capitals,2,Metropolitan,Eastern,58,2,86,0.6744186046511628,53,5,52,6
2018-19,2019-01-13,Washington Capitals,1,Metropolitan,Eastern,59,2,88,0.6704545454545454,55,4,52,7
2018-19,2019-01-15,Washington Capitals,0,Metropolitan,Eastern,59,2,90,0.6555555555555556,56,3,54,5
2018-19,2019-01-16,Washington Capitals,0,Metropolitan,Eastern,59,2,92,0.6413043478260869,56,3,56,3
2018-19,2019-01-19,Washington Capitals,0,Metropolitan,Eastern,59,2,94,0.6276595744680851,59,0,58,1
2018-19,2019-01-20,Washington Capitals,0,Metropolitan,Eastern,59,2,96,0.6145833333333334,59,0,58,1
2018-19,2019-01-23,Washington Capitals,1,Metropolitan,Eastern,60,2,98,0.6122448979591837,59,1,58,2
2018-19,2019-01-24,Washington Capitals,0,Metropolitan,Eastern,60,2,100,0.6,59,1,58,2
2018-19,2019-02-02,Washington Capitals,2,Metropolitan,Eastern,62,2,102,0.6078431372549019,62,0,59,3
2018-19,2019-02-03,Washington Capitals,0,Metropolitan,Eastern,62,2,104,0.5961538461538461,62,0,59,3
2018-19,2019-02-06,Washington Capitals,2,Metropolitan,Eastern,64,2,106,0.6037735849056604,62,2,61,3
2018-19,2019-02-08,Washington Capitals,2,Metropolitan,Eastern,66,2,108,0.6111111111111112,63,3,63,3
2018-19,2019-02-10,Washington Capitals,1,Metropolitan,Eastern,67,2,110,0.6090909090909091,65,2,63,4
2018-19,2019-02-12,Washington Capitals,2,Metropolitan,Eastern,69,2,112,0.6160714285714286,65,4,65,4
2018-19,2019-02-13,Washington Capitals,0,Metropolitan,Eastern,69,2,114,0.6052631578947368,67,2,65,4
2018-19,2019-02-15,Washington Capitals,2,Metropolitan,Eastern,71,2,116,0.6120689655172413,67,4,67,4
2018-19,2019-02-18,Washington Capitals,0,Metropolitan,Eastern,71,2,118,0.6016949152542372,69,2,69,2
2018-19,2019-02-19,Washington Capitals,2,Metropolitan,Eastern,73,2,120,0.6083333333333333,69,4,69,4
2018-19,2019-02-22,Washington Capitals,2,Metropolitan,Eastern,75,2,122,0.6147540983606558,71,4,70,5
2018-19,2019-02-23,Washington Capitals,0,Metropolitan,Eastern,75,2,124,0.6048387096774194,72,3,71,4
2018-19,2019-02-24,Washington Capitals,2,Metropolitan,Eastern,77,2,126,0.6111111111111112,73,4,72,5
2018-19,2019-02-27,Washington Capitals,2,Metropolitan,Eastern,79,2,128,0.6171875,74,5,74,5
2018-19,2019-03-02,Washington Capitals,2,Metropolitan,Eastern,81,2,130,0.6230769230769231,76,5,75,6
2018-19,2019-03-03,Washington Capitals,2,Metropolitan,Eastern,83,2,132,0.6287878787878788,78,5,77,6
2018-19,2019-03-07,Washington Capitals,2,Metropolitan,Eastern,85,2,134,0.6343283582089553,79,6,79,6
2018-19,2019-03-09,Washington Capitals,2,Metropolitan,Eastern,87,2,136,0.6397058823529411,81,6,79,8
2018-19,2019-03-10,Washington Capitals,2,Metropolitan,Eastern,89,2,138,0.644927536231884,81,8,79,10
2018-19,2019-03-12,Washington Capitals,0,Metropolitan,Eastern,89,2,140,0.6357142857142857,85,4,81,8
2018-19,2019-03-14,Washington Capitals,2,Metropolitan,Eastern,91,2,142,0.6408450704225352,87,4,81,10
2018-19,2019-03-16,Washington Capitals,0,Metropolitan,Eastern,91,2,144,0.6319444444444444,87,4,84,7
2018-19,2019-03-19,Washington Capitals,2,Metropolitan,Eastern,93,2,146,0.636986301369863,89,4,84,9
2018-19,2019-03-20,Washington Capitals,1,Metropolitan,Eastern,94,2,148,0.6351351351351351,89,5,84,10
2018-19,2019-03-22,Washington Capitals,0,Metropolitan,Eastern,94,2,150,0.6266666666666667,91,3,85,9
2018-19,2019-03-24,Washington Capitals,2,Metropolitan,Eastern,96,2,152,0.631578947368421,93,3,88,8
2018-19,2019-03-26,Washington Capitals,2,Metropolitan,Eastern,98,2,154,0.6363636363636364,95,3,90,8
2018-19,2019-03-28,Washington Capitals,2,Metropolitan,Eastern,100,2,156,0.6410256410256411,95,5,90,10
2018-19,2019-03-30,Washington Capitals,2,Metropolitan,Eastern,102,2,158,0.6455696202531646,95,7,92,10
2018-19,2019-04-01,Washington Capitals,0,Metropolitan,Eastern,102,2,160,0.6375,97,5,92,10
2018-19,2019-04-04,Washington Capitals,2,Metropolitan,Eastern,104,2,162,0.6419753086419753,99,5,94,10
2018-19,2019-04-06,Washington Capitals,0,Metropolitan,Eastern,104,2,164,0.6341463414634146,100,4,98,6
2018-19,2018-10-05,Winnipeg Jets,2,Central,Western,2,2,2,1.0,2,0,0,2
2018-19,2018-10-06,Winnipeg Jets,0,Central,Western,2,2,4,0.5,2,0,2,0
2018-19,2018-10-10,Winnipeg Jets,2,Central,Western,4,2,6,0.6666666666666666,4,0,4,0
2018-19,2018-10-12,Winnipeg Jets,0,Central,Western,4,2,8,0.5,6,-2,4,0
2018-19,2018-10-14,Winnipeg Jets,2,Central,Western,6,2,10,0.6,7,-1,6,0
2018-19,2018-10-17,Winnipeg Jets,1,Central,Western,7,2,12,0.5833333333333334,8,-1,6,1
2018-19,2018-10-19,Winnipeg Jets,2,Central,Western,9,2,14,0.6428571428571429,9,0,7,2
2018-19,2018-10-20,Winnipeg Jets,2,Central,Western,11,2,16,0.6875,11,0,8,3
2018-19,2018-10-23,Winnipeg Jets,2,Central,Western,13,2,18,0.7222222222222222,13,0,10,3
2018-19,2018-10-24,Winnipeg Jets,0,Central,Western,13,2,20,0.65,13,0,10,3
2018-19,2018-10-26,Winnipeg Jets,2,Central,Western,15,2,22,0.6818181818181818,14,1,11,4
2018-19,2018-10-27,Winnipeg Jets,0,Central,Western,15,2,24,0.625,15,0,11,4
2018-19,2018-11-02,Winnipeg Jets,2,Central,Western,17,2,26,0.6538461538461539,16,1,15,2
2018-19,2018-11-03,Winnipeg Jets,0,Central,Western,17,2,28,0.6071428571428571,17,0,16,1
2018-19,2018-11-10,Winnipeg Jets,2,Central,Western,19,2,30,0.6333333333333333,20,-1,17,2
2018-19,2018-11-12,Winnipeg Jets,2,Central,Western,21,2,32,0.65625,21,0,19,2
2018-19,2018-11-15,Winnipeg Jets,2,Central,Western,23,2,34,0.6764705882352942,23,0,20,3
2018-19,2018-11-17,Winnipeg Jets,1,Central,Western,24,2,36,0.6666666666666666,24,0,21,3
2018-19,2018-11-20,Winnipeg Jets,2,Central,Western,26,2,38,0.6842105263157895,26,0,22,4
2018-19,2018-11-22,Winnipeg Jets,0,Central,Western,26,2,40,0.65,26,0,23,3
2018-19,2018-11-23,Winnipeg Jets,0,Central,Western,26,2,42,0.6190476190476191,26,0,24,2
2018-19,2018-11-25,Winnipeg Jets,2,Central,Western,28,2,44,0.6363636363636364,30,-2,25,3
2018-19,2018-11-28,Winnipeg Jets,0,Central,Western,28,2,46,0.6086956521739131,30,-2,27,1
2018-19,2018-11-30,Winnipeg Jets,2,Central,Western,30,2,48,0.625,30,0,29,1
2018-19,2018-12-02,Winnipeg Jets,2,Central,Western,32,2,50,0.64,34,-2,29,3
2018-19,2018-12-02,Winnipeg Jets,2,Central,Western,34,2,52,0.6538461538461539,34,0,29,5
2018-19,2018-12-05,Winnipeg Jets,2,Central,Western,36,2,54,0.6666666666666666,36,0,31,5
2018-19,2018-12-08,Winnipeg Jets,0,Central,Western,36,2,56,0.6428571428571429,36,0,33,3
2018-19,2018-12-09,Winnipeg Jets,2,Central,Western,38,2,58,0.6551724137931034,38,0,33,5
2018-19,2018-12-12,Winnipeg Jets,2,Central,Western,40,2,60,0.6666666666666666,39,1,35,5
2018-19,2018-12-14,Winnipeg Jets,2,Central,Western,42,2,62,0.6774193548387096,39,3,37,5
2018-19,2018-12-15,Winnipeg Jets,2,Central,Western,44,2,64,0.6875,40,4,38,6
2018-19,2018-12-17,Winnipeg Jets,2,Central,Western,46,2,66,0.696969696969697,42,4,39,7
2018-19,2018-12-19,Winnipeg Jets,0,Central,Western,46,2,68,0.6764705882352942,42,4,39,7
2018-19,2018-12-21,Winnipeg Jets,2,Central,Western,48,2,70,0.6857142857142857,44,4,39,9
2018-19,2018-12-23,Winnipeg Jets,2,Central,Western,50,2,72,0.6944444444444444,44,6,39,11
2018-19,2018-12-28,Winnipeg Jets,0,Central,Western,50,2,74,0.6756756756756757,44,6,41,9
2018-19,2018-12-29,Winnipeg Jets,0,Central,Western,50,2,76,0.6578947368421053,44,6,41,9
2018-19,2019-01-01,Winnipeg Jets,2,Central,Western,52,2,78,0.6666666666666666,46,6,44,8
2018-19,2019-01-05,Winnipeg Jets,0,Central,Western,52,2,80,0.65,48,4,45,7
2018-19,2019-01-06,Winnipeg Jets,2,Central,Western,54,2,82,0.6585365853658537,48,6,45,9
2018-19,2019-01-09,Winnipeg Jets,2,Central,Western,56,2,84,0.6666666666666666,50,6,45,11
2018-19,2019-01-11,Winnipeg Jets,0,Central,Western,56,2,86,0.6511627906976745,50,6,47,9
2018-19,2019-01-12,Winnipeg Jets,2,Central,Western,58,2,88,0.6590909090909091,50,8,47,11
2018-19,2019-01-13,Winnipeg Jets,2,Central,Western,60,2,90,0.6666666666666666,50,10,47,13
2018-19,2019-01-16,Winnipeg Jets,2,Central,Western,62,2,92,0.6739130434782609,50,12,49,13
2018-19,2019-01-18,Winnipeg Jets,2,Central,Western,64,2,94,0.6808510638297872,50,14,49,15
2018-19,2019-01-20,Winnipeg Jets,0,Central,Western,64,2,96,0.6666666666666666,52,12,52,12
2018-19,2019-01-29,Winnipeg Jets,0,Central,Western,64,2,98,0.6530612244897959,55,9,52,12
2018-19,2019-01-30,Winnipeg Jets,2,Central,Western,66,2,100,0.66,55,11,52,14
2018-19,2019-02-01,Winnipeg Jets,2,Central,Western,68,2,102,0.6666666666666666,55,13,52,16
2018-19,2019-02-03,Winnipeg Jets,2,Central,Western,70,2,104,0.6730769230769231,58,12,54,16
2018-19,2019-02-06,Winnipeg Jets,1,Central,Western,71,2,106,0.6698113207547169,60,11,54,17
2018-19,2019-02-08,Winnipeg Jets,0,Central,Western,71,2,108,0.6574074074074074,61,10,55,16
2018-19,2019-02-09,Winnipeg Jets,0,Central,Western,71,2,110,0.6454545454545455,61,10,57,14
2018-19,2019-02-10,Winnipeg Jets,2,Central,Western,73,2,112,0.6517857142857143,61,12,59,14
2018-19,2019-02-13,Winnipeg Jets,2,Central,Western,75,2,114,0.6578947368421053,63,12,59,16
2018-19,2019-02-15,Winnipeg Jets,0,Central,Western,75,2,116,0.646551724137931,63,12,59,16
2018-19,2019-02-17,Winnipeg Jets,1,Central,Western,76,2,118,0.6440677966101694,67,9,60,16
2018-19,2019-02-21,Winnipeg Jets,0,Central,Western,76,2,120,0.6333333333333333,69,7,61,15
2018-19,2019-02-23,Winnipeg Jets,2,Central,Western,78,2,122,0.639344262295082,71,7,64,14
2018-19,2019-02-25,Winnipeg Jets,0,Central,Western,78,2,124,0.6290322580645161,72,6,66,12
2018-19,2019-02-27,Winnipeg Jets,0,Central,Western,78,2,126,0.6190476190476191,74,4,67,11
2018-19,2019-03-02,Winnipeg Jets,2,Central,Western,80,2,128,0.625,74,6,68,12
2018-19,2019-03-04,Winnipeg Jets,2,Central,Western,82,2,130,0.6307692307692307,74,8,71,11
2018-19,2019-03-06,Winnipeg Jets,0,Central,Western,82,2,132,0.6212121212121212,74,8,72,10
2018-19,2019-03-09,Winnipeg Jets,2,Central,Western,84,2,134,0.6268656716417911,79,5,74,10
2018-19,2019-03-10,Winnipeg Jets,0,Central,Western,84,2,136,0.6176470588235294,79,5,74,10
2018-19,2019-03-13,Winnipeg Jets,0,Central,Western,84,2,138,0.6086956521739131,79,5,75,9
2018-19,2019-03-15,Winnipeg Jets,2,Central,Western,86,2,140,0.6142857142857143,79,7,77,9
2018-19,2019-03-16,Winnipeg Jets,2,Central,Western,88,2,142,0.6197183098591549,81,7,77,11
2018-19,2019-03-19,Winnipeg Jets,2,Central,Western,90,2,144,0.625,82,8,78,12
2018-19,2019-03-21,Winnipeg Jets,2,Central,Western,92,2,146,0.6301369863013698,84,8,78,14
2018-19,2019-03-22,Winnipeg Jets,0,Central,Western,92,2,148,0.6216216216216216,86,6,79,13
2018-19,2019-03-23,Winnipeg Jets,2,Central,Western,94,2,150,0.6266666666666667,86,8,80,14
2018-19,2019-03-26,Winnipeg Jets,0,Central,Western,94,2,152,0.618421052631579,90,4,81,13
2018-19,2019-03-29,Winnipeg Jets,0,Central,Western,94,2,154,0.6103896103896104,90,4,83,11
2018-19,2019-03-30,Winnipeg Jets,0,Central,Western,94,2,156,0.6025641025641025,92,2,85,9
2018-19,2019-04-02,Winnipeg Jets,2,Central,Western,96,2,158,0.6075949367088608,94,2,86,10
2018-19,2019-04-03,Winnipeg Jets,0,Central,Western,96,2,160,0.6,94,2,88,8
2018-19,2019-04-05,Winnipeg Jets,1,Central,Western,97,2,162,0.5987654320987654,97,0,90,7
2018-19,2019-04-07,Winnipeg Jets,2,Central,Western,99,2,164,0.6036585365853658,99,0,90,9
2019-20,2019-10-04,Anaheim Ducks,2,Pacific,Western,2,2,2,1.0,2,0,0,2
2019-20,2019-10-06,Anaheim Ducks,2,Pacific,Western,4,2,4,1.0,4,0,2,2
2019-20,2019-10-08,Anaheim Ducks,2,Pacific,Western,6,2,6,1.0,4,2,2,4
2019-20,2019-10-10,Anaheim Ducks,0,Pacific,Western,6,2,8,0.75,4,2,3,3
2019-20,2019-10-11,Anaheim Ducks,2,Pacific,Western,8,2,10,0.8,5,3,4,4
2019-20,2019-10-14,Anaheim Ducks,0,Pacific,Western,8,2,12,0.6666666666666666,8,0,5,3
2019-20,2019-10-17,Anaheim Ducks,2,Pacific,Western,10,2,14,0.7142857142857143,8,2,7,3
2019-20,2019-10-19,Anaheim Ducks,2,Pacific,Western,12,2,16,0.75,12,0,8,4
2019-20,2019-10-21,Anaheim Ducks,0,Pacific,Western,12,2,18,0.6666666666666666,12,0,9,3
2019-20,2019-10-23,Anaheim Ducks,0,Pacific,Western,12,2,20,0.6,12,0,11,1
2019-20,2019-10-25,Anaheim Ducks,0,Pacific,Western,12,2,22,0.5454545454545454,13,-1,12,0
2019-20,2019-10-27,Anaheim Ducks,2,Pacific,Western,14,2,24,0.5833333333333334,14,0,13,1
2019-20,2019-10-28,Anaheim Ducks,0,Pacific,Western,14,2,26,0.5384615384615384,15,-1,14,0
2019-20,2019-10-30,Anaheim Ducks,2,Pacific,Western,16,2,28,0.5714285714285714,16,0,15,1
2019-20,2019-11-02,Anaheim Ducks,2,Pacific,Western,18,2,30,0.6,18,0,17,1
2019-20,2019-11-04,Anaheim Ducks,1,Pacific,Western,19,2,32,0.59375,19,0,18,1
2019-20,2019-11-06,Anaheim Ducks,0,Pacific,Western,19,2,34,0.5588235294117647,20,-1,19,0
2019-20,2019-11-11,Anaheim Ducks,0,Pacific,Western,19,2,36,0.5277777777777778,21,-2,21,-2
2019-20,2019-11-13,Anaheim Ducks,1,Pacific,Western,20,2,38,0.5263157894736842,23,-3,21,-1
2019-20,2019-11-15,Anaheim Ducks,0,Pacific,Western,20,2,40,0.5,23,-3,22,-2
2019-20,2019-11-17,Anaheim Ducks,2,Pacific,Western,22,2,42,0.5238095238095238,24,-2,23,-1
2019-20,2019-11-19,Anaheim Ducks,0,Pacific,Western,22,2,44,0.5,24,-2,23,-1
2019-20,2019-11-22,Anaheim Ducks,1,Pacific,Western,23,2,46,0.5,26,-3,26,-3
2019-20,2019-11-24,Anaheim Ducks,0,Pacific,Western,23,2,48,0.4791666666666667,28,-5,26,-3
2019-20,2019-11-26,Anaheim Ducks,2,Pacific,Western,25,2,50,0.5,28,-3,27,-2
2019-20,2019-11-28,Anaheim Ducks,1,Pacific,Western,26,2,52,0.5,28,-2,28,-2
2019-20,2019-11-29,Anaheim Ducks,0,Pacific,Western,26,2,54,0.48148148148148145,30,-4,29,-3
2019-20,2019-12-03,Anaheim Ducks,2,Pacific,Western,28,2,56,0.5,32,-4,31,-3
2019-20,2019-12-07,Anaheim Ducks,0,Pacific,Western,28,2,58,0.4827586206896552,35,-7,34,-6
2019-20,2019-12-08,Anaheim Ducks,0,Pacific,Western,28,2,60,0.4666666666666667,35,-7,34,-6
2019-20,2019-12-11,Anaheim Ducks,2,Pacific,Western,30,2,62,0.4838709677419355,38,-8,37,-7
2019-20,2019-12-13,Anaheim Ducks,0,Pacific,Western,30,2,64,0.46875,40,-10,37,-7
2019-20,2019-12-14,Anaheim Ducks,2,Pacific,Western,32,2,66,0.48484848484848486,40,-8,39,-7
2019-20,2019-12-18,Anaheim Ducks,0,Pacific,Western,32,2,68,0.47058823529411764,42,-10,40,-8
2019-20,2019-12-19,Anaheim Ducks,0,Pacific,Western,32,2,70,0.45714285714285713,42,-10,40,-8
2019-20,2019-12-21,Anaheim Ducks,2,Pacific,Western,34,2,72,0.4722222222222222,42,-8,41,-7
2019-20,2019-12-22,Anaheim Ducks,0,Pacific,Western,34,2,74,0.4594594594594595,44,-10,41,-7
2019-20,2019-12-28,Anaheim Ducks,2,Pacific,Western,36,2,76,0.47368421052631576,45,-9,44,-8
2019-20,2019-12-30,Anaheim Ducks,1,Pacific,Western,37,2,78,0.47435897435897434,46,-9,45,-8
2019-20,2019-12-31,Anaheim Ducks,0,Pacific,Western,37,2,80,0.4625,46,-9,45,-8
2019-20,2020-01-03,Anaheim Ducks,0,Pacific,Western,37,2,82,0.45121951219512196,48,-11,47,-10
2019-20,2020-01-06,Anaheim Ducks,2,Pacific,Western,39,2,84,0.4642857142857143,50,-11,49,-10
2019-20,2020-01-08,Anaheim Ducks,0,Pacific,Western,39,2,86,0.45348837209302323,51,-12,50,-11
2019-20,2020-01-10,Anaheim Ducks,0,Pacific,Western,39,2,88,0.4431818181818182,53,-14,52,-13
2019-20,2020-01-12,Anaheim Ducks,0,Pacific,Western,39,2,90,0.43333333333333335,54,-15,53,-14
2019-20,2020-01-14,Anaheim Ducks,0,Pacific,Western,39,2,92,0.42391304347826086,54,-15,53,-14
2019-20,2020-01-17,Anaheim Ducks,2,Pacific,Western,41,2,94,0.43617021276595747,56,-15,55,-14
2019-20,2020-01-18,Anaheim Ducks,2,Pacific,Western,43,2,96,0.4479166666666667,57,-14,56,-13
2019-20,2020-01-28,Anaheim Ducks,0,Pacific,Western,43,2,98,0.4387755102040816,57,-14,57,-14
2019-20,2020-01-30,Anaheim Ducks,2,Pacific,Western,45,2,100,0.45,58,-13,57,-12
2019-20,2020-02-01,Anaheim Ducks,0,Pacific,Western,45,2,102,0.4411764705882353,60,-15,58,-13
2019-20,2020-02-02,Anaheim Ducks,2,Pacific,Western,47,2,104,0.4519230769230769,61,-14,59,-12
2019-20,2020-02-05,Anaheim Ducks,2,Pacific,Western,49,2,106,0.46226415094339623,61,-12,60,-11
2019-20,2020-02-07,Anaheim Ducks,1,Pacific,Western,50,2,108,0.46296296296296297,62,-12,60,-10
2019-20,2020-02-08,Anaheim Ducks,1,Pacific,Western,51,2,110,0.4636363636363636,62,-11,61,-10
2019-20,2020-02-09,Anaheim Ducks,2,Pacific,Western,53,2,112,0.4732142857142857,64,-11,61,-8
2019-20,2020-02-14,Anaheim Ducks,0,Pacific,Western,53,2,114,0.4649122807017544,66,-13,64,-11
2019-20,2020-02-16,Anaheim Ducks,2,Pacific,Western,55,2,116,0.47413793103448276,68,-13,66,-11
2019-20,2020-02-17,Anaheim Ducks,0,Pacific,Western,55,2,118,0.4661016949152542,69,-14,68,-13
2019-20,2020-02-20,Anaheim Ducks,0,Pacific,Western,55,2,120,0.4583333333333333,70,-15,68,-13
2019-20,2020-02-22,Anaheim Ducks,0,Pacific,Western,55,2,122,0.45081967213114754,70,-15,68,-13
2019-20,2020-02-24,Anaheim Ducks,1,Pacific,Western,56,2,124,0.45161290322580644,72,-16,70,-14
2019-20,2020-02-26,Anaheim Ducks,2,Pacific,Western,58,2,126,0.4603174603174603,74,-16,70,-12
2019-20,2020-02-29,Anaheim Ducks,2,Pacific,Western,60,2,128,0.46875,74,-14,72,-12
2019-20,2020-03-02,Anaheim Ducks,0,Pacific,Western,60,2,130,0.46153846153846156,75,-15,72,-12
2019-20,2020-03-04,Anaheim Ducks,0,Pacific,Western,60,2,132,0.45454545454545453,75,-15,74,-14
2019-20,2020-03-05,Anaheim Ducks,2,Pacific,Western,62,2,134,0.4626865671641791,77,-15,74,-12
2019-20,2020-03-07,Anaheim Ducks,2,Pacific,Western,64,2,136,0.47058823529411764,79,-15,76,-12
2019-20,2020-03-09,Anaheim Ducks,1,Pacific,Western,65,2,138,0.47101449275362317,79,-14,76,-11
2019-20,2020-03-11,Anaheim Ducks,2,Pacific,Western,67,2,140,0.4785714285714286,79,-12,78,-11
2019-20,2020-03-12,Anaheim Ducks,0,Pacific,Western,67,2,142,0.47183098591549294,79,-12,78,-11
2019-20,2019-10-04,Arizona Coyotes,0,Pacific,Western,0,2,2,0.0,2,-2,0,0
2019-20,2019-10-06,Arizona Coyotes,0,Pacific,Western,0,2,4,0.0,4,-4,2,-2
2019-20,2019-10-11,Arizona Coyotes,2,Pacific,Western,2,2,6,0.3333333333333333,5,-3,4,-2
2019-20,2019-10-13,Arizona Coyotes,1,Pacific,Western,3,2,8,0.375,6,-3,5,-2
2019-20,2019-10-16,Arizona Coyotes,2,Pacific,Western,5,2,10,0.5,8,-3,7,-2
2019-20,2019-10-18,Arizona Coyotes,2,Pacific,Western,7,2,12,0.5833333333333334,10,-3,8,-1
2019-20,2019-10-19,Arizona Coyotes,2,Pacific,Western,9,2,14,0.6428571428571429,12,-3,8,1
2019-20,2019-10-22,Arizona Coyotes,2,Pacific,Western,11,2,16,0.6875,12,-1,11,0
2019-20,2019-10-24,Arizona Coyotes,0,Pacific,Western,11,2,18,0.6111111111111112,12,-1,11,0
2019-20,2019-10-25,Arizona Coyotes,2,Pacific,Western,13,2,20,0.65,13,0,12,1
2019-20,2019-10-28,Arizona Coyotes,2,Pacific,Western,15,2,22,0.6818181818181818,15,0,14,1
2019-20,2019-10-31,Arizona Coyotes,0,Pacific,Western,15,2,24,0.625,16,-1,15,0
2019-20,2019-11-03,Arizona Coyotes,2,Pacific,Western,17,2,26,0.6538461538461539,18,-1,18,-1
2019-20,2019-11-05,Arizona Coyotes,2,Pacific,Western,19,2,28,0.6785714285714286,19,0,18,1
2019-20,2019-11-06,Arizona Coyotes,1,Pacific,Western,20,2,30,0.6666666666666666,20,0,19,1
2019-20,2019-11-08,Arizona Coyotes,0,Pacific,Western,20,2,32,0.625,21,-1,20,0
2019-20,2019-11-10,Arizona Coyotes,0,Pacific,Western,20,2,34,0.5882352941176471,21,-1,21,-1
2019-20,2019-11-12,Arizona Coyotes,2,Pacific,Western,22,2,36,0.6111111111111112,22,0,21,1
2019-20,2019-11-13,Arizona Coyotes,2,Pacific,Western,24,2,38,0.631578947368421,23,1,21,3
2019-20,2019-11-15,Arizona Coyotes,0,Pacific,Western,24,2,40,0.6,23,1,22,2
2019-20,2019-11-16,Arizona Coyotes,2,Pacific,Western,26,2,42,0.6190476190476191,23,3,23,3
2019-20,2019-11-19,Arizona Coyotes,2,Pacific,Western,28,2,44,0.6363636363636364,24,4,23,5
2019-20,2019-11-22,Arizona Coyotes,0,Pacific,Western,28,2,46,0.6086956521739131,26,2,26,2
2019-20,2019-11-23,Arizona Coyotes,2,Pacific,Western,30,2,48,0.625,28,2,26,4
2019-20,2019-11-25,Arizona Coyotes,1,Pacific,Western,31,2,50,0.62,28,3,26,5
2019-20,2019-11-28,Arizona Coyotes,2,Pacific,Western,33,2,52,0.6346153846153846,28,5,28,5
2019-20,2019-11-29,Arizona Coyotes,1,Pacific,Western,34,2,54,0.6296296296296297,30,4,29,5
2019-20,2019-12-01,Arizona Coyotes,0,Pacific,Western,34,2,56,0.6071428571428571,31,3,30,4
2019-20,2019-12-04,Arizona Coyotes,2,Pacific,Western,36,2,58,0.6206896551724138,34,2,32,4
2019-20,2019-12-06,Arizona Coyotes,2,Pacific,Western,38,2,60,0.6333333333333333,35,3,32,6
2019-20,2019-12-07,Arizona Coyotes,0,Pacific,Western,38,2,62,0.6129032258064516,35,3,34,4
2019-20,2019-12-09,Arizona Coyotes,2,Pacific,Western,40,2,64,0.625,35,5,34,6
2019-20,2019-12-11,Arizona Coyotes,0,Pacific,Western,40,2,66,0.6060606060606061,38,2,37,3
2019-20,2019-12-13,Arizona Coyotes,2,Pacific,Western,42,2,68,0.6176470588235294,40,2,37,5
2019-20,2019-12-15,Arizona Coyotes,0,Pacific,Western,42,2,70,0.6,40,2,39,3
2019-20,2019-12-18,Arizona Coyotes,2,Pacific,Western,44,2,72,0.6111111111111112,42,2,40,4
2019-20,2019-12-20,Arizona Coyotes,0,Pacific,Western,44,2,74,0.5945945945945946,42,2,41,3
2019-20,2019-12-23,Arizona Coyotes,2,Pacific,Western,46,2,76,0.6052631578947368,44,2,43,3
2019-20,2019-12-24,Arizona Coyotes,0,Pacific,Western,46,2,78,0.5897435897435898,44,2,43,3
2019-20,2019-12-29,Arizona Coyotes,0,Pacific,Western,46,2,80,0.575,45,1,44,2
2019-20,2019-12-30,Arizona Coyotes,0,Pacific,Western,46,2,82,0.5609756097560976,46,0,45,1
2019-20,2020-01-01,Arizona Coyotes,2,Pacific,Western,48,2,84,0.5714285714285714,46,2,46,2
2019-20,2020-01-03,Arizona Coyotes,2,Pacific,Western,50,2,86,0.5813953488372093,48,2,47,3
2019-20,2020-01-05,Arizona Coyotes,2,Pacific,Western,52,2,88,0.5909090909090909,50,2,48,4
2019-20,2020-01-08,Arizona Coyotes,2,Pacific,Western,54,2,90,0.6,51,3,50,4
2019-20,2020-01-10,Arizona Coyotes,0,Pacific,Western,54,2,92,0.5869565217391305,53,1,52,2
2019-20,2020-01-11,Arizona Coyotes,0,Pacific,Western,54,2,94,0.574468085106383,53,1,52,2
2019-20,2020-01-12,Arizona Coyotes,1,Pacific,Western,55,2,96,0.5729166666666666,54,1,53,2
2019-20,2020-01-15,Arizona Coyotes,2,Pacific,Western,57,2,98,0.5816326530612245,55,2,54,3
2019-20,2020-01-17,Arizona Coyotes,0,Pacific,Western,57,2,100,0.57,56,1,55,2
2019-20,2020-01-18,Arizona Coyotes,0,Pacific,Western,57,2,102,0.5588235294117647,57,0,56,1
2019-20,2020-01-30,Arizona Coyotes,0,Pacific,Western,57,2,104,0.5480769230769231,58,-1,57,0
2019-20,2020-01-31,Arizona Coyotes,1,Pacific,Western,58,2,106,0.5471698113207547,58,0,57,1
2019-20,2020-02-02,Arizona Coyotes,1,Pacific,Western,59,2,108,0.5462962962962963,61,-2,59,0
2019-20,2020-02-05,Arizona Coyotes,2,Pacific,Western,61,2,110,0.5545454545454546,61,0,60,1
2019-20,2020-02-07,Arizona Coyotes,0,Pacific,Western,61,2,112,0.5446428571428571,62,-1,60,1
2019-20,2020-02-08,Arizona Coyotes,0,Pacific,Western,61,2,114,0.5350877192982456,62,-1,61,0
2019-20,2020-02-11,Arizona Coyotes,2,Pacific,Western,63,2,116,0.5431034482758621,64,-1,63,0
2019-20,2020-02-12,Arizona Coyotes,1,Pacific,Western,64,2,118,0.5423728813559322,64,0,64,0
2019-20,2020-02-14,Arizona Coyotes,0,Pacific,Western,64,2,120,0.5333333333333333,66,-2,64,0
2019-20,2020-02-16,Arizona Coyotes,2,Pacific,Western,66,2,122,0.5409836065573771,68,-2,66,0
2019-20,2020-02-17,Arizona Coyotes,2,Pacific,Western,68,2,124,0.5483870967741935,69,-1,68,0
2019-20,2020-02-20,Arizona Coyotes,0,Pacific,Western,68,2,126,0.5396825396825397,70,-2,68,0
2019-20,2020-02-21,Arizona Coyotes,0,Pacific,Western,68,2,128,0.53125,70,-2,68,0
2019-20,2020-02-23,Arizona Coyotes,2,Pacific,Western,70,2,130,0.5384615384615384,71,-1,69,1
2019-20,2020-02-26,Arizona Coyotes,0,Pacific,Western,70,2,132,0.5303030303030303,74,-4,70,0
2019-20,2020-03-01,Arizona Coyotes,2,Pacific,Western,72,2,134,0.5373134328358209,75,-3,72,0
2019-20,2020-03-05,Arizona Coyotes,2,Pacific,Western,74,2,136,0.5441176470588235,77,-3,74,0
2019-20,2020-03-07,Arizona Coyotes,0,Pacific,Western,74,2,138,0.5362318840579711,79,-5,76,-2
2019-20,2020-03-10,Arizona Coyotes,0,Pacific,Western,74,2,140,0.5285714285714286,79,-5,78,-4
2019-20,2019-10-04,Boston Bruins,2,Atlantic,Eastern,2,2,2,1.0,2,0,1,1
2019-20,2019-10-06,Boston Bruins,2,Atlantic,Eastern,4,2,4,1.0,4,0,3,1
2019-20,2019-10-09,Boston Bruins,2,Atlantic,Eastern,6,2,6,1.0,5,1,4,2
2019-20,2019-10-11,Boston Bruins,0,Atlantic,Eastern,6,2,8,0.75,6,0,4,2
2019-20,2019-10-12,Boston Bruins,2,Atlantic,Eastern,8,2,10,0.8,7,1,5,3
2019-20,2019-10-14,Boston Bruins,2,Atlantic,Eastern,10,2,12,0.8333333333333334,7,3,6,4
2019-20,2019-10-17,Boston Bruins,1,Atlantic,Eastern,11,2,14,0.7857142857142857,9,2,8,3
2019-20,2019-10-19,Boston Bruins,1,Atlantic,Eastern,12,2,16,0.75,11,1,10,2
2019-20,2019-10-22,Boston Bruins,2,Atlantic,Eastern,14,2,18,0.7777777777777778,12,2,10,4
2019-20,2019-10-26,Boston Bruins,2,Atlantic,Eastern,16,2,20,0.8,14,2,12,4
2019-20,2019-10-27,Boston Bruins,2,Atlantic,Eastern,18,2,22,0.8181818181818182,14,4,14,4
2019-20,2019-10-29,Boston Bruins,2,Atlantic,Eastern,20,2,24,0.8333333333333334,15,5,14,6
2019-20,2019-11-02,Boston Bruins,2,Atlantic,Eastern,22,2,26,0.8461538461538461,18,4,17,5
2019-20,2019-11-05,Boston Bruins,2,Atlantic,Eastern,24,2,28,0.8571428571428571,18,6,17,7
2019-20,2019-11-06,Boston Bruins,0,Atlantic,Eastern,24,2,30,0.8,19,5,18,6
2019-20,2019-11-09,Boston Bruins,0,Atlantic,Eastern,24,2,32,0.75,20,4,19,5
2019-20,2019-11-11,Boston Bruins,1,Atlantic,Eastern,25,2,34,0.7352941176470589,21,4,21,4
2019-20,2019-11-13,Boston Bruins,1,Atlantic,Eastern,26,2,36,0.7222222222222222,23,3,22,4
2019-20,2019-11-16,Boston Bruins,2,Atlantic,Eastern,28,2,38,0.7368421052631579,23,5,22,6
2019-20,2019-11-17,Boston Bruins,1,Atlantic,Eastern,29,2,40,0.725,25,4,24,5
2019-20,2019-11-20,Boston Bruins,2,Atlantic,Eastern,31,2,42,0.7380952380952381,26,5,24,7
2019-20,2019-11-22,Boston Bruins,2,Atlantic,Eastern,33,2,44,0.75,27,6,26,7
2019-20,2019-11-24,Boston Bruins,2,Atlantic,Eastern,35,2,46,0.7608695652173914,27,8,27,8
2019-20,2019-11-27,Boston Bruins,2,Atlantic,Eastern,37,2,48,0.7708333333333334,27,10,27,10
2019-20,2019-11-28,Boston Bruins,2,Atlantic,Eastern,39,2,50,0.78,28,11,28,11
2019-20,2019-11-29,Boston Bruins,2,Atlantic,Eastern,41,2,52,0.7884615384615384,28,13,28,13
2019-20,2019-12-02,Boston Bruins,2,Atlantic,Eastern,43,2,54,0.7962962962962963,30,13,30,13
2019-20,2019-12-04,Boston Bruins,2,Atlantic,Eastern,45,2,56,0.8035714285714286,31,14,31,14
2019-20,2019-12-06,Boston Bruins,1,Atlantic,Eastern,46,2,58,0.7931034482758621,31,15,31,15
2019-20,2019-12-08,Boston Bruins,0,Atlantic,Eastern,46,2,60,0.7666666666666667,32,14,32,14
2019-20,2019-12-10,Boston Bruins,0,Atlantic,Eastern,46,2,62,0.7419354838709677,34,12,34,12
2019-20,2019-12-12,Boston Bruins,0,Atlantic,Eastern,46,2,64,0.71875,36,10,36,10
2019-20,2019-12-13,Boston Bruins,0,Atlantic,Eastern,46,2,66,0.696969696969697,36,10,36,10
2019-20,2019-12-15,Boston Bruins,2,Atlantic,Eastern,48,2,68,0.7058823529411765,36,12,36,12
2019-20,2019-12-18,Boston Bruins,1,Atlantic,Eastern,49,2,70,0.7,38,11,38,11
2019-20,2019-12-20,Boston Bruins,1,Atlantic,Eastern,50,2,72,0.6944444444444444,39,11,39,11
2019-20,2019-12-22,Boston Bruins,1,Atlantic,Eastern,51,2,74,0.6891891891891891,41,10,41,10
2019-20,2019-12-24,Boston Bruins,2,Atlantic,Eastern,53,2,76,0.6973684210526315,42,11,42,11
2019-20,2019-12-28,Boston Bruins,2,Atlantic,Eastern,55,2,78,0.7051282051282052,42,13,42,13
2019-20,2019-12-30,Boston Bruins,2,Atlantic,Eastern,57,2,80,0.7125,45,12,45,12
2019-20,2019-12-31,Boston Bruins,1,Atlantic,Eastern,58,2,82,0.7073170731707317,45,13,45,13
2019-20,2020-01-03,Boston Bruins,1,Atlantic,Eastern,59,2,84,0.7023809523809523,48,11,48,11
2019-20,2020-01-04,Boston Bruins,0,Atlantic,Eastern,59,2,86,0.686046511627907,48,11,48,11
2019-20,2020-01-08,Boston Bruins,2,Atlantic,Eastern,61,2,88,0.6931818181818182,53,8,50,11
2019-20,2020-01-10,Boston Bruins,2,Atlantic,Eastern,63,2,90,0.7,54,9,52,11
2019-20,2020-01-12,Boston Bruins,2,Atlantic,Eastern,65,2,92,0.7065217391304348,54,11,52,13
2019-20,2020-01-14,Boston Bruins,1,Atlantic,Eastern,66,2,94,0.7021276595744681,54,12,54,12
2019-20,2020-01-15,Boston Bruins,0,Atlantic,Eastern,66,2,96,0.6875,56,10,54,12
2019-20,2020-01-17,Boston Bruins,2,Atlantic,Eastern,68,2,98,0.6938775510204082,57,11,56,12
2019-20,2020-01-19,Boston Bruins,0,Atlantic,Eastern,68,2,100,0.68,57,11,58,10
2019-20,2020-01-22,Boston Bruins,2,Atlantic,Eastern,70,2,102,0.6862745098039216,61,9,60,10
2019-20,2020-02-01,Boston Bruins,2,Atlantic,Eastern,72,2,104,0.6923076923076923,61,11,61,11
2019-20,2020-02-02,Boston Bruins,2,Atlantic,Eastern,74,2,106,0.6981132075471698,63,11,63,11
2019-20,2020-02-05,Boston Bruins,2,Atlantic,Eastern,76,2,108,0.7037037037037037,64,12,64,12
2019-20,2020-02-06,Boston Bruins,2,Atlantic,Eastern,78,2,110,0.7090909090909091,64,14,64,14
2019-20,2020-02-08,Boston Bruins,2,Atlantic,Eastern,80,2,112,0.7142857142857143,65,15,65,15
2019-20,2020-02-09,Boston Bruins,0,Atlantic,Eastern,80,2,114,0.7017543859649122,66,14,67,13
2019-20,2020-02-13,Boston Bruins,2,Atlantic,Eastern,82,2,116,0.7068965517241379,68,14,68,14
2019-20,2020-02-15,Boston Bruins,2,Atlantic,Eastern,84,2,118,0.711864406779661,68,16,69,15
2019-20,2020-02-16,Boston Bruins,2,Atlantic,Eastern,86,2,120,0.7166666666666667,70,16,70,16
2019-20,2020-02-20,Boston Bruins,2,Atlantic,Eastern,88,2,122,0.7213114754098361,70,18,72,16
2019-20,2020-02-22,Boston Bruins,2,Atlantic,Eastern,90,2,124,0.7258064516129032,72,18,72,18
2019-20,2020-02-23,Boston Bruins,0,Atlantic,Eastern,90,2,126,0.7142857142857143,72,18,74,16
2019-20,2020-02-26,Boston Bruins,0,Atlantic,Eastern,90,2,128,0.703125,74,16,74,16
2019-20,2020-02-28,Boston Bruins,2,Atlantic,Eastern,92,2,130,0.7076923076923077,76,16,76,16
2019-20,2020-02-29,Boston Bruins,2,Atlantic,Eastern,94,2,132,0.7121212121212122,76,18,76,18
2019-20,2020-03-04,Boston Bruins,2,Atlantic,Eastern,96,2,134,0.7164179104477612,78,18,78,18
2019-20,2020-03-06,Boston Bruins,2,Atlantic,Eastern,98,2,136,0.7205882352941176,79,19,78,20
2019-20,2020-03-08,Boston Bruins,0,Atlantic,Eastern,98,2,138,0.7101449275362319,79,19,79,19
2019-20,2020-03-10,Boston Bruins,2,Atlantic,Eastern,100,2,140,0.7142857142857143,81,19,81,19
2019-20,2019-10-03,Buffalo Sabres,2,Atlantic,Eastern,2,2,2,1.0,2,0,0,2
2019-20,2019-10-05,Buffalo Sabres,2,Atlantic,Eastern,4,2,4,1.0,3,1,2,2
2019-20,2019-10-07,Buffalo Sabres,1,Atlantic,Eastern,5,2,6,0.8333333333333334,4,1,3,2
2019-20,2019-10-09,Buffalo Sabres,2,Atlantic,Eastern,7,2,8,0.875,5,2,4,3
2019-20,2019-10-11,Buffalo Sabres,2,Atlantic,Eastern,9,2,10,0.9,6,3,4,5
2019-20,2019-10-14,Buffalo Sabres,2,Atlantic,Eastern,11,2,12,0.9166666666666666,7,4,6,5
2019-20,2019-10-17,Buffalo Sabres,0,Atlantic,Eastern,11,2,14,0.7857142857142857,9,2,8,3
2019-20,2019-10-18,Buffalo Sabres,2,Atlantic,Eastern,13,2,16,0.8125,9,4,8,5
2019-20,2019-10-20,Buffalo Sabres,2,Atlantic,Eastern,15,2,18,0.8333333333333334,11,4,10,5
2019-20,2019-10-22,Buffalo Sabres,2,Atlantic,Eastern,17,2,20,0.85,12,5,10,7
2019-20,2019-10-24,Buffalo Sabres,0,Atlantic,Eastern,17,2,22,0.7727272727272727,12,5,12,5
2019-20,2019-10-25,Buffalo Sabres,2,Atlantic,Eastern,19,2,24,0.7916666666666666,14,5,12,7
2019-20,2019-10-28,Buffalo Sabres,1,Atlantic,Eastern,20,2,26,0.7692307692307693,14,6,14,6
2019-20,2019-11-01,Buffalo Sabres,0,Atlantic,Eastern,20,2,28,0.7142857142857143,16,4,16,4
2019-20,2019-11-02,Buffalo Sabres,0,Atlantic,Eastern,20,2,30,0.6666666666666666,18,2,17,3
2019-20,2019-11-09,Buffalo Sabres,0,Atlantic,Eastern,20,2,32,0.625,20,0,19,1
2019-20,2019-11-10,Buffalo Sabres,0,Atlantic,Eastern,20,2,34,0.5882352941176471,21,-1,20,0
2019-20,2019-11-15,Buffalo Sabres,1,Atlantic,Eastern,21,2,36,0.5833333333333334,23,-2,22,-1
2019-20,2019-11-17,Buffalo Sabres,2,Atlantic,Eastern,23,2,38,0.6052631578947368,25,-2,24,-1
2019-20,2019-11-18,Buffalo Sabres,0,Atlantic,Eastern,23,2,40,0.575,25,-2,24,-1
2019-20,2019-11-20,Buffalo Sabres,0,Atlantic,Eastern,23,2,42,0.5476190476190477,26,-3,24,-1
2019-20,2019-11-22,Buffalo Sabres,0,Atlantic,Eastern,23,2,44,0.5227272727272727,27,-4,26,-3
2019-20,2019-11-24,Buffalo Sabres,2,Atlantic,Eastern,25,2,46,0.5434782608695652,27,-2,27,-2
2019-20,2019-11-26,Buffalo Sabres,0,Atlantic,Eastern,25,2,48,0.5208333333333334,27,-2,27,-2
2019-20,2019-11-28,Buffalo Sabres,1,Atlantic,Eastern,26,2,50,0.52,28,-2,28,-2
2019-20,2019-11-29,Buffalo Sabres,2,Atlantic,Eastern,28,2,52,0.5384615384615384,28,0,28,0
2019-20,2019-12-01,Buffalo Sabres,1,Atlantic,Eastern,29,2,54,0.5370370370370371,30,-1,30,-1
2019-20,2019-12-03,Buffalo Sabres,2,Atlantic,Eastern,31,2,56,0.5535714285714286,31,0,31,0
2019-20,2019-12-06,Buffalo Sabres,0,Atlantic,Eastern,31,2,58,0.5344827586206896,31,0,31,0
2019-20,2019-12-07,Buffalo Sabres,1,Atlantic,Eastern,32,2,60,0.5333333333333333,32,0,32,0
2019-20,2019-12-09,Buffalo Sabres,2,Atlantic,Eastern,34,2,62,0.5483870967741935,33,1,34,0
2019-20,2019-12-11,Buffalo Sabres,2,Atlantic,Eastern,36,2,64,0.5625,35,1,35,1
2019-20,2019-12-13,Buffalo Sabres,2,Atlantic,Eastern,38,2,66,0.5757575757575758,36,2,36,2
2019-20,2019-12-14,Buffalo Sabres,1,Atlantic,Eastern,39,2,68,0.5735294117647058,36,3,36,3
2019-20,2019-12-18,Buffalo Sabres,0,Atlantic,Eastern,39,2,70,0.5571428571428572,38,1,38,1
2019-20,2019-12-20,Buffalo Sabres,0,Atlantic,Eastern,39,2,72,0.5416666666666666,39,0,39,0
2019-20,2019-12-21,Buffalo Sabres,2,Atlantic,Eastern,41,2,74,0.5540540540540541,40,1,40,1
2019-20,2019-12-24,Buffalo Sabres,0,Atlantic,Eastern,41,2,76,0.5394736842105263,42,-1,42,-1
2019-20,2019-12-28,Buffalo Sabres,0,Atlantic,Eastern,41,2,78,0.5256410256410257,42,-1,42,-1
2019-20,2019-12-30,Buffalo Sabres,0,Atlantic,Eastern,41,2,80,0.5125,45,-4,45,-4
2019-20,2020-01-01,Buffalo Sabres,0,Atlantic,Eastern,41,2,82,0.5,46,-5,46,-5
2019-20,2020-01-03,Buffalo Sabres,2,Atlantic,Eastern,43,2,84,0.5119047619047619,48,-5,48,-5
2019-20,2020-01-04,Buffalo Sabres,2,Atlantic,Eastern,45,2,86,0.5232558139534884,48,-3,48,-3
2019-20,2020-01-10,Buffalo Sabres,0,Atlantic,Eastern,45,2,88,0.5113636363636364,54,-9,52,-7
2019-20,2020-01-11,Buffalo Sabres,0,Atlantic,Eastern,45,2,90,0.5,54,-9,52,-7
2019-20,2020-01-12,Buffalo Sabres,2,Atlantic,Eastern,47,2,92,0.5108695652173914,54,-7,52,-5
2019-20,2020-01-15,Buffalo Sabres,2,Atlantic,Eastern,49,2,94,0.5212765957446809,56,-7,54,-5
2019-20,2020-01-17,Buffalo Sabres,2,Atlantic,Eastern,51,2,96,0.53125,57,-6,56,-5
2019-20,2020-01-19,Buffalo Sabres,0,Atlantic,Eastern,51,2,98,0.5204081632653061,57,-6,58,-7
2019-20,2020-01-29,Buffalo Sabres,0,Atlantic,Eastern,51,2,100,0.51,61,-10,61,-10
2019-20,2020-01-31,Buffalo Sabres,0,Atlantic,Eastern,51,2,102,0.5,61,-10,61,-10
2019-20,2020-02-01,Buffalo Sabres,2,Atlantic,Eastern,53,2,104,0.5096153846153846,61,-8,61,-8
2019-20,2020-02-05,Buffalo Sabres,0,Atlantic,Eastern,53,2,106,0.5,64,-11,64,-11
2019-20,2020-02-07,Buffalo Sabres,1,Atlantic,Eastern,54,2,108,0.5,64,-10,65,-11
2019-20,2020-02-08,Buffalo Sabres,2,Atlantic,Eastern,56,2,110,0.509090909090909,65,-9,65,-9
2019-20,2020-02-09,Buffalo Sabres,0,Atlantic,Eastern,56,2,112,0.5,66,-10,67,-11
2019-20,2020-02-12,Buffalo Sabres,2,Atlantic,Eastern,58,2,114,0.5087719298245614,68,-10,68,-10
2019-20,2020-02-14,Buffalo Sabres,2,Atlantic,Eastern,60,2,116,0.5172413793103449,68,-8,68,-8
2019-20,2020-02-17,Buffalo Sabres,2,Atlantic,Eastern,62,2,118,0.5254237288135594,70,-8,70,-8
2019-20,2020-02-19,Buffalo Sabres,0,Atlantic,Eastern,62,2,120,0.5166666666666667,70,-8,72,-10
2019-20,2020-02-22,Buffalo Sabres,2,Atlantic,Eastern,64,2,122,0.5245901639344263,72,-8,72,-8
2019-20,2020-02-23,Buffalo Sabres,2,Atlantic,Eastern,66,2,124,0.532258064516129,72,-6,74,-8
2019-20,2020-02-27,Buffalo Sabres,0,Atlantic,Eastern,66,2,126,0.5238095238095238,74,-8,74,-8
2019-20,2020-02-29,Buffalo Sabres,0,Atlantic,Eastern,66,2,128,0.515625,76,-10,76,-10
2019-20,2020-03-01,Buffalo Sabres,0,Atlantic,Eastern,66,2,130,0.5076923076923077,78,-12,76,-10
2019-20,2020-03-04,Buffalo Sabres,0,Atlantic,Eastern,66,2,132,0.5,78,-12,78,-12
2019-20,2020-03-06,Buffalo Sabres,0,Atlantic,Eastern,66,2,134,0.4925373134328358,79,-13,78,-12
2019-20,2020-03-08,Buffalo Sabres,0,Atlantic,Eastern,66,2,136,0.4852941176470588,79,-13,79,-13
2019-20,2020-03-09,Buffalo Sabres,2,Atlantic,Eastern,68,2,138,0.4927536231884058,79,-11,79,-11
2019-20,2019-10-04,Calgary Flames,0,Pacific,Western,0,2,2,0.0,2,-2,0,0
2019-20,2019-10-06,Calgary Flames,2,Pacific,Western,2,2,4,0.5,4,-2,2,0
2019-20,2019-10-09,Calgary Flames,1,Pacific,Western,3,2,6,0.5,4,-1,3,0
2019-20,2019-10-11,Calgary Flames,2,Pacific,Western,5,2,8,0.625,5,0,4,1
2019-20,2019-10-13,Calgary Flames,0,Pacific,Western,5,2,10,0.5,6,-1,5,0
2019-20,2019-10-14,Calgary Flames,0,Pacific,Western,5,2,12,0.4166666666666667,8,-3,5,0
2019-20,2019-10-16,Calgary Flames,2,Pacific,Western,7,2,14,0.5,8,-1,7,0
2019-20,2019-10-18,Calgary Flames,2,Pacific,Western,9,2,16,0.5625,10,-1,8,1
2019-20,2019-10-20,Calgary Flames,0,Pacific,Western,9,2,18,0.5,12,-3,9,0
2019-20,2019-10-21,Calgary Flames,2,Pacific,Western,11,2,20,0.55,12,-1,9,2
2019-20,2019-10-23,Calgary Flames,0,Pacific,Western,11,2,22,0.5,12,-1,11,0
2019-20,2019-10-25,Calgary Flames,2,Pacific,Western,13,2,24,0.5416666666666666,13,0,12,1
2019-20,2019-10-27,Calgary Flames,1,Pacific,Western,14,2,26,0.5384615384615384,14,0,13,1
2019-20,2019-10-29,Calgary Flames,0,Pacific,Western,14,2,28,0.5,15,-1,14,0
2019-20,2019-11-01,Calgary Flames,2,Pacific,Western,16,2,30,0.5333333333333333,17,-1,16,0
2019-20,2019-11-02,Calgary Flames,2,Pacific,Western,18,2,32,0.5625,18,0,17,1
2019-20,2019-11-04,Calgary Flames,0,Pacific,Western,18,2,34,0.5294117647058824,19,-1,18,0
2019-20,2019-11-06,Calgary Flames,2,Pacific,Western,20,2,36,0.5555555555555556,20,0,19,1
2019-20,2019-11-08,Calgary Flames,2,Pacific,Western,22,2,38,0.5789473684210527,21,1,20,2
2019-20,2019-11-10,Calgary Flames,1,Pacific,Western,23,2,40,0.575,21,2,21,2
2019-20,2019-11-14,Calgary Flames,0,Pacific,Western,23,2,42,0.5476190476190477,23,0,21,2
2019-20,2019-11-16,Calgary Flames,0,Pacific,Western,23,2,44,0.5227272727272727,23,0,23,0
2019-20,2019-11-18,Calgary Flames,0,Pacific,Western,23,2,46,0.5,24,-1,23,0
2019-20,2019-11-20,Calgary Flames,0,Pacific,Western,23,2,48,0.4791666666666667,25,-2,24,-1
2019-20,2019-11-22,Calgary Flames,0,Pacific,Western,23,2,50,0.46,26,-3,26,-3
2019-20,2019-11-23,Calgary Flames,2,Pacific,Western,25,2,52,0.4807692307692308,28,-3,26,-1
2019-20,2019-11-26,Calgary Flames,1,Pacific,Western,26,2,54,0.48148148148148145,28,-2,27,-1
2019-20,2019-11-28,Calgary Flames,2,Pacific,Western,28,2,56,0.5,28,0,28,0
2019-20,2019-12-01,Calgary Flames,2,Pacific,Western,30,2,58,0.5172413793103449,31,-1,30,0
2019-20,2019-12-06,Calgary Flames,2,Pacific,Western,32,2,60,0.5333333333333333,35,-3,32,0
2019-20,2019-12-08,Calgary Flames,2,Pacific,Western,34,2,62,0.5483870967741935,35,-1,34,0
2019-20,2019-12-10,Calgary Flames,2,Pacific,Western,36,2,64,0.5625,36,0,35,1
2019-20,2019-12-11,Calgary Flames,2,Pacific,Western,38,2,66,0.5757575757575758,38,0,37,1
2019-20,2019-12-13,Calgary Flames,2,Pacific,Western,40,2,68,0.5882352941176471,40,0,37,3
2019-20,2019-12-14,Calgary Flames,0,Pacific,Western,40,2,70,0.5714285714285714,40,0,39,1
2019-20,2019-12-18,Calgary Flames,0,Pacific,Western,40,2,72,0.5555555555555556,42,-2,40,0
2019-20,2019-12-20,Calgary Flames,1,Pacific,Western,41,2,74,0.5540540540540541,42,-1,41,0
2019-20,2019-12-23,Calgary Flames,2,Pacific,Western,43,2,76,0.5657894736842105,44,-1,43,0
2019-20,2019-12-23,Calgary Flames,0,Pacific,Western,43,2,78,0.5512820512820513,44,-1,43,0
2019-20,2019-12-28,Calgary Flames,2,Pacific,Western,45,2,80,0.5625,45,0,44,1
2019-20,2019-12-30,Calgary Flames,0,Pacific,Western,45,2,82,0.5487804878048781,46,-1,45,0
2019-20,2020-01-01,Calgary Flames,0,Pacific,Western,45,2,84,0.5357142857142857,46,-1,46,-1
2019-20,2020-01-03,Calgary Flames,2,Pacific,Western,47,2,86,0.5465116279069767,48,-1,47,0
2019-20,2020-01-06,Calgary Flames,2,Pacific,Western,49,2,88,0.5568181818181818,50,-1,49,0
2019-20,2020-01-08,Calgary Flames,2,Pacific,Western,51,2,90,0.5666666666666667,51,0,50,1
2019-20,2020-01-10,Calgary Flames,2,Pacific,Western,53,2,92,0.5760869565217391,53,0,52,1
2019-20,2020-01-12,Calgary Flames,2,Pacific,Western,55,2,94,0.5851063829787234,54,1,53,2
2019-20,2020-01-14,Calgary Flames,0,Pacific,Western,55,2,96,0.5729166666666666,54,1,53,2
2019-20,2020-01-17,Calgary Flames,2,Pacific,Western,57,2,98,0.5816326530612245,56,1,55,2
2019-20,2020-01-18,Calgary Flames,0,Pacific,Western,57,2,100,0.57,57,0,56,1
2019-20,2020-01-29,Calgary Flames,1,Pacific,Western,58,2,102,0.5686274509803921,57,1,57,1
2019-20,2020-01-30,Calgary Flames,2,Pacific,Western,60,2,104,0.5769230769230769,58,2,57,3
2019-20,2020-02-02,Calgary Flames,0,Pacific,Western,60,2,106,0.5660377358490566,61,-1,59,1
2019-20,2020-02-05,Calgary Flames,0,Pacific,Western,60,2,108,0.5555555555555556,61,-1,60,0
2019-20,2020-02-07,Calgary Flames,0,Pacific,Western,60,2,110,0.5454545454545454,62,-2,60,0
2019-20,2020-02-09,Calgary Flames,2,Pacific,Western,62,2,112,0.5535714285714286,64,-2,61,1
2019-20,2020-02-11,Calgary Flames,2,Pacific,Western,64,2,114,0.5614035087719298,64,0,63,1
2019-20,2020-02-13,Calgary Flames,0,Pacific,Western,64,2,116,0.5517241379310345,64,0,64,0
2019-20,2020-02-14,Calgary Flames,2,Pacific,Western,66,2,118,0.559322033898305,66,0,64,2
2019-20,2020-02-16,Calgary Flames,0,Pacific,Western,66,2,120,0.55,68,-2,66,0
2019-20,2020-02-17,Calgary Flames,2,Pacific,Western,68,2,122,0.5573770491803278,69,-1,68,0
2019-20,2020-02-22,Calgary Flames,0,Pacific,Western,68,2,124,0.5483870967741935,70,-2,68,0
2019-20,2020-02-24,Calgary Flames,2,Pacific,Western,70,2,126,0.5555555555555556,72,-2,70,0
2019-20,2020-02-26,Calgary Flames,2,Pacific,Western,72,2,128,0.5625,74,-2,70,2
2019-20,2020-02-28,Calgary Flames,1,Pacific,Western,73,2,130,0.5615384615384615,74,-1,72,1
2019-20,2020-02-29,Calgary Flames,0,Pacific,Western,73,2,132,0.553030303030303,74,-1,72,1
2019-20,2020-03-01,Calgary Flames,2,Pacific,Western,75,2,134,0.5597014925373134,75,0,72,3
2019-20,2020-03-05,Calgary Flames,2,Pacific,Western,77,2,136,0.5661764705882353,77,0,74,3
2019-20,2020-03-07,Calgary Flames,2,Pacific,Western,79,2,138,0.572463768115942,79,0,76,3
2019-20,2020-03-08,Calgary Flames,0,Pacific,Western,79,2,140,0.5642857142857143,79,0,76,3
2019-20,2019-10-03,Carolina Hurricanes,2,Metropolitan,Eastern,2,2,2,1.0,2,0,0,2
2019-20,2019-10-05,Carolina Hurricanes,2,Metropolitan,Eastern,4,2,4,1.0,4,0,2,2
2019-20,2019-10-06,Carolina Hurricanes,2,Metropolitan,Eastern,6,2,6,1.0,4,2,3,3
2019-20,2019-10-08,Carolina Hurricanes,2,Metropolitan,Eastern,8,2,8,1.0,4,4,3,5
2019-20,2019-10-11,Carolina Hurricanes,2,Metropolitan,Eastern,10,2,10,1.0,4,6,4,6
2019-20,2019-10-12,Carolina Hurricanes,0,Metropolitan,Eastern,10,2,12,0.8333333333333334,4,6,5,5
2019-20,2019-10-16,Carolina Hurricanes,2,Metropolitan,Eastern,12,2,14,0.8571428571428571,10,2,6,6
2019-20,2019-10-17,Carolina Hurricanes,0,Metropolitan,Eastern,12,2,16,0.75,10,2,8,4
2019-20,2019-10-19,Carolina Hurricanes,0,Metropolitan,Eastern,12,2,18,0.6666666666666666,12,0,10,2
2019-20,2019-10-24,Carolina Hurricanes,1,Metropolitan,Eastern,13,2,20,0.65,12,1,12,1
2019-20,2019-10-26,Carolina Hurricanes,2,Metropolitan,Eastern,15,2,22,0.6818181818181818,14,1,12,3
2019-20,2019-10-29,Carolina Hurricanes,2,Metropolitan,Eastern,17,2,24,0.7083333333333334,16,1,14,3
2019-20,2019-11-01,Carolina Hurricanes,2,Metropolitan,Eastern,19,2,26,0.7307692307692307,18,1,16,3
2019-20,2019-11-02,Carolina Hurricanes,0,Metropolitan,Eastern,19,2,28,0.6785714285714286,19,0,17,2
2019-20,2019-11-06,Carolina Hurricanes,0,Metropolitan,Eastern,19,2,30,0.6333333333333333,19,0,18,1
2019-20,2019-11-08,Carolina Hurricanes,0,Metropolitan,Eastern,19,2,32,0.59375,19,0,19,0
2019-20,2019-11-10,Carolina Hurricanes,0,Metropolitan,Eastern,19,2,34,0.5588235294117647,21,-2,20,-1
2019-20,2019-11-12,Carolina Hurricanes,2,Metropolitan,Eastern,21,2,36,0.5833333333333334,22,-1,21,0
2019-20,2019-11-15,Carolina Hurricanes,2,Metropolitan,Eastern,23,2,38,0.6052631578947368,23,0,22,1
2019-20,2019-11-16,Carolina Hurricanes,2,Metropolitan,Eastern,25,2,40,0.625,25,0,22,3
2019-20,2019-11-20,Carolina Hurricanes,2,Metropolitan,Eastern,27,2,42,0.6428571428571429,27,0,24,3
2019-20,2019-11-22,Carolina Hurricanes,0,Metropolitan,Eastern,27,2,44,0.6136363636363636,27,0,26,1
2019-20,2019-11-24,Carolina Hurricanes,2,Metropolitan,Eastern,29,2,46,0.6304347826086957,29,0,27,2
2019-20,2019-11-25,Carolina Hurricanes,2,Metropolitan,Eastern,31,2,48,0.6458333333333334,31,0,27,4
2019-20,2019-11-28,Carolina Hurricanes,0,Metropolitan,Eastern,31,2,50,0.62,32,-1,28,3
2019-20,2019-11-30,Carolina Hurricanes,0,Metropolitan,Eastern,31,2,52,0.5961538461538461,34,-3,29,2
2019-20,2019-12-01,Carolina Hurricanes,2,Metropolitan,Eastern,33,2,54,0.6111111111111112,35,-2,30,3
2019-20,2019-12-04,Carolina Hurricanes,0,Metropolitan,Eastern,33,2,56,0.5892857142857143,37,-4,31,2
2019-20,2019-12-06,Carolina Hurricanes,2,Metropolitan,Eastern,35,2,58,0.603448275862069,37,-2,31,4
2019-20,2019-12-08,Carolina Hurricanes,2,Metropolitan,Eastern,37,2,60,0.6166666666666667,39,-2,32,5
2019-20,2019-12-11,Carolina Hurricanes,2,Metropolitan,Eastern,39,2,62,0.6290322580645161,39,0,35,4
2019-20,2019-12-13,Carolina Hurricanes,1,Metropolitan,Eastern,40,2,64,0.625,40,0,36,4
2019-20,2019-12-14,Carolina Hurricanes,2,Metropolitan,Eastern,42,2,66,0.6363636363636364,42,0,36,6
2019-20,2019-12-18,Carolina Hurricanes,2,Metropolitan,Eastern,44,2,68,0.6470588235294118,44,0,38,6
2019-20,2019-12-20,Carolina Hurricanes,2,Metropolitan,Eastern,46,2,70,0.6571428571428571,46,0,39,7
2019-20,2019-12-22,Carolina Hurricanes,0,Metropolitan,Eastern,46,2,72,0.6388888888888888,46,0,41,5
2019-20,2019-12-23,Carolina Hurricanes,0,Metropolitan,Eastern,46,2,74,0.6216216216216216,46,0,41,5
2019-20,2019-12-28,Carolina Hurricanes,0,Metropolitan,Eastern,46,2,76,0.6052631578947368,48,-2,42,4
2019-20,2019-12-29,Carolina Hurricanes,2,Metropolitan,Eastern,48,2,78,0.6153846153846154,50,-2,43,5
2019-20,2020-01-01,Carolina Hurricanes,2,Metropolitan,Eastern,50,2,80,0.625,52,-2,46,4
2019-20,2020-01-04,Carolina Hurricanes,0,Metropolitan,Eastern,50,2,82,0.6097560975609756,53,-3,48,2
2019-20,2020-01-05,Carolina Hurricanes,0,Metropolitan,Eastern,50,2,84,0.5952380952380952,53,-3,49,1
2019-20,2020-01-08,Carolina Hurricanes,2,Metropolitan,Eastern,52,2,86,0.6046511627906976,57,-5,50,2
2019-20,2020-01-11,Carolina Hurricanes,2,Metropolitan,Eastern,54,2,88,0.6136363636363636,57,-3,52,2
2019-20,2020-01-12,Carolina Hurricanes,2,Metropolitan,Eastern,56,2,90,0.6222222222222222,58,-2,52,4
2019-20,2020-01-14,Carolina Hurricanes,0,Metropolitan,Eastern,56,2,92,0.6086956521739131,58,-2,54,2
2019-20,2020-01-17,Carolina Hurricanes,0,Metropolitan,Eastern,56,2,94,0.5957446808510638,60,-4,56,0
2019-20,2020-01-18,Carolina Hurricanes,1,Metropolitan,Eastern,57,2,96,0.59375,60,-3,56,1
2019-20,2020-01-19,Carolina Hurricanes,2,Metropolitan,Eastern,59,2,98,0.6020408163265306,61,-2,58,1
2019-20,2020-01-22,Carolina Hurricanes,2,Metropolitan,Eastern,61,2,100,0.61,63,-2,60,1
2019-20,2020-02-01,Carolina Hurricanes,0,Metropolitan,Eastern,61,2,102,0.5980392156862745,64,-3,61,0
2019-20,2020-02-02,Carolina Hurricanes,2,Metropolitan,Eastern,63,2,104,0.6057692307692307,65,-2,63,0
2019-20,2020-02-05,Carolina Hurricanes,0,Metropolitan,Eastern,63,2,106,0.5943396226415094,67,-4,64,-1
2019-20,2020-02-07,Carolina Hurricanes,2,Metropolitan,Eastern,65,2,108,0.6018518518518519,68,-3,65,0
2019-20,2020-02-09,Carolina Hurricanes,2,Metropolitan,Eastern,67,2,110,0.6090909090909091,69,-2,67,0
2019-20,2020-02-12,Carolina Hurricanes,0,Metropolitan,Eastern,67,2,112,0.5982142857142857,72,-5,68,-1
2019-20,2020-02-15,Carolina Hurricanes,2,Metropolitan,Eastern,69,2,114,0.6052631578947368,72,-3,69,0
2019-20,2020-02-16,Carolina Hurricanes,1,Metropolitan,Eastern,70,2,116,0.603448275862069,72,-2,70,0
2019-20,2020-02-19,Carolina Hurricanes,2,Metropolitan,Eastern,72,2,118,0.6101694915254238,73,-1,72,0
2019-20,2020-02-22,Carolina Hurricanes,0,Metropolitan,Eastern,72,2,120,0.6,77,-5,72,0
2019-20,2020-02-23,Carolina Hurricanes,2,Metropolitan,Eastern,74,2,122,0.6065573770491803,77,-3,74,0
2019-20,2020-02-26,Carolina Hurricanes,0,Metropolitan,Eastern,74,2,124,0.5967741935483871,79,-5,74,0
2019-20,2020-02-29,Carolina Hurricanes,0,Metropolitan,Eastern,74,2,126,0.5873015873015873,80,-6,76,-2
2019-20,2020-03-01,Carolina Hurricanes,1,Metropolitan,Eastern,75,2,128,0.5859375,80,-5,76,-1
2019-20,2020-03-06,Carolina Hurricanes,0,Metropolitan,Eastern,75,2,130,0.5769230769230769,84,-9,78,-3
2019-20,2020-03-07,Carolina Hurricanes,2,Metropolitan,Eastern,77,2,132,0.5833333333333334,84,-7,79,-2
2019-20,2020-03-08,Carolina Hurricanes,2,Metropolitan,Eastern,79,2,134,0.5895522388059702,84,-5,79,0
2019-20,2020-03-10,Carolina Hurricanes,2,Metropolitan,Eastern,81,2,136,0.5955882352941176,86,-5,81,0
2019-20,2019-10-05,Chicago Blackhawks,0,Central,Western,0,2,2,0.0,2,-2,0,0
2019-20,2019-10-11,Chicago Blackhawks,0,Central,Western,0,2,4,0.0,6,-6,4,-4
2019-20,2019-10-12,Chicago Blackhawks,1,Central,Western,1,2,6,0.16666666666666666,6,-5,4,-3
2019-20,2019-10-15,Chicago Blackhawks,2,Central,Western,3,2,8,0.375,8,-5,5,-2
2019-20,2019-10-19,Chicago Blackhawks,2,Central,Western,5,2,10,0.5,8,-3,8,-3
2019-20,2019-10-20,Chicago Blackhawks,0,Central,Western,5,2,12,0.4166666666666667,9,-4,9,-4
2019-20,2019-10-23,Chicago Blackhawks,1,Central,Western,6,2,14,0.42857142857142855,11,-5,11,-5
2019-20,2019-10-25,Chicago Blackhawks,0,Central,Western,6,2,16,0.375,13,-7,12,-6
2019-20,2019-10-26,Chicago Blackhawks,0,Central,Western,6,2,18,0.3333333333333333,13,-7,13,-7
2019-20,2019-10-27,Chicago Blackhawks,2,Central,Western,8,2,20,0.4,15,-7,13,-5
2019-20,2019-10-30,Chicago Blackhawks,0,Central,Western,8,2,22,0.36363636363636365,15,-7,15,-7
2019-20,2019-11-03,Chicago Blackhawks,1,Central,Western,9,2,24,0.375,18,-9,18,-9
2019-20,2019-11-04,Chicago Blackhawks,2,Central,Western,11,2,26,0.4230769230769231,18,-7,18,-7
2019-20,2019-11-06,Chicago Blackhawks,0,Central,Western,11,2,28,0.39285714285714285,18,-7,19,-8
2019-20,2019-11-08,Chicago Blackhawks,2,Central,Western,13,2,30,0.43333333333333335,20,-7,20,-7
2019-20,2019-11-10,Chicago Blackhawks,1,Central,Western,14,2,32,0.4375,21,-7,21,-7
2019-20,2019-11-11,Chicago Blackhawks,2,Central,Western,16,2,34,0.47058823529411764,21,-5,21,-5
2019-20,2019-11-14,Chicago Blackhawks,2,Central,Western,18,2,36,0.5,21,-3,21,-3
2019-20,2019-11-17,Chicago Blackhawks,2,Central,Western,20,2,38,0.5263157894736842,25,-5,23,-3
2019-20,2019-11-18,Chicago Blackhawks,2,Central,Western,22,2,40,0.55,25,-3,23,-1
2019-20,2019-11-20,Chicago Blackhawks,0,Central,Western,22,2,42,0.5238095238095238,27,-5,24,-2
2019-20,2019-11-22,Chicago Blackhawks,0,Central,Western,22,2,44,0.5,28,-6,26,-4
2019-20,2019-11-24,Chicago Blackhawks,1,Central,Western,23,2,46,0.5,29,-6,26,-3
2019-20,2019-11-27,Chicago Blackhawks,2,Central,Western,25,2,48,0.5208333333333334,29,-4,27,-2
2019-20,2019-11-29,Chicago Blackhawks,0,Central,Western,25,2,50,0.5,32,-7,29,-4
2019-20,2019-12-01,Chicago Blackhawks,0,Central,Western,25,2,52,0.4807692307692308,33,-8,30,-5
2019-20,2019-12-03,Chicago Blackhawks,0,Central,Western,25,2,54,0.46296296296296297,33,-8,31,-6
2019-20,2019-12-06,Chicago Blackhawks,2,Central,Western,27,2,56,0.48214285714285715,36,-9,32,-5
2019-20,2019-12-07,Chicago Blackhawks,2,Central,Western,29,2,58,0.5,36,-7,34,-5
2019-20,2019-12-09,Chicago Blackhawks,1,Central,Western,30,2,60,0.5,38,-8,34,-4
2019-20,2019-12-11,Chicago Blackhawks,0,Central,Western,30,2,62,0.4838709677419355,40,-10,37,-7
2019-20,2019-12-13,Chicago Blackhawks,0,Central,Western,30,2,64,0.46875,40,-10,37,-7
2019-20,2019-12-15,Chicago Blackhawks,0,Central,Western,30,2,66,0.45454545454545453,42,-12,39,-9
2019-20,2019-12-16,Chicago Blackhawks,2,Central,Western,32,2,68,0.47058823529411764,42,-10,40,-8
2019-20,2019-12-19,Chicago Blackhawks,0,Central,Western,32,2,70,0.45714285714285713,42,-10,40,-8
2019-20,2019-12-20,Chicago Blackhawks,2,Central,Western,34,2,72,0.4722222222222222,44,-10,41,-7
2019-20,2019-12-22,Chicago Blackhawks,2,Central,Western,36,2,74,0.4864864864864865,44,-8,41,-5
2019-20,2019-12-24,Chicago Blackhawks,0,Central,Western,36,2,76,0.47368421052631576,44,-8,43,-7
2019-20,2019-12-28,Chicago Blackhawks,2,Central,Western,38,2,78,0.48717948717948717,45,-7,44,-6
2019-20,2019-12-29,Chicago Blackhawks,2,Central,Western,40,2,80,0.5,46,-6,44,-4
2019-20,2020-01-01,Chicago Blackhawks,2,Central,Western,42,2,82,0.5121951219512195,50,-8,46,-4
2019-20,2020-01-03,Chicago Blackhawks,0,Central,Western,42,2,84,0.5,50,-8,47,-5
2019-20,2020-01-06,Chicago Blackhawks,2,Central,Western,44,2,86,0.5116279069767442,52,-8,49,-5
2019-20,2020-01-08,Chicago Blackhawks,0,Central,Western,44,2,88,0.5,52,-8,50,-6
2019-20,2020-01-10,Chicago Blackhawks,0,Central,Western,44,2,90,0.4888888888888889,54,-10,52,-8
2019-20,2020-01-12,Chicago Blackhawks,2,Central,Western,46,2,92,0.5,55,-9,53,-7
2019-20,2020-01-15,Chicago Blackhawks,2,Central,Western,48,2,94,0.5106382978723404,56,-8,54,-6
2019-20,2020-01-16,Chicago Blackhawks,2,Central,Western,50,2,96,0.5208333333333334,56,-6,54,-4
2019-20,2020-01-19,Chicago Blackhawks,2,Central,Western,52,2,98,0.5306122448979592,58,-6,57,-5
2019-20,2020-01-20,Chicago Blackhawks,2,Central,Western,54,2,100,0.54,58,-4,57,-3
2019-20,2020-01-22,Chicago Blackhawks,0,Central,Western,54,2,102,0.5294117647058824,58,-4,57,-3
2019-20,2020-02-02,Chicago Blackhawks,2,Central,Western,56,2,104,0.5384615384615384,62,-6,59,-3
2019-20,2020-02-05,Chicago Blackhawks,1,Central,Western,57,2,106,0.5377358490566038,64,-7,60,-3
2019-20,2020-02-06,Chicago Blackhawks,1,Central,Western,58,2,108,0.5370370370370371,64,-6,60,-2
2019-20,2020-02-10,Chicago Blackhawks,0,Central,Western,58,2,110,0.5272727272727272,67,-9,62,-4
2019-20,2020-02-12,Chicago Blackhawks,0,Central,Western,58,2,112,0.5178571428571429,69,-11,64,-6
2019-20,2020-02-13,Chicago Blackhawks,0,Central,Western,58,2,114,0.5087719298245614,69,-11,64,-6
2019-20,2020-02-16,Chicago Blackhawks,2,Central,Western,60,2,116,0.5172413793103449,72,-12,66,-6
2019-20,2020-02-17,Chicago Blackhawks,0,Central,Western,60,2,118,0.5084745762711864,72,-12,68,-8
2019-20,2020-02-20,Chicago Blackhawks,0,Central,Western,60,2,120,0.5,75,-15,68,-8
2019-20,2020-02-22,Chicago Blackhawks,2,Central,Western,62,2,122,0.5081967213114754,76,-14,68,-6
2019-20,2020-02-23,Chicago Blackhawks,0,Central,Western,62,2,124,0.5,78,-16,69,-7
2019-20,2020-02-26,Chicago Blackhawks,0,Central,Western,62,2,126,0.49206349206349204,79,-17,70,-8
2019-20,2020-02-28,Chicago Blackhawks,2,Central,Western,64,2,128,0.5,80,-16,72,-8
2019-20,2020-02-29,Chicago Blackhawks,2,Central,Western,66,2,130,0.5076923076923077,80,-14,72,-6
2019-20,2020-03-04,Chicago Blackhawks,2,Central,Western,68,2,132,0.5151515151515151,82,-14,74,-6
2019-20,2020-03-06,Chicago Blackhawks,2,Central,Western,70,2,134,0.5223880597014925,82,-12,74,-4
2019-20,2020-03-07,Chicago Blackhawks,0,Central,Western,70,2,136,0.5147058823529411,82,-12,76,-6
2019-20,2020-03-08,Chicago Blackhawks,0,Central,Western,70,2,138,0.5072463768115942,82,-12,76,-6
2019-20,2020-03-12,Chicago Blackhawks,2,Central,Western,72,2,140,0.5142857142857142,82,-10,78,-6
2019-20,2019-10-04,Colorado Avalanche,2,Central,Western,2,2,2,1.0,2,0,0,2
2019-20,2019-10-06,Colorado Avalanche,2,Central,Western,4,2,4,1.0,2,2,2,2
2019-20,2019-10-11,Colorado Avalanche,2,Central,Western,6,2,6,1.0,6,0,4,2
2019-20,2019-10-13,Colorado Avalanche,2,Central,Western,8,2,8,1.0,7,1,5,3
2019-20,2019-10-14,Colorado Avalanche,2,Central,Western,10,2,10,1.0,8,2,5,5
2019-20,2019-10-16,Colorado Avalanche,1,Central,Western,11,2,12,0.9166666666666666,8,3,7,4
2019-20,2019-10-18,Colorado Avalanche,2,Central,Western,13,2,14,0.9285714285714286,8,5,8,5
2019-20,2019-10-19,Colorado Avalanche,2,Central,Western,15,2,16,0.9375,8,7,8,7
2019-20,2019-10-22,Colorado Avalanche,0,Central,Western,15,2,18,0.8333333333333334,10,5,11,4
2019-20,2019-10-25,Colorado Avalanche,2,Central,Western,17,2,20,0.85,13,4,12,5
2019-20,2019-10-27,Colorado Avalanche,0,Central,Western,17,2,22,0.7727272727272727,15,2,13,4
2019-20,2019-10-31,Colorado Avalanche,1,Central,Western,18,2,24,0.75,17,1,15,3
2019-20,2019-11-02,Colorado Avalanche,0,Central,Western,18,2,26,0.6923076923076923,18,0,17,1
2019-20,2019-11-03,Colorado Avalanche,0,Central,Western,18,2,28,0.6428571428571429,18,0,18,0
2019-20,2019-11-06,Colorado Avalanche,0,Central,Western,18,2,30,0.6,18,0,19,-1
2019-20,2019-11-08,Colorado Avalanche,2,Central,Western,20,2,32,0.625,20,0,20,0
2019-20,2019-11-10,Colorado Avalanche,2,Central,Western,22,2,34,0.6470588235294118,21,1,21,1
2019-20,2019-11-13,Colorado Avalanche,2,Central,Western,24,2,36,0.6666666666666666,21,3,21,3
2019-20,2019-11-15,Colorado Avalanche,0,Central,Western,24,2,38,0.631578947368421,23,1,22,2
2019-20,2019-11-17,Colorado Avalanche,2,Central,Western,26,2,40,0.65,25,1,23,3
2019-20,2019-11-20,Colorado Avalanche,2,Central,Western,28,2,42,0.6666666666666666,27,1,24,4
2019-20,2019-11-22,Colorado Avalanche,0,Central,Western,28,2,44,0.6363636363636364,28,0,26,2
2019-20,2019-11-24,Colorado Avalanche,0,Central,Western,28,2,46,0.6086956521739131,29,-1,26,2
2019-20,2019-11-28,Colorado Avalanche,2,Central,Western,30,2,48,0.625,31,-1,28,2
2019-20,2019-11-29,Colorado Avalanche,2,Central,Western,32,2,50,0.64,32,0,29,3
2019-20,2019-12-01,Colorado Avalanche,2,Central,Western,34,2,52,0.6538461538461539,33,1,30,4
2019-20,2019-12-05,Colorado Avalanche,2,Central,Western,36,2,54,0.6666666666666666,35,1,32,4
2019-20,2019-12-06,Colorado Avalanche,2,Central,Western,38,2,56,0.6785714285714286,36,2,32,6
2019-20,2019-12-08,Colorado Avalanche,2,Central,Western,40,2,58,0.6896551724137931,38,2,34,6
2019-20,2019-12-10,Colorado Avalanche,1,Central,Western,41,2,60,0.6833333333333333,38,3,35,6
2019-20,2019-12-12,Colorado Avalanche,2,Central,Western,43,2,62,0.6935483870967742,40,3,37,6
2019-20,2019-12-14,Colorado Avalanche,2,Central,Western,45,2,64,0.703125,41,4,39,6
2019-20,2019-12-17,Colorado Avalanche,0,Central,Western,45,2,66,0.6818181818181818,42,3,40,5
2019-20,2019-12-19,Colorado Avalanche,2,Central,Western,47,2,68,0.6911764705882353,42,5,40,7
2019-20,2019-12-20,Colorado Avalanche,0,Central,Western,47,2,70,0.6714285714285714,44,3,41,6
2019-20,2019-12-22,Colorado Avalanche,0,Central,Western,47,2,72,0.6527777777777778,44,3,41,6
2019-20,2019-12-24,Colorado Avalanche,2,Central,Western,49,2,74,0.6621621621621622,44,5,43,6
2019-20,2019-12-28,Colorado Avalanche,0,Central,Western,49,2,76,0.6447368421052632,45,4,44,5
2019-20,2019-12-29,Colorado Avalanche,1,Central,Western,50,2,78,0.6410256410256411,46,4,44,6
2019-20,2020-01-01,Colorado Avalanche,0,Central,Western,50,2,80,0.625,50,0,46,4
2019-20,2020-01-03,Colorado Avalanche,2,Central,Western,52,2,82,0.6341463414634146,50,2,47,5
2019-20,2020-01-05,Colorado Avalanche,2,Central,Western,54,2,84,0.6428571428571429,52,2,48,6
2019-20,2020-01-07,Colorado Avalanche,0,Central,Western,54,2,86,0.627906976744186,52,2,50,4
2019-20,2020-01-08,Colorado Avalanche,0,Central,Western,54,2,88,0.6136363636363636,52,2,50,4
2019-20,2020-01-11,Colorado Avalanche,1,Central,Western,55,2,90,0.6111111111111112,55,0,52,3
2019-20,2020-01-15,Colorado Avalanche,1,Central,Western,56,2,92,0.6086956521739131,56,0,54,2
2019-20,2020-01-17,Colorado Avalanche,2,Central,Western,58,2,94,0.6170212765957447,58,0,55,3
2019-20,2020-01-18,Colorado Avalanche,2,Central,Western,60,2,96,0.625,58,2,56,4
2019-20,2020-01-20,Colorado Avalanche,2,Central,Western,62,2,98,0.6326530612244898,58,4,57,5
2019-20,2020-02-02,Colorado Avalanche,0,Central,Western,62,2,100,0.62,62,0,59,3
2019-20,2020-02-05,Colorado Avalanche,2,Central,Western,64,2,102,0.6274509803921569,64,0,60,4
2019-20,2020-02-07,Colorado Avalanche,2,Central,Western,66,2,104,0.6346153846153846,65,1,60,6
2019-20,2020-02-09,Colorado Avalanche,2,Central,Western,68,2,106,0.6415094339622641,67,1,61,7
2019-20,2020-02-10,Colorado Avalanche,2,Central,Western,70,2,108,0.6481481481481481,67,3,62,8
2019-20,2020-02-12,Colorado Avalanche,2,Central,Western,72,2,110,0.6545454545454545,69,3,64,8
2019-20,2020-02-14,Colorado Avalanche,0,Central,Western,72,2,112,0.6428571428571429,71,1,64,8
2019-20,2020-02-16,Colorado Avalanche,0,Central,Western,72,2,114,0.631578947368421,72,0,66,6
2019-20,2020-02-18,Colorado Avalanche,1,Central,Western,73,2,116,0.6293103448275862,73,0,68,5
2019-20,2020-02-20,Colorado Avalanche,2,Central,Western,75,2,118,0.635593220338983,75,0,68,7
2019-20,2020-02-22,Colorado Avalanche,2,Central,Western,77,2,120,0.6416666666666667,76,1,68,9
2019-20,2020-02-23,Colorado Avalanche,2,Central,Western,79,2,122,0.6475409836065574,78,1,69,10
2019-20,2020-02-27,Colorado Avalanche,2,Central,Western,81,2,124,0.6532258064516129,80,1,70,11
2019-20,2020-02-29,Colorado Avalanche,2,Central,Western,83,2,126,0.6587301587301587,80,3,72,11
2019-20,2020-03-01,Colorado Avalanche,2,Central,Western,85,2,128,0.6640625,81,4,72,13
2019-20,2020-03-03,Colorado Avalanche,2,Central,Western,87,2,130,0.6692307692307692,81,6,72,15
2019-20,2020-03-05,Colorado Avalanche,1,Central,Western,88,2,132,0.6666666666666666,82,6,74,14
2019-20,2020-03-07,Colorado Avalanche,0,Central,Western,88,2,134,0.6567164179104478,82,6,76,12
2019-20,2020-03-09,Colorado Avalanche,2,Central,Western,90,2,136,0.6617647058823529,82,8,76,14
2019-20,2020-03-10,Colorado Avalanche,0,Central,Western,90,2,138,0.6521739130434783,82,8,78,12
2019-20,2020-03-12,Colorado Avalanche,2,Central,Western,92,2,140,0.6571428571428571,82,10,78,14
2019-20,2019-10-04,Columbus Blue Jackets,0,Metropolitan,Eastern,0,2,2,0.0,2,-2,1,-1
2019-20,2019-10-05,Columbus Blue Jackets,0,Metropolitan,Eastern,0,2,4,0.0,4,-4,2,-2
2019-20,2019-10-07,Columbus Blue Jackets,2,Metropolitan,Eastern,2,2,6,0.3333333333333333,4,-2,3,-1
2019-20,2019-10-11,Columbus Blue Jackets,0,Metropolitan,Eastern,2,2,8,0.25,4,-2,4,-2
2019-20,2019-10-12,Columbus Blue Jackets,2,Metropolitan,Eastern,4,2,10,0.4,4,0,5,-1
2019-20,2019-10-16,Columbus Blue Jackets,2,Metropolitan,Eastern,6,2,12,0.5,10,-4,6,0
2019-20,2019-10-19,Columbus Blue Jackets,1,Metropolitan,Eastern,7,2,14,0.5,12,-5,10,-3
2019-20,2019-10-19,Columbus Blue Jackets,1,Metropolitan,Eastern,8,2,16,0.5,12,-4,10,-2
2019-20,2019-10-21,Columbus Blue Jackets,2,Metropolitan,Eastern,10,2,18,0.5555555555555556,12,-2,10,0
2019-20,2019-10-24,Columbus Blue Jackets,2,Metropolitan,Eastern,12,2,20,0.6,12,0,12,0
2019-20,2019-10-26,Columbus Blue Jackets,0,Metropolitan,Eastern,12,2,22,0.5454545454545454,14,-2,12,0
2019-20,2019-10-30,Columbus Blue Jackets,0,Metropolitan,Eastern,12,2,24,0.5,16,-4,14,-2
2019-20,2019-11-02,Columbus Blue Jackets,1,Metropolitan,Eastern,13,2,26,0.5,19,-6,17,-4
2019-20,2019-11-02,Columbus Blue Jackets,0,Metropolitan,Eastern,13,2,28,0.4642857142857143,19,-6,17,-4
2019-20,2019-11-06,Columbus Blue Jackets,0,Metropolitan,Eastern,13,2,30,0.43333333333333335,19,-6,18,-5
2019-20,2019-11-08,Columbus Blue Jackets,2,Metropolitan,Eastern,15,2,32,0.46875,19,-4,19,-4
2019-20,2019-11-10,Columbus Blue Jackets,0,Metropolitan,Eastern,15,2,34,0.4411764705882353,21,-6,20,-5
2019-20,2019-11-13,Columbus Blue Jackets,1,Metropolitan,Eastern,16,2,36,0.4444444444444444,22,-6,22,-6
2019-20,2019-11-16,Columbus Blue Jackets,2,Metropolitan,Eastern,18,2,38,0.47368421052631576,25,-7,22,-4
2019-20,2019-11-20,Columbus Blue Jackets,2,Metropolitan,Eastern,20,2,40,0.5,27,-7,24,-4
2019-20,2019-11-22,Columbus Blue Jackets,2,Metropolitan,Eastern,22,2,42,0.5238095238095238,27,-5,26,-4
2019-20,2019-11-24,Columbus Blue Jackets,0,Metropolitan,Eastern,22,2,44,0.5,29,-7,27,-5
2019-20,2019-11-26,Columbus Blue Jackets,2,Metropolitan,Eastern,24,2,46,0.5217391304347826,31,-7,27,-3
2019-20,2019-11-28,Columbus Blue Jackets,0,Metropolitan,Eastern,24,2,48,0.5,32,-8,28,-4
2019-20,2019-11-30,Columbus Blue Jackets,2,Metropolitan,Eastern,26,2,50,0.52,34,-8,29,-3
2019-20,2019-12-01,Columbus Blue Jackets,0,Metropolitan,Eastern,26,2,52,0.5,35,-9,30,-4
2019-20,2019-12-04,Columbus Blue Jackets,0,Metropolitan,Eastern,26,2,54,0.48148148148148145,37,-11,31,-5
2019-20,2019-12-06,Columbus Blue Jackets,0,Metropolitan,Eastern,26,2,56,0.4642857142857143,37,-11,31,-5
2019-20,2019-12-08,Columbus Blue Jackets,0,Metropolitan,Eastern,26,2,58,0.4482758620689655,39,-13,32,-6
2019-20,2019-12-10,Columbus Blue Jackets,2,Metropolitan,Eastern,28,2,60,0.4666666666666667,39,-11,34,-6
2019-20,2019-12-13,Columbus Blue Jackets,1,Metropolitan,Eastern,29,2,62,0.46774193548387094,40,-11,36,-7
2019-20,2019-12-14,Columbus Blue Jackets,1,Metropolitan,Eastern,30,2,64,0.46875,42,-12,36,-6
2019-20,2019-12-17,Columbus Blue Jackets,2,Metropolitan,Eastern,32,2,66,0.48484848484848486,42,-10,37,-5
2019-20,2019-12-18,Columbus Blue Jackets,2,Metropolitan,Eastern,34,2,68,0.5,44,-10,38,-4
2019-20,2019-12-20,Columbus Blue Jackets,2,Metropolitan,Eastern,36,2,70,0.5142857142857142,46,-10,39,-3
2019-20,2019-12-22,Columbus Blue Jackets,2,Metropolitan,Eastern,38,2,72,0.5277777777777778,46,-8,41,-3
2019-20,2019-12-24,Columbus Blue Jackets,2,Metropolitan,Eastern,40,2,74,0.5405405405405406,47,-7,42,-2
2019-20,2019-12-28,Columbus Blue Jackets,1,Metropolitan,Eastern,41,2,76,0.5394736842105263,48,-7,42,-1
2019-20,2019-12-29,Columbus Blue Jackets,1,Metropolitan,Eastern,42,2,78,0.5384615384615384,50,-8,43,-1
2019-20,2020-01-01,Columbus Blue Jackets,2,Metropolitan,Eastern,44,2,80,0.55,52,-8,46,-2
2019-20,2020-01-03,Columbus Blue Jackets,2,Metropolitan,Eastern,46,2,82,0.5609756097560976,53,-7,48,-2
2019-20,2020-01-04,Columbus Blue Jackets,0,Metropolitan,Eastern,46,2,84,0.5476190476190477,53,-7,48,-2
2019-20,2020-01-07,Columbus Blue Jackets,2,Metropolitan,Eastern,48,2,86,0.5581395348837209,55,-7,49,-1
2019-20,2020-01-08,Columbus Blue Jackets,2,Metropolitan,Eastern,50,2,88,0.5681818181818182,57,-7,50,0
2019-20,2020-01-10,Columbus Blue Jackets,0,Metropolitan,Eastern,50,2,90,0.5555555555555556,57,-7,52,-2
2019-20,2020-01-12,Columbus Blue Jackets,2,Metropolitan,Eastern,52,2,92,0.5652173913043478,58,-6,52,0
2019-20,2020-01-15,Columbus Blue Jackets,2,Metropolitan,Eastern,54,2,94,0.574468085106383,60,-6,54,0
2019-20,2020-01-17,Columbus Blue Jackets,2,Metropolitan,Eastern,56,2,96,0.5833333333333334,60,-4,56,0
2019-20,2020-01-19,Columbus Blue Jackets,2,Metropolitan,Eastern,58,2,98,0.5918367346938775,61,-3,58,0
2019-20,2020-01-20,Columbus Blue Jackets,2,Metropolitan,Eastern,60,2,100,0.6,61,-1,58,2
2019-20,2020-01-23,Columbus Blue Jackets,2,Metropolitan,Eastern,62,2,102,0.6078431372549019,63,-1,61,1
2019-20,2020-02-01,Columbus Blue Jackets,1,Metropolitan,Eastern,63,2,104,0.6057692307692307,64,-1,61,2
2019-20,2020-02-02,Columbus Blue Jackets,2,Metropolitan,Eastern,65,2,106,0.6132075471698113,65,0,63,2
2019-20,2020-02-05,Columbus Blue Jackets,2,Metropolitan,Eastern,67,2,108,0.6203703703703703,67,0,64,3
2019-20,2020-02-08,Columbus Blue Jackets,2,Metropolitan,Eastern,69,2,110,0.6272727272727273,69,0,65,4
2019-20,2020-02-09,Columbus Blue Jackets,0,Metropolitan,Eastern,69,2,112,0.6160714285714286,69,0,67,2
2019-20,2020-02-11,Columbus Blue Jackets,1,Metropolitan,Eastern,70,2,114,0.6140350877192983,70,0,67,3
2019-20,2020-02-14,Columbus Blue Jackets,1,Metropolitan,Eastern,71,2,116,0.6120689655172413,72,-1,68,3
2019-20,2020-02-15,Columbus Blue Jackets,0,Metropolitan,Eastern,71,2,118,0.6016949152542372,72,-1,69,2
2019-20,2020-02-16,Columbus Blue Jackets,1,Metropolitan,Eastern,72,2,120,0.6,72,0,70,2
2019-20,2020-02-19,Columbus Blue Jackets,0,Metropolitan,Eastern,72,2,122,0.5901639344262295,73,-1,72,0
2019-20,2020-02-21,Columbus Blue Jackets,1,Metropolitan,Eastern,73,2,124,0.5887096774193549,75,-2,72,1
2019-20,2020-02-23,Columbus Blue Jackets,1,Metropolitan,Eastern,74,2,126,0.5873015873015873,77,-3,74,0
2019-20,2020-02-25,Columbus Blue Jackets,2,Metropolitan,Eastern,76,2,128,0.59375,77,-1,74,2
2019-20,2020-02-26,Columbus Blue Jackets,0,Metropolitan,Eastern,76,2,130,0.5846153846153846,79,-3,74,2
2019-20,2020-02-29,Columbus Blue Jackets,0,Metropolitan,Eastern,76,2,132,0.5757575757575758,80,-4,76,0
2019-20,2020-03-02,Columbus Blue Jackets,2,Metropolitan,Eastern,78,2,134,0.582089552238806,80,-2,78,0
2019-20,2020-03-05,Columbus Blue Jackets,1,Metropolitan,Eastern,79,2,136,0.5808823529411765,82,-3,78,1
2019-20,2020-03-08,Columbus Blue Jackets,0,Metropolitan,Eastern,79,2,138,0.572463768115942,84,-5,79,0
2019-20,2020-03-09,Columbus Blue Jackets,2,Metropolitan,Eastern,81,2,140,0.5785714285714286,84,-3,79,2
2019-20,2019-10-04,Dallas Stars,0,Central,Western,0,2,2,0.0,2,-2,0,0
2019-20,2019-10-06,Dallas Stars,0,Central,Western,0,2,4,0.0,2,-2,2,-2
2019-20,2019-10-06,Dallas Stars,0,Central,Western,0,2,6,0.0,2,-2,2,-2
2019-20,2019-10-08,Dallas Stars,2,Central,Western,2,2,8,0.25,4,-2,2,0
2019-20,2019-10-11,Dallas Stars,1,Central,Western,3,2,10,0.3,6,-3,4,-1
2019-20,2019-10-13,Dallas Stars,0,Central,Western,3,2,12,0.25,7,-4,5,-2
2019-20,2019-10-14,Dallas Stars,0,Central,Western,3,2,14,0.21428571428571427,8,-5,5,-2
2019-20,2019-10-16,Dallas Stars,0,Central,Western,3,2,16,0.1875,8,-5,7,-4
2019-20,2019-10-18,Dallas Stars,0,Central,Western,3,2,18,0.16666666666666666,8,-5,8,-5
2019-20,2019-10-19,Dallas Stars,2,Central,Western,5,2,20,0.25,8,-3,8,-3
2019-20,2019-10-22,Dallas Stars,2,Central,Western,7,2,22,0.3181818181818182,10,-3,11,-4
2019-20,2019-10-25,Dallas Stars,2,Central,Western,9,2,24,0.375,13,-4,12,-3
2019-20,2019-10-27,Dallas Stars,0,Central,Western,9,2,26,0.34615384615384615,15,-6,13,-4
2019-20,2019-10-30,Dallas Stars,2,Central,Western,11,2,28,0.39285714285714285,15,-4,15,-4
2019-20,2019-11-02,Dallas Stars,2,Central,Western,13,2,30,0.43333333333333335,18,-5,17,-4
2019-20,2019-11-02,Dallas Stars,2,Central,Western,15,2,32,0.46875,18,-3,17,-2
2019-20,2019-11-06,Dallas Stars,2,Central,Western,17,2,34,0.5,18,-1,19,-2
2019-20,2019-11-10,Dallas Stars,1,Central,Western,18,2,36,0.5,21,-3,21,-3
2019-20,2019-11-14,Dallas Stars,2,Central,Western,20,2,38,0.5263157894736842,21,-1,21,-1
2019-20,2019-11-15,Dallas Stars,2,Central,Western,22,2,40,0.55,23,-1,22,0
2019-20,2019-11-16,Dallas Stars,2,Central,Western,24,2,42,0.5714285714285714,24,0,23,1
2019-20,2019-11-20,Dallas Stars,2,Central,Western,26,2,44,0.5909090909090909,27,-1,24,2
2019-20,2019-11-22,Dallas Stars,2,Central,Western,28,2,46,0.6086956521739131,28,0,26,2
2019-20,2019-11-24,Dallas Stars,2,Central,Western,30,2,48,0.625,29,1,26,4
2019-20,2019-11-26,Dallas Stars,2,Central,Western,32,2,50,0.64,29,3,27,5
2019-20,2019-11-27,Dallas Stars,0,Central,Western,32,2,52,0.6153846153846154,29,3,27,5
2019-20,2019-11-30,Dallas Stars,0,Central,Western,32,2,54,0.5925925925925926,32,0,29,3
2019-20,2019-12-01,Dallas Stars,1,Central,Western,33,2,56,0.5892857142857143,33,0,30,3
2019-20,2019-12-04,Dallas Stars,0,Central,Western,33,2,58,0.5689655172413793,34,-1,32,1
2019-20,2019-12-06,Dallas Stars,2,Central,Western,35,2,60,0.5833333333333334,36,-1,32,3
2019-20,2019-12-08,Dallas Stars,2,Central,Western,37,2,62,0.5967741935483871,38,-1,34,3
2019-20,2019-12-11,Dallas Stars,2,Central,Western,39,2,64,0.609375,40,-1,37,2
2019-20,2019-12-14,Dallas Stars,2,Central,Western,41,2,66,0.6212121212121212,41,0,39,2
2019-20,2019-12-14,Dallas Stars,1,Central,Western,42,2,68,0.6176470588235294,41,1,39,3
2019-20,2019-12-17,Dallas Stars,0,Central,Western,42,2,70,0.6,42,0,40,2
2019-20,2019-12-20,Dallas Stars,2,Central,Western,44,2,72,0.6111111111111112,44,0,41,3
2019-20,2019-12-21,Dallas Stars,0,Central,Western,44,2,74,0.5945945945945946,44,0,41,3
2019-20,2019-12-23,Dallas Stars,0,Central,Western,44,2,76,0.5789473684210527,44,0,43,1
2019-20,2019-12-29,Dallas Stars,2,Central,Western,46,2,78,0.5897435897435898,46,0,44,2
2019-20,2019-12-30,Dallas Stars,2,Central,Western,48,2,80,0.6,48,0,45,3
2019-20,2020-01-01,Dallas Stars,2,Central,Western,50,2,82,0.6097560975609756,50,0,46,4
2019-20,2020-01-04,Dallas Stars,2,Central,Western,52,2,84,0.6190476190476191,52,0,48,4
2019-20,2020-01-09,Dallas Stars,2,Central,Western,54,2,86,0.627906976744186,54,0,51,3
2019-20,2020-01-10,Dallas Stars,2,Central,Western,56,2,88,0.6363636363636364,54,2,52,4
2019-20,2020-01-12,Dallas Stars,0,Central,Western,56,2,90,0.6222222222222222,55,1,53,3
2019-20,2020-01-15,Dallas Stars,2,Central,Western,58,2,92,0.6304347826086957,56,2,54,4
2019-20,2020-01-17,Dallas Stars,0,Central,Western,58,2,94,0.6170212765957447,58,0,55,3
2019-20,2020-01-19,Dallas Stars,0,Central,Western,58,2,96,0.6041666666666666,58,0,57,1
2019-20,2020-01-28,Dallas Stars,2,Central,Western,60,2,98,0.6122448979591837,60,0,57,3
2019-20,2020-01-30,Dallas Stars,0,Central,Western,60,2,100,0.6,60,0,57,3
2019-20,2020-02-02,Dallas Stars,2,Central,Western,62,2,102,0.6078431372549019,62,0,59,3
2019-20,2020-02-04,Dallas Stars,2,Central,Western,64,2,104,0.6153846153846154,62,2,59,5
2019-20,2020-02-05,Dallas Stars,1,Central,Western,65,2,106,0.6132075471698113,64,1,60,5
2019-20,2020-02-08,Dallas Stars,0,Central,Western,65,2,108,0.6018518518518519,65,0,61,4
2019-20,2020-02-09,Dallas Stars,2,Central,Western,67,2,110,0.6090909090909091,67,0,61,6
2019-20,2020-02-12,Dallas Stars,2,Central,Western,69,2,112,0.6160714285714286,69,0,64,5
2019-20,2020-02-14,Dallas Stars,2,Central,Western,71,2,114,0.6228070175438597,71,0,64,7
2019-20,2020-02-16,Dallas Stars,2,Central,Western,73,2,116,0.6293103448275862,72,1,66,7
2019-20,2020-02-16,Dallas Stars,1,Central,Western,74,2,118,0.6271186440677966,72,2,66,8
2019-20,2020-02-20,Dallas Stars,2,Central,Western,76,2,120,0.6333333333333333,75,1,68,8
2019-20,2020-02-22,Dallas Stars,0,Central,Western,76,2,122,0.6229508196721312,76,0,68,8
2019-20,2020-02-23,Dallas Stars,2,Central,Western,78,2,124,0.6290322580645161,78,0,69,9
2019-20,2020-02-26,Dallas Stars,2,Central,Western,80,2,126,0.6349206349206349,79,1,70,10
2019-20,2020-02-28,Dallas Stars,0,Central,Western,80,2,128,0.625,80,0,72,8
2019-20,2020-03-01,Dallas Stars,1,Central,Western,81,2,130,0.6230769230769231,81,0,72,9
2019-20,2020-03-04,Dallas Stars,1,Central,Western,82,2,132,0.6212121212121212,82,0,74,8
2019-20,2020-03-06,Dallas Stars,0,Central,Western,82,2,134,0.6119402985074627,82,0,74,8
2019-20,2020-03-07,Dallas Stars,0,Central,Western,82,2,136,0.6029411764705882,82,0,76,6
2019-20,2020-03-11,Dallas Stars,0,Central,Western,82,2,138,0.5942028985507246,82,0,78,4
2019-20,2019-10-06,Detroit Red Wings,2,Atlantic,Eastern,2,2,2,1.0,4,-2,3,-1
2019-20,2019-10-06,Detroit Red Wings,2,Atlantic,Eastern,4,2,4,1.0,4,0,3,1
2019-20,2019-10-08,Detroit Red Wings,0,Atlantic,Eastern,4,2,6,0.6666666666666666,4,0,3,1
2019-20,2019-10-10,Detroit Red Wings,2,Atlantic,Eastern,6,2,8,0.75,6,0,4,2
2019-20,2019-10-12,Detroit Red Wings,0,Atlantic,Eastern,6,2,10,0.6,7,-1,5,1
2019-20,2019-10-16,Detroit Red Wings,0,Atlantic,Eastern,6,2,12,0.5,9,-3,6,0
2019-20,2019-10-18,Detroit Red Wings,0,Atlantic,Eastern,6,2,14,0.42857142857142855,9,-3,8,-2
2019-20,2019-10-19,Detroit Red Wings,0,Atlantic,Eastern,6,2,16,0.375,11,-5,10,-4
2019-20,2019-10-22,Detroit Red Wings,0,Atlantic,Eastern,6,2,18,0.3333333333333333,12,-6,10,-4
2019-20,2019-10-23,Detroit Red Wings,0,Atlantic,Eastern,6,2,20,0.3,12,-6,10,-4
2019-20,2019-10-25,Detroit Red Wings,0,Atlantic,Eastern,6,2,22,0.2727272727272727,14,-8,12,-6
2019-20,2019-10-27,Detroit Red Wings,1,Atlantic,Eastern,7,2,24,0.2916666666666667,14,-7,14,-7
2019-20,2019-10-29,Detroit Red Wings,2,Atlantic,Eastern,9,2,26,0.34615384615384615,15,-6,14,-5
2019-20,2019-11-01,Detroit Red Wings,0,Atlantic,Eastern,9,2,28,0.32142857142857145,16,-7,16,-7
2019-20,2019-11-02,Detroit Red Wings,0,Atlantic,Eastern,9,2,30,0.3,18,-9,17,-8
2019-20,2019-11-05,Detroit Red Wings,0,Atlantic,Eastern,9,2,32,0.28125,18,-9,17,-8
2019-20,2019-11-07,Detroit Red Wings,0,Atlantic,Eastern,9,2,34,0.2647058823529412,19,-10,18,-9
2019-20,2019-11-09,Detroit Red Wings,2,Atlantic,Eastern,11,2,36,0.3055555555555556,20,-9,19,-8
2019-20,2019-11-10,Detroit Red Wings,2,Atlantic,Eastern,13,2,38,0.34210526315789475,21,-8,20,-7
2019-20,2019-11-13,Detroit Red Wings,2,Atlantic,Eastern,15,2,40,0.375,23,-8,22,-7
2019-20,2019-11-15,Detroit Red Wings,1,Atlantic,Eastern,16,2,42,0.38095238095238093,23,-7,22,-6
2019-20,2019-11-17,Detroit Red Wings,1,Atlantic,Eastern,17,2,44,0.38636363636363635,25,-8,24,-7
2019-20,2019-11-20,Detroit Red Wings,0,Atlantic,Eastern,17,2,46,0.3695652173913043,26,-9,24,-7
2019-20,2019-11-22,Detroit Red Wings,0,Atlantic,Eastern,17,2,48,0.3541666666666667,27,-10,26,-9
2019-20,2019-11-24,Detroit Red Wings,0,Atlantic,Eastern,17,2,50,0.34,27,-10,27,-10
2019-20,2019-11-25,Detroit Red Wings,0,Atlantic,Eastern,17,2,52,0.3269230769230769,27,-10,27,-10
2019-20,2019-11-28,Detroit Red Wings,0,Atlantic,Eastern,17,2,54,0.3148148148148148,28,-11,28,-11
2019-20,2019-11-29,Detroit Red Wings,0,Atlantic,Eastern,17,2,56,0.30357142857142855,28,-11,28,-11
2019-20,2019-12-01,Detroit Red Wings,0,Atlantic,Eastern,17,2,58,0.29310344827586204,30,-13,30,-13
2019-20,2019-12-03,Detroit Red Wings,0,Atlantic,Eastern,17,2,60,0.2833333333333333,31,-14,31,-14
2019-20,2019-12-08,Detroit Red Wings,0,Atlantic,Eastern,17,2,62,0.27419354838709675,32,-15,32,-15
2019-20,2019-12-11,Detroit Red Wings,0,Atlantic,Eastern,17,2,64,0.265625,35,-18,35,-18
2019-20,2019-12-13,Detroit Red Wings,2,Atlantic,Eastern,19,2,66,0.2878787878787879,36,-17,36,-17
2019-20,2019-12-15,Detroit Red Wings,2,Atlantic,Eastern,21,2,68,0.3088235294117647,36,-15,36,-15
2019-20,2019-12-16,Detroit Red Wings,0,Atlantic,Eastern,21,2,70,0.3,36,-15,36,-15
2019-20,2019-12-18,Detroit Red Wings,0,Atlantic,Eastern,21,2,72,0.2916666666666667,38,-17,38,-17
2019-20,2019-12-22,Detroit Red Wings,0,Atlantic,Eastern,21,2,74,0.28378378378378377,41,-20,41,-20
2019-20,2019-12-23,Detroit Red Wings,0,Atlantic,Eastern,21,2,76,0.27631578947368424,41,-20,41,-20
2019-20,2019-12-29,Detroit Red Wings,0,Atlantic,Eastern,21,2,78,0.2692307692307692,43,-22,43,-22
2019-20,2019-12-30,Detroit Red Wings,0,Atlantic,Eastern,21,2,80,0.2625,45,-24,45,-24
2019-20,2020-01-01,Detroit Red Wings,2,Atlantic,Eastern,23,2,82,0.2804878048780488,46,-23,46,-23
2019-20,2020-01-04,Detroit Red Wings,0,Atlantic,Eastern,23,2,84,0.27380952380952384,48,-25,48,-25
2019-20,2020-01-06,Detroit Red Wings,0,Atlantic,Eastern,23,2,86,0.26744186046511625,52,-29,49,-26
2019-20,2020-01-08,Detroit Red Wings,2,Atlantic,Eastern,25,2,88,0.2840909090909091,53,-28,50,-25
2019-20,2020-01-11,Detroit Red Wings,2,Atlantic,Eastern,27,2,90,0.3,54,-27,52,-25
2019-20,2020-01-12,Detroit Red Wings,0,Atlantic,Eastern,27,2,92,0.29347826086956524,54,-27,52,-25
2019-20,2020-01-15,Detroit Red Wings,0,Atlantic,Eastern,27,2,94,0.2872340425531915,56,-29,54,-27
2019-20,2020-01-18,Detroit Red Wings,1,Atlantic,Eastern,28,2,96,0.2916666666666667,57,-29,56,-28
2019-20,2020-01-19,Detroit Red Wings,0,Atlantic,Eastern,28,2,98,0.2857142857142857,57,-29,58,-30
2019-20,2020-01-20,Detroit Red Wings,0,Atlantic,Eastern,28,2,100,0.28,57,-29,58,-30
2019-20,2020-01-23,Detroit Red Wings,0,Atlantic,Eastern,28,2,102,0.27450980392156865,61,-33,61,-33
2019-20,2020-02-01,Detroit Red Wings,0,Atlantic,Eastern,28,2,104,0.2692307692307692,61,-33,61,-33
2019-20,2020-02-02,Detroit Red Wings,0,Atlantic,Eastern,28,2,106,0.2641509433962264,63,-35,63,-35
2019-20,2020-02-04,Detroit Red Wings,0,Atlantic,Eastern,28,2,108,0.25925925925925924,63,-35,63,-35
2019-20,2020-02-07,Detroit Red Wings,2,Atlantic,Eastern,30,2,110,0.2727272727272727,64,-34,65,-35
2019-20,2020-02-08,Detroit Red Wings,0,Atlantic,Eastern,30,2,112,0.26785714285714285,65,-35,65,-35
2019-20,2020-02-09,Detroit Red Wings,2,Atlantic,Eastern,32,2,114,0.2807017543859649,66,-34,67,-35
2019-20,2020-02-12,Detroit Red Wings,0,Atlantic,Eastern,32,2,116,0.27586206896551724,68,-36,68,-36
2019-20,2020-02-14,Detroit Red Wings,0,Atlantic,Eastern,32,2,118,0.2711864406779661,68,-36,68,-36
2019-20,2020-02-15,Detroit Red Wings,0,Atlantic,Eastern,32,2,120,0.26666666666666666,68,-36,69,-37
2019-20,2020-02-16,Detroit Red Wings,0,Atlantic,Eastern,32,2,122,0.26229508196721313,70,-38,70,-38
2019-20,2020-02-19,Detroit Red Wings,2,Atlantic,Eastern,34,2,124,0.27419354838709675,70,-36,72,-38
2019-20,2020-02-22,Detroit Red Wings,0,Atlantic,Eastern,34,2,126,0.2698412698412698,72,-38,72,-38
2019-20,2020-02-24,Detroit Red Wings,0,Atlantic,Eastern,34,2,128,0.265625,72,-38,74,-40
2019-20,2020-02-26,Detroit Red Wings,0,Atlantic,Eastern,34,2,130,0.26153846153846155,74,-40,74,-40
2019-20,2020-02-28,Detroit Red Wings,0,Atlantic,Eastern,34,2,132,0.25757575757575757,76,-42,76,-42
2019-20,2020-03-01,Detroit Red Wings,1,Atlantic,Eastern,35,2,134,0.26119402985074625,78,-43,76,-41
2019-20,2020-03-03,Detroit Red Wings,0,Atlantic,Eastern,35,2,136,0.25735294117647056,78,-43,78,-43
2019-20,2020-03-07,Detroit Red Wings,2,Atlantic,Eastern,37,2,138,0.26811594202898553,79,-42,79,-42
2019-20,2020-03-08,Detroit Red Wings,2,Atlantic,Eastern,39,2,140,0.2785714285714286,79,-40,79,-40
2019-20,2020-03-10,Detroit Red Wings,0,Atlantic,Eastern,39,2,142,0.2746478873239437,81,-42,81,-42
2019-20,2019-10-03,Edmonton Oilers,2,Pacific,Western,2,2,2,1.0,0,2,0,2
2019-20,2019-10-06,Edmonton Oilers,2,Pacific,Western,4,2,4,1.0,4,0,2,2
2019-20,2019-10-08,Edmonton Oilers,2,Pacific,Western,6,2,6,1.0,4,2,2,4
2019-20,2019-10-10,Edmonton Oilers,2,Pacific,Western,8,2,8,1.0,4,4,3,5
2019-20,2019-10-12,Edmonton Oilers,2,Pacific,Western,10,2,10,1.0,5,5,4,6
2019-20,2019-10-15,Edmonton Oilers,0,Pacific,Western,10,2,12,0.8333333333333334,8,2,5,5
2019-20,2019-10-17,Edmonton Oilers,2,Pacific,Western,12,2,14,0.8571428571428571,8,4,7,5
2019-20,2019-10-19,Edmonton Oilers,2,Pacific,Western,14,2,16,0.875,12,2,8,6
2019-20,2019-10-20,Edmonton Oilers,1,Pacific,Western,15,2,18,0.8333333333333334,12,3,9,6
2019-20,2019-10-23,Edmonton Oilers,0,Pacific,Western,15,2,20,0.75,12,3,11,4
2019-20,2019-10-25,Edmonton Oilers,2,Pacific,Western,17,2,22,0.7727272727272727,13,4,12,5
2019-20,2019-10-27,Edmonton Oilers,0,Pacific,Western,17,2,24,0.7083333333333334,14,3,13,4
2019-20,2019-10-29,Edmonton Oilers,0,Pacific,Western,17,2,26,0.6538461538461539,15,2,14,3
2019-20,2019-10-30,Edmonton Oilers,2,Pacific,Western,19,2,28,0.6785714285714286,16,3,15,4
2019-20,2019-11-02,Edmonton Oilers,2,Pacific,Western,21,2,30,0.7,18,3,17,4
2019-20,2019-11-05,Edmonton Oilers,1,Pacific,Western,22,2,32,0.6875,19,3,18,4
2019-20,2019-11-07,Edmonton Oilers,0,Pacific,Western,22,2,34,0.6470588235294118,20,2,19,3
2019-20,2019-11-09,Edmonton Oilers,2,Pacific,Western,24,2,36,0.6666666666666666,21,3,20,4
2019-20,2019-11-11,Edmonton Oilers,2,Pacific,Western,26,2,38,0.6842105263157895,21,5,21,5
2019-20,2019-11-13,Edmonton Oilers,0,Pacific,Western,26,2,40,0.65,23,3,21,5
2019-20,2019-11-15,Edmonton Oilers,2,Pacific,Western,28,2,42,0.6666666666666666,23,5,22,6
2019-20,2019-11-16,Edmonton Oilers,1,Pacific,Western,29,2,44,0.6590909090909091,23,6,23,6
2019-20,2019-11-20,Edmonton Oilers,2,Pacific,Western,31,2,46,0.6739130434782609,25,6,24,7
2019-20,2019-11-22,Edmonton Oilers,0,Pacific,Western,31,2,48,0.6458333333333334,26,5,26,5
2019-20,2019-11-24,Edmonton Oilers,2,Pacific,Western,33,2,50,0.66,28,5,26,7
2019-20,2019-11-25,Edmonton Oilers,2,Pacific,Western,35,2,52,0.6730769230769231,28,7,26,9
2019-20,2019-11-28,Edmonton Oilers,0,Pacific,Western,35,2,54,0.6481481481481481,28,7,28,7
2019-20,2019-12-01,Edmonton Oilers,0,Pacific,Western,35,2,56,0.625,31,4,30,5
2019-20,2019-12-02,Edmonton Oilers,2,Pacific,Western,37,2,58,0.6379310344827587,31,6,30,7
2019-20,2019-12-05,Edmonton Oilers,0,Pacific,Western,37,2,60,0.6166666666666667,34,3,32,5
2019-20,2019-12-07,Edmonton Oilers,2,Pacific,Western,39,2,62,0.6290322580645161,35,4,34,5
2019-20,2019-12-09,Edmonton Oilers,1,Pacific,Western,40,2,64,0.625,35,5,34,6
2019-20,2019-12-11,Edmonton Oilers,0,Pacific,Western,40,2,66,0.6060606060606061,38,2,37,3
2019-20,2019-12-13,Edmonton Oilers,0,Pacific,Western,40,2,68,0.5882352941176471,40,0,37,3
2019-20,2019-12-15,Edmonton Oilers,0,Pacific,Western,40,2,70,0.5714285714285714,40,0,39,1
2019-20,2019-12-17,Edmonton Oilers,2,Pacific,Western,42,2,72,0.5833333333333334,41,1,40,2
2019-20,2019-12-19,Edmonton Oilers,0,Pacific,Western,42,2,74,0.5675675675675675,42,0,40,2
2019-20,2019-12-21,Edmonton Oilers,0,Pacific,Western,42,2,76,0.5526315789473685,42,0,41,1
2019-20,2019-12-22,Edmonton Oilers,2,Pacific,Western,44,2,78,0.5641025641025641,44,0,41,3
2019-20,2019-12-24,Edmonton Oilers,0,Pacific,Western,44,2,80,0.55,44,0,43,1
2019-20,2019-12-28,Edmonton Oilers,0,Pacific,Western,44,2,82,0.5365853658536586,45,-1,44,0
2019-20,2020-01-01,Edmonton Oilers,2,Pacific,Western,46,2,84,0.5476190476190477,46,0,46,0
2019-20,2020-01-03,Edmonton Oilers,1,Pacific,Western,47,2,86,0.5465116279069767,48,-1,47,0
2019-20,2020-01-04,Edmonton Oilers,2,Pacific,Western,49,2,88,0.5568181818181818,49,0,48,1
2019-20,2020-01-07,Edmonton Oilers,2,Pacific,Western,51,2,90,0.5666666666666667,51,0,50,1
2019-20,2020-01-10,Edmonton Oilers,2,Pacific,Western,53,2,92,0.5760869565217391,53,0,52,1
2019-20,2020-01-12,Edmonton Oilers,0,Pacific,Western,53,2,94,0.5638297872340425,54,-1,53,0
2019-20,2020-01-15,Edmonton Oilers,2,Pacific,Western,55,2,96,0.5729166666666666,55,0,54,1
2019-20,2020-01-18,Edmonton Oilers,2,Pacific,Western,57,2,98,0.5816326530612245,57,0,56,1
2019-20,2020-01-30,Edmonton Oilers,1,Pacific,Western,58,2,100,0.58,58,0,57,1
2019-20,2020-02-01,Edmonton Oilers,2,Pacific,Western,60,2,102,0.5882352941176471,60,0,58,2
2019-20,2020-02-02,Edmonton Oilers,2,Pacific,Western,62,2,104,0.5961538461538461,61,1,59,3
2019-20,2020-02-05,Edmonton Oilers,0,Pacific,Western,62,2,106,0.5849056603773585,61,1,60,2
2019-20,2020-02-07,Edmonton Oilers,0,Pacific,Western,62,2,108,0.5740740740740741,62,0,60,2
2019-20,2020-02-09,Edmonton Oilers,2,Pacific,Western,64,2,110,0.5818181818181818,64,0,61,3
2019-20,2020-02-12,Edmonton Oilers,2,Pacific,Western,66,2,112,0.5892857142857143,64,2,64,2
2019-20,2020-02-14,Edmonton Oilers,0,Pacific,Western,66,2,114,0.5789473684210527,66,0,64,2
2019-20,2020-02-15,Edmonton Oilers,2,Pacific,Western,68,2,116,0.5862068965517241,66,2,64,4
2019-20,2020-02-16,Edmonton Oilers,2,Pacific,Western,70,2,118,0.5932203389830508,68,2,66,4
2019-20,2020-02-20,Edmonton Oilers,1,Pacific,Western,71,2,120,0.5916666666666667,70,1,68,3
2019-20,2020-02-22,Edmonton Oilers,0,Pacific,Western,71,2,122,0.5819672131147541,70,1,68,3
2019-20,2020-02-24,Edmonton Oilers,2,Pacific,Western,73,2,124,0.5887096774193549,72,1,70,3
2019-20,2020-02-26,Edmonton Oilers,1,Pacific,Western,74,2,126,0.5873015873015873,74,0,70,4
2019-20,2020-02-27,Edmonton Oilers,0,Pacific,Western,74,2,128,0.578125,74,0,70,4
2019-20,2020-03-01,Edmonton Oilers,2,Pacific,Western,76,2,130,0.5846153846153846,75,1,72,4
2019-20,2020-03-03,Edmonton Oilers,2,Pacific,Western,78,2,132,0.5909090909090909,75,3,72,6
2019-20,2020-03-04,Edmonton Oilers,2,Pacific,Western,80,2,134,0.5970149253731343,75,5,74,6
2019-20,2020-03-06,Edmonton Oilers,0,Pacific,Western,80,2,136,0.5882352941176471,77,3,74,6
2019-20,2020-03-08,Edmonton Oilers,2,Pacific,Western,82,2,138,0.5942028985507246,79,3,76,6
2019-20,2020-03-10,Edmonton Oilers,1,Pacific,Western,83,2,140,0.5928571428571429,79,4,78,5
2019-20,2020-03-12,Edmonton Oilers,0,Pacific,Western,83,2,142,0.5845070422535211,79,4,78,5
2019-20,2019-10-03,Florida Panthers,0,Atlantic,Eastern,0,2,2,0.0,2,-2,0,0
2019-20,2019-10-05,Florida Panthers,2,Atlantic,Eastern,2,2,4,0.5,3,-1,2,0
2019-20,2019-10-08,Florida Panthers,0,Atlantic,Eastern,2,2,6,0.3333333333333333,4,-2,3,-1
2019-20,2019-10-11,Florida Panthers,1,Atlantic,Eastern,3,2,8,0.375,6,-3,4,-1
2019-20,2019-10-12,Florida Panthers,1,Atlantic,Eastern,4,2,10,0.4,7,-3,5,-1
2019-20,2019-10-14,Florida Panthers,2,Atlantic,Eastern,6,2,12,0.5,7,-1,6,0
2019-20,2019-10-18,Florida Panthers,1,Atlantic,Eastern,7,2,14,0.5,9,-2,8,-1
2019-20,2019-10-20,Florida Panthers,2,Atlantic,Eastern,9,2,16,0.5625,11,-2,10,-1
2019-20,2019-10-22,Florida Panthers,2,Atlantic,Eastern,11,2,18,0.6111111111111112,12,-1,10,1
2019-20,2019-10-25,Florida Panthers,1,Atlantic,Eastern,12,2,20,0.6,14,-2,12,0
2019-20,2019-10-27,Florida Panthers,2,Atlantic,Eastern,14,2,22,0.6363636363636364,14,0,14,0
2019-20,2019-10-29,Florida Panthers,0,Atlantic,Eastern,14,2,24,0.5833333333333334,15,-1,14,0
2019-20,2019-10-31,Florida Panthers,2,Atlantic,Eastern,16,2,26,0.6153846153846154,16,0,15,1
2019-20,2019-11-02,Florida Panthers,2,Atlantic,Eastern,18,2,28,0.6428571428571429,18,0,17,1
2019-20,2019-11-08,Florida Panthers,1,Atlantic,Eastern,19,2,30,0.6333333333333333,20,-1,19,0
2019-20,2019-11-09,Florida Panthers,0,Atlantic,Eastern,19,2,32,0.59375,20,-1,19,0
2019-20,2019-11-10,Florida Panthers,2,Atlantic,Eastern,21,2,34,0.6176470588235294,21,0,20,1
2019-20,2019-11-13,Florida Panthers,2,Atlantic,Eastern,23,2,36,0.6388888888888888,23,0,22,1
2019-20,2019-11-15,Florida Panthers,0,Atlantic,Eastern,23,2,38,0.6052631578947368,23,0,22,1
2019-20,2019-11-17,Florida Panthers,2,Atlantic,Eastern,25,2,40,0.625,25,0,24,1
2019-20,2019-11-20,Florida Panthers,2,Atlantic,Eastern,27,2,42,0.6428571428571429,26,1,24,3
2019-20,2019-11-22,Florida Panthers,2,Atlantic,Eastern,29,2,44,0.6590909090909091,27,2,26,3
2019-20,2019-11-24,Florida Panthers,0,Atlantic,Eastern,29,2,46,0.6304347826086957,27,2,27,2
2019-20,2019-11-24,Florida Panthers,0,Atlantic,Eastern,29,2,48,0.6041666666666666,27,2,27,2
2019-20,2019-11-28,Florida Panthers,0,Atlantic,Eastern,29,2,50,0.58,28,1,28,1
2019-20,2019-12-01,Florida Panthers,2,Atlantic,Eastern,31,2,52,0.5961538461538461,30,1,30,1
2019-20,2019-12-04,Florida Panthers,0,Atlantic,Eastern,31,2,54,0.5740740740740741,31,0,31,0
2019-20,2019-12-08,Florida Panthers,2,Atlantic,Eastern,33,2,56,0.5892857142857143,32,1,32,1
2019-20,2019-12-08,Florida Panthers,2,Atlantic,Eastern,35,2,58,0.603448275862069,32,3,32,3
2019-20,2019-12-11,Florida Panthers,0,Atlantic,Eastern,35,2,60,0.5833333333333334,35,0,35,0
2019-20,2019-12-13,Florida Panthers,0,Atlantic,Eastern,35,2,62,0.5645161290322581,36,-1,36,-1
2019-20,2019-12-15,Florida Panthers,0,Atlantic,Eastern,35,2,64,0.546875,36,-1,36,-1
2019-20,2019-12-17,Florida Panthers,2,Atlantic,Eastern,37,2,66,0.5606060606060606,37,0,37,0
2019-20,2019-12-21,Florida Panthers,2,Atlantic,Eastern,39,2,68,0.5735294117647058,40,-1,40,-1
2019-20,2019-12-22,Florida Panthers,2,Atlantic,Eastern,41,2,70,0.5857142857142857,41,0,41,0
2019-20,2019-12-24,Florida Panthers,0,Atlantic,Eastern,41,2,72,0.5694444444444444,42,-1,42,-1
2019-20,2019-12-29,Florida Panthers,2,Atlantic,Eastern,43,2,74,0.581081081081081,43,0,43,0
2019-20,2019-12-30,Florida Panthers,2,Atlantic,Eastern,45,2,76,0.5921052631578947,45,0,45,0
2019-20,2020-01-01,Florida Panthers,0,Atlantic,Eastern,45,2,78,0.5769230769230769,46,-1,46,-1
2019-20,2020-01-03,Florida Panthers,2,Atlantic,Eastern,47,2,80,0.5875,48,-1,48,-1
2019-20,2020-01-04,Florida Panthers,0,Atlantic,Eastern,47,2,82,0.573170731707317,48,-1,48,-1
2019-20,2020-01-05,Florida Panthers,2,Atlantic,Eastern,49,2,84,0.5833333333333334,52,-3,49,0
2019-20,2020-01-08,Florida Panthers,0,Atlantic,Eastern,49,2,86,0.5697674418604651,53,-4,50,-1
2019-20,2020-01-10,Florida Panthers,2,Atlantic,Eastern,51,2,88,0.5795454545454546,54,-3,52,-1
2019-20,2020-01-13,Florida Panthers,2,Atlantic,Eastern,53,2,90,0.5888888888888889,54,-1,53,0
2019-20,2020-01-17,Florida Panthers,2,Atlantic,Eastern,55,2,92,0.5978260869565217,57,-2,56,-1
2019-20,2020-01-19,Florida Panthers,2,Atlantic,Eastern,57,2,94,0.6063829787234043,57,0,58,-1
2019-20,2020-01-21,Florida Panthers,2,Atlantic,Eastern,59,2,96,0.6145833333333334,59,0,59,0
2019-20,2020-01-22,Florida Panthers,2,Atlantic,Eastern,61,2,98,0.6224489795918368,61,0,60,1
2019-20,2020-02-01,Florida Panthers,0,Atlantic,Eastern,61,2,100,0.61,61,0,61,0
2019-20,2020-02-04,Florida Panthers,2,Atlantic,Eastern,63,2,102,0.6176470588235294,63,0,63,0
2019-20,2020-02-05,Florida Panthers,1,Atlantic,Eastern,64,2,104,0.6153846153846154,64,0,64,0
2019-20,2020-02-07,Florida Panthers,0,Atlantic,Eastern,64,2,106,0.6037735849056604,64,0,65,-1
2019-20,2020-02-09,Florida Panthers,0,Atlantic,Eastern,64,2,108,0.5925925925925926,66,-2,67,-3
2019-20,2020-02-11,Florida Panthers,0,Atlantic,Eastern,64,2,110,0.5818181818181818,66,-2,67,-3
2019-20,2020-02-12,Florida Panthers,2,Atlantic,Eastern,66,2,112,0.5892857142857143,68,-2,68,-2
2019-20,2020-02-14,Florida Panthers,0,Atlantic,Eastern,66,2,114,0.5789473684210527,68,-2,68,-2
2019-20,2020-02-15,Florida Panthers,0,Atlantic,Eastern,66,2,116,0.5689655172413793,68,-2,69,-3
2019-20,2020-02-17,Florida Panthers,2,Atlantic,Eastern,68,2,118,0.576271186440678,70,-2,70,-2
2019-20,2020-02-20,Florida Panthers,2,Atlantic,Eastern,70,2,120,0.5833333333333334,70,0,72,-2
2019-20,2020-02-21,Florida Panthers,0,Atlantic,Eastern,70,2,122,0.5737704918032787,72,-2,72,-2
2019-20,2020-02-23,Florida Panthers,0,Atlantic,Eastern,70,2,124,0.5645161290322581,72,-2,74,-4
2019-20,2020-02-26,Florida Panthers,2,Atlantic,Eastern,72,2,126,0.5714285714285714,74,-2,74,-2
2019-20,2020-02-28,Florida Panthers,0,Atlantic,Eastern,72,2,128,0.5625,76,-4,76,-4
2019-20,2020-02-29,Florida Panthers,1,Atlantic,Eastern,73,2,130,0.5615384615384615,76,-3,76,-3
2019-20,2020-03-01,Florida Panthers,0,Atlantic,Eastern,73,2,132,0.553030303030303,78,-5,76,-3
2019-20,2020-03-06,Florida Panthers,1,Atlantic,Eastern,74,2,134,0.5522388059701493,79,-5,78,-4
2019-20,2020-03-08,Florida Panthers,2,Atlantic,Eastern,76,2,136,0.5588235294117647,79,-3,79,-3
2019-20,2020-03-10,Florida Panthers,2,Atlantic,Eastern,78,2,138,0.5652173913043478,81,-3,81,-3
2019-20,2019-10-06,Los Angeles Kings,0,Pacific,Western,0,2,2,0.0,4,-4,2,-2
2019-20,2019-10-09,Los Angeles Kings,2,Pacific,Western,2,2,4,0.5,4,-2,3,-1
2019-20,2019-10-10,Los Angeles Kings,0,Pacific,Western,2,2,6,0.3333333333333333,4,-2,3,-1
2019-20,2019-10-12,Los Angeles Kings,2,Pacific,Western,4,2,8,0.5,5,-1,4,0
2019-20,2019-10-14,Los Angeles Kings,0,Pacific,Western,4,2,10,0.4,8,-4,5,-1
2019-20,2019-10-16,Los Angeles Kings,0,Pacific,Western,4,2,12,0.3333333333333333,8,-4,7,-3
2019-20,2019-10-18,Los Angeles Kings,0,Pacific,Western,4,2,14,0.2857142857142857,10,-6,8,-4
2019-20,2019-10-20,Los Angeles Kings,2,Pacific,Western,6,2,16,0.375,12,-6,9,-3
2019-20,2019-10-23,Los Angeles Kings,2,Pacific,Western,8,2,18,0.4444444444444444,12,-4,11,-3
2019-20,2019-10-25,Los Angeles Kings,0,Pacific,Western,8,2,20,0.4,13,-5,12,-4
2019-20,2019-10-27,Los Angeles Kings,0,Pacific,Western,8,2,22,0.36363636363636365,14,-6,13,-5
2019-20,2019-10-27,Los Angeles Kings,0,Pacific,Western,8,2,24,0.3333333333333333,14,-6,13,-5
2019-20,2019-10-31,Los Angeles Kings,0,Pacific,Western,8,2,26,0.3076923076923077,16,-8,15,-7
2019-20,2019-11-03,Los Angeles Kings,2,Pacific,Western,10,2,28,0.35714285714285715,18,-8,18,-8
2019-20,2019-11-06,Los Angeles Kings,0,Pacific,Western,10,2,30,0.3333333333333333,20,-10,19,-9
2019-20,2019-11-08,Los Angeles Kings,1,Pacific,Western,11,2,32,0.34375,21,-10,20,-9
2019-20,2019-11-10,Los Angeles Kings,0,Pacific,Western,11,2,34,0.3235294117647059,21,-10,21,-10
2019-20,2019-11-13,Los Angeles Kings,2,Pacific,Western,13,2,36,0.3611111111111111,23,-10,21,-8
2019-20,2019-11-15,Los Angeles Kings,2,Pacific,Western,15,2,38,0.39473684210526316,23,-8,22,-7
2019-20,2019-11-16,Los Angeles Kings,2,Pacific,Western,17,2,40,0.425,23,-6,23,-6
2019-20,2019-11-19,Los Angeles Kings,0,Pacific,Western,17,2,42,0.40476190476190477,24,-7,23,-6
2019-20,2019-11-22,Los Angeles Kings,2,Pacific,Western,19,2,44,0.4318181818181818,26,-7,26,-7
2019-20,2019-11-23,Los Angeles Kings,0,Pacific,Western,19,2,46,0.41304347826086957,28,-9,26,-7
2019-20,2019-11-26,Los Angeles Kings,1,Pacific,Western,20,2,48,0.4166666666666667,28,-8,27,-7
2019-20,2019-11-28,Los Angeles Kings,2,Pacific,Western,22,2,50,0.44,28,-6,28,-6
2019-20,2019-11-29,Los Angeles Kings,0,Pacific,Western,22,2,52,0.4230769230769231,30,-8,29,-7
2019-20,2019-12-01,Los Angeles Kings,2,Pacific,Western,24,2,54,0.4444444444444444,31,-7,30,-6
2019-20,2019-12-03,Los Angeles Kings,0,Pacific,Western,24,2,56,0.42857142857142855,32,-8,31,-7
2019-20,2019-12-05,Los Angeles Kings,0,Pacific,Western,24,2,58,0.41379310344827586,34,-10,32,-8
2019-20,2019-12-07,Los Angeles Kings,0,Pacific,Western,24,2,60,0.4,35,-11,34,-10
2019-20,2019-12-08,Los Angeles Kings,0,Pacific,Western,24,2,62,0.3870967741935484,35,-11,34,-10
2019-20,2019-12-11,Los Angeles Kings,2,Pacific,Western,26,2,64,0.40625,38,-12,37,-11
2019-20,2019-12-13,Los Angeles Kings,2,Pacific,Western,28,2,66,0.42424242424242425,40,-12,37,-9
2019-20,2019-12-15,Los Angeles Kings,1,Pacific,Western,29,2,68,0.4264705882352941,40,-11,39,-10
2019-20,2019-12-16,Los Angeles Kings,2,Pacific,Western,31,2,70,0.44285714285714284,40,-9,40,-9
2019-20,2019-12-18,Los Angeles Kings,2,Pacific,Western,33,2,72,0.4583333333333333,42,-9,40,-7
2019-20,2019-12-20,Los Angeles Kings,1,Pacific,Western,34,2,74,0.4594594594594595,42,-8,41,-7
2019-20,2019-12-21,Los Angeles Kings,0,Pacific,Western,34,2,76,0.4473684210526316,42,-8,41,-7
2019-20,2019-12-24,Los Angeles Kings,0,Pacific,Western,34,2,78,0.4358974358974359,44,-10,43,-9
2019-20,2019-12-28,Los Angeles Kings,2,Pacific,Western,36,2,80,0.45,45,-9,44,-8
2019-20,2019-12-29,Los Angeles Kings,0,Pacific,Western,36,2,82,0.43902439024390244,45,-9,44,-8
2019-20,2020-01-01,Los Angeles Kings,2,Pacific,Western,38,2,84,0.4523809523809524,46,-8,46,-8
2019-20,2020-01-05,Los Angeles Kings,0,Pacific,Western,38,2,86,0.4418604651162791,50,-12,48,-10
2019-20,2020-01-07,Los Angeles Kings,0,Pacific,Western,38,2,88,0.4318181818181818,51,-13,50,-12
2019-20,2020-01-09,Los Angeles Kings,0,Pacific,Western,38,2,90,0.4222222222222222,51,-13,51,-13
2019-20,2020-01-10,Los Angeles Kings,2,Pacific,Western,40,2,92,0.43478260869565216,53,-13,52,-12
2019-20,2020-01-12,Los Angeles Kings,0,Pacific,Western,40,2,94,0.425531914893617,54,-14,53,-13
2019-20,2020-01-15,Los Angeles Kings,1,Pacific,Western,41,2,96,0.4270833333333333,55,-14,54,-13
2019-20,2020-01-17,Los Angeles Kings,0,Pacific,Western,41,2,98,0.41836734693877553,56,-15,55,-14
2019-20,2020-01-19,Los Angeles Kings,0,Pacific,Western,41,2,100,0.41,57,-16,57,-16
2019-20,2020-01-30,Los Angeles Kings,0,Pacific,Western,41,2,102,0.4019607843137255,58,-17,57,-16
2019-20,2020-01-31,Los Angeles Kings,2,Pacific,Western,43,2,104,0.41346153846153844,58,-15,57,-14
2019-20,2020-02-02,Los Angeles Kings,0,Pacific,Western,43,2,106,0.4056603773584906,61,-18,59,-16
2019-20,2020-02-05,Los Angeles Kings,0,Pacific,Western,43,2,108,0.39814814814814814,61,-18,60,-17
2019-20,2020-02-07,Los Angeles Kings,0,Pacific,Western,43,2,110,0.39090909090909093,62,-19,60,-17
2019-20,2020-02-09,Los Angeles Kings,0,Pacific,Western,43,2,112,0.38392857142857145,64,-21,61,-18
2019-20,2020-02-09,Los Angeles Kings,0,Pacific,Western,43,2,114,0.37719298245614036,64,-21,61,-18
2019-20,2020-02-13,Los Angeles Kings,2,Pacific,Western,45,2,116,0.3879310344827586,64,-19,64,-19
2019-20,2020-02-16,Los Angeles Kings,2,Pacific,Western,47,2,118,0.3983050847457627,68,-21,66,-19
2019-20,2020-02-19,Los Angeles Kings,0,Pacific,Western,47,2,120,0.39166666666666666,69,-22,68,-21
2019-20,2020-02-21,Los Angeles Kings,2,Pacific,Western,49,2,122,0.4016393442622951,70,-21,68,-19
2019-20,2020-02-23,Los Angeles Kings,1,Pacific,Western,50,2,124,0.4032258064516129,71,-21,69,-19
2019-20,2020-02-24,Los Angeles Kings,0,Pacific,Western,50,2,126,0.3968253968253968,72,-22,70,-20
2019-20,2020-02-27,Los Angeles Kings,2,Pacific,Western,52,2,128,0.40625,74,-22,70,-18
2019-20,2020-02-29,Los Angeles Kings,2,Pacific,Western,54,2,130,0.4153846153846154,74,-20,72,-18
2019-20,2020-03-02,Los Angeles Kings,2,Pacific,Western,56,2,132,0.42424242424242425,75,-19,72,-16
2019-20,2020-03-06,Los Angeles Kings,2,Pacific,Western,58,2,134,0.43283582089552236,77,-19,74,-16
2019-20,2020-03-07,Los Angeles Kings,2,Pacific,Western,60,2,136,0.4411764705882353,79,-19,76,-16
2019-20,2020-03-10,Los Angeles Kings,2,Pacific,Western,62,2,138,0.4492753623188406,79,-17,78,-16
2019-20,2020-03-12,Los Angeles Kings,2,Pacific,Western,64,2,140,0.45714285714285713,79,-15,78,-14
2019-20,2019-10-04,Minnesota Wild,0,Central,Western,0,2,2,0.0,2,-2,0,0
2019-20,2019-10-06,Minnesota Wild,0,Central,Western,0,2,4,0.0,2,-2,2,-2
2019-20,2019-10-11,Minnesota Wild,0,Central,Western,0,2,6,0.0,6,-6,4,-4
2019-20,2019-10-13,Minnesota Wild,0,Central,Western,0,2,8,0.0,7,-7,5,-5
2019-20,2019-10-14,Minnesota Wild,2,Central,Western,2,2,10,0.2,8,-6,5,-3
2019-20,2019-10-15,Minnesota Wild,0,Central,Western,2,2,12,0.16666666666666666,8,-6,5,-3
2019-20,2019-10-17,Minnesota Wild,0,Central,Western,2,2,14,0.14285714285714285,8,-6,7,-5
2019-20,2019-10-20,Minnesota Wild,2,Central,Western,4,2,16,0.25,9,-5,9,-5
2019-20,2019-10-23,Minnesota Wild,2,Central,Western,6,2,18,0.3333333333333333,11,-5,11,-5
2019-20,2019-10-25,Minnesota Wild,0,Central,Western,6,2,20,0.3,13,-7,12,-6
2019-20,2019-10-27,Minnesota Wild,2,Central,Western,8,2,22,0.36363636363636365,15,-7,13,-5
2019-20,2019-10-30,Minnesota Wild,0,Central,Western,8,2,24,0.3333333333333333,15,-7,15,-7
2019-20,2019-10-31,Minnesota Wild,0,Central,Western,8,2,26,0.3076923076923077,17,-9,15,-7
2019-20,2019-11-03,Minnesota Wild,1,Central,Western,9,2,28,0.32142857142857145,18,-9,18,-9
2019-20,2019-11-06,Minnesota Wild,2,Central,Western,11,2,30,0.36666666666666664,18,-7,19,-8
2019-20,2019-11-08,Minnesota Wild,0,Central,Western,11,2,32,0.34375,20,-9,20,-9
2019-20,2019-11-10,Minnesota Wild,2,Central,Western,13,2,34,0.38235294117647056,21,-8,21,-8
2019-20,2019-11-13,Minnesota Wild,0,Central,Western,13,2,36,0.3611111111111111,21,-8,21,-8
2019-20,2019-11-15,Minnesota Wild,2,Central,Western,15,2,38,0.39473684210526316,23,-8,22,-7
2019-20,2019-11-16,Minnesota Wild,1,Central,Western,16,2,40,0.4,24,-8,23,-7
2019-20,2019-11-20,Minnesota Wild,2,Central,Western,18,2,42,0.42857142857142855,27,-9,24,-6
2019-20,2019-11-22,Minnesota Wild,2,Central,Western,20,2,44,0.45454545454545453,28,-8,26,-6
2019-20,2019-11-24,Minnesota Wild,1,Central,Western,21,2,46,0.45652173913043476,29,-8,26,-5
2019-20,2019-11-26,Minnesota Wild,1,Central,Western,22,2,48,0.4583333333333333,29,-7,27,-5
2019-20,2019-11-27,Minnesota Wild,2,Central,Western,24,2,50,0.48,29,-5,27,-3
2019-20,2019-11-29,Minnesota Wild,2,Central,Western,26,2,52,0.5,32,-6,29,-3
2019-20,2019-12-01,Minnesota Wild,2,Central,Western,28,2,54,0.5185185185185185,33,-5,30,-2
2019-20,2019-12-04,Minnesota Wild,2,Central,Western,30,2,56,0.5357142857142857,34,-4,32,-2
2019-20,2019-12-06,Minnesota Wild,2,Central,Western,32,2,58,0.5517241379310345,36,-4,32,0
2019-20,2019-12-08,Minnesota Wild,0,Central,Western,32,2,60,0.5333333333333333,38,-6,34,-2
2019-20,2019-12-11,Minnesota Wild,1,Central,Western,33,2,62,0.532258064516129,40,-7,37,-4
2019-20,2019-12-13,Minnesota Wild,2,Central,Western,35,2,64,0.546875,40,-5,37,-2
2019-20,2019-12-15,Minnesota Wild,2,Central,Western,37,2,66,0.5606060606060606,42,-5,39,-2
2019-20,2019-12-16,Minnesota Wild,0,Central,Western,37,2,68,0.5441176470588235,42,-5,40,-3
2019-20,2019-12-18,Minnesota Wild,0,Central,Western,37,2,70,0.5285714285714286,42,-5,40,-3
2019-20,2019-12-20,Minnesota Wild,2,Central,Western,39,2,72,0.5416666666666666,44,-5,41,-2
2019-20,2019-12-21,Minnesota Wild,0,Central,Western,39,2,74,0.527027027027027,44,-5,41,-2
2019-20,2019-12-23,Minnesota Wild,2,Central,Western,41,2,76,0.5394736842105263,44,-3,43,-2
2019-20,2019-12-28,Minnesota Wild,2,Central,Western,43,2,78,0.5512820512820513,45,-2,44,-1
2019-20,2019-12-29,Minnesota Wild,0,Central,Western,43,2,80,0.5375,46,-3,44,-1
2019-20,2019-12-31,Minnesota Wild,0,Central,Western,43,2,82,0.524390243902439,48,-5,45,-2
2019-20,2020-01-04,Minnesota Wild,2,Central,Western,45,2,84,0.5357142857142857,52,-7,48,-3
2019-20,2020-01-06,Minnesota Wild,1,Central,Western,46,2,86,0.5348837209302325,52,-6,49,-3
2019-20,2020-01-10,Minnesota Wild,0,Central,Western,46,2,88,0.5227272727272727,54,-8,52,-6
2019-20,2020-01-12,Minnesota Wild,0,Central,Western,46,2,90,0.5111111111111111,55,-9,53,-7
2019-20,2020-01-15,Minnesota Wild,0,Central,Western,46,2,92,0.5,56,-10,54,-8
2019-20,2020-01-17,Minnesota Wild,2,Central,Western,48,2,94,0.5106382978723404,58,-10,55,-7
2019-20,2020-01-19,Minnesota Wild,2,Central,Western,50,2,96,0.5208333333333334,58,-8,57,-7
2019-20,2020-01-21,Minnesota Wild,0,Central,Western,50,2,98,0.5102040816326531,58,-8,57,-7
2019-20,2020-01-23,Minnesota Wild,2,Central,Western,52,2,100,0.52,58,-6,57,-5
2019-20,2020-02-02,Minnesota Wild,0,Central,Western,52,2,102,0.5098039215686274,62,-10,59,-7
2019-20,2020-02-05,Minnesota Wild,2,Central,Western,54,2,104,0.5192307692307693,64,-10,60,-6
2019-20,2020-02-07,Minnesota Wild,2,Central,Western,56,2,106,0.5283018867924528,65,-9,60,-4
2019-20,2020-02-08,Minnesota Wild,2,Central,Western,58,2,108,0.5370370370370371,65,-7,61,-3
2019-20,2020-02-10,Minnesota Wild,0,Central,Western,58,2,110,0.5272727272727272,67,-9,62,-4
2019-20,2020-02-12,Minnesota Wild,2,Central,Western,60,2,112,0.5357142857142857,69,-9,64,-4
2019-20,2020-02-14,Minnesota Wild,1,Central,Western,61,2,114,0.5350877192982456,71,-10,64,-3
2019-20,2020-02-15,Minnesota Wild,0,Central,Western,61,2,116,0.5258620689655172,71,-10,64,-3
2019-20,2020-02-20,Minnesota Wild,2,Central,Western,63,2,118,0.5338983050847458,75,-12,68,-5
2019-20,2020-02-22,Minnesota Wild,2,Central,Western,65,2,120,0.5416666666666666,76,-11,68,-3
2019-20,2020-02-24,Minnesota Wild,0,Central,Western,65,2,122,0.5327868852459017,78,-13,70,-5
2019-20,2020-02-26,Minnesota Wild,2,Central,Western,67,2,124,0.5403225806451613,79,-12,70,-3
2019-20,2020-02-28,Minnesota Wild,2,Central,Western,69,2,126,0.5476190476190477,80,-11,72,-3
2019-20,2020-02-29,Minnesota Wild,2,Central,Western,71,2,128,0.5546875,80,-9,72,-1
2019-20,2020-03-02,Minnesota Wild,0,Central,Western,71,2,130,0.5461538461538461,81,-10,72,-1
2019-20,2020-03-04,Minnesota Wild,2,Central,Western,73,2,132,0.553030303030303,82,-9,74,-1
2019-20,2020-03-06,Minnesota Wild,2,Central,Western,75,2,134,0.5597014925373134,82,-7,74,1
2019-20,2020-03-07,Minnesota Wild,0,Central,Western,75,2,136,0.5514705882352942,82,-7,76,-1
2019-20,2020-03-09,Minnesota Wild,2,Central,Western,77,2,138,0.5579710144927537,82,-5,76,1
2019-20,2019-10-03,Montréal Canadiens,1,Atlantic,Eastern,1,2,2,0.5,2,-1,0,1
2019-20,2019-10-05,Montréal Canadiens,2,Atlantic,Eastern,3,2,4,0.75,3,0,2,1
2019-20,2019-10-09,Montréal Canadiens,1,Atlantic,Eastern,4,2,6,0.6666666666666666,5,-1,4,0
2019-20,2019-10-10,Montréal Canadiens,0,Atlantic,Eastern,4,2,8,0.5,6,-2,4,0
2019-20,2019-10-12,Montréal Canadiens,2,Atlantic,Eastern,6,2,10,0.6,7,-1,5,1
2019-20,2019-10-15,Montréal Canadiens,0,Atlantic,Eastern,6,2,12,0.5,9,-3,6,0
2019-20,2019-10-17,Montréal Canadiens,2,Atlantic,Eastern,8,2,14,0.5714285714285714,9,-1,8,0
2019-20,2019-10-19,Montréal Canadiens,2,Atlantic,Eastern,10,2,16,0.625,11,-1,10,0
2019-20,2019-10-20,Montréal Canadiens,0,Atlantic,Eastern,10,2,18,0.5555555555555556,11,-1,10,0
2019-20,2019-10-24,Montréal Canadiens,0,Atlantic,Eastern,10,2,20,0.5,12,-2,12,-2
2019-20,2019-10-26,Montréal Canadiens,2,Atlantic,Eastern,12,2,22,0.5454545454545454,14,-2,12,0
2019-20,2019-10-31,Montréal Canadiens,2,Atlantic,Eastern,14,2,24,0.5833333333333334,16,-2,15,-1
2019-20,2019-11-01,Montréal Canadiens,2,Atlantic,Eastern,16,2,26,0.6153846153846154,16,0,16,0
2019-20,2019-11-02,Montréal Canadiens,0,Atlantic,Eastern,16,2,28,0.5714285714285714,18,-2,17,-1
2019-20,2019-11-06,Montréal Canadiens,2,Atlantic,Eastern,18,2,30,0.6,19,-1,18,0
2019-20,2019-11-08,Montréal Canadiens,1,Atlantic,Eastern,19,2,32,0.59375,20,-1,19,0
2019-20,2019-11-10,Montréal Canadiens,2,Atlantic,Eastern,21,2,34,0.6176470588235294,21,0,20,1
2019-20,2019-11-13,Montréal Canadiens,2,Atlantic,Eastern,23,2,36,0.6388888888888888,23,0,22,1
2019-20,2019-11-16,Montréal Canadiens,2,Atlantic,Eastern,25,2,38,0.6578947368421053,23,2,22,3
2019-20,2019-11-17,Montréal Canadiens,1,Atlantic,Eastern,26,2,40,0.65,25,1,24,2
2019-20,2019-11-20,Montréal Canadiens,0,Atlantic,Eastern,26,2,42,0.6190476190476191,26,0,24,2
2019-20,2019-11-21,Montréal Canadiens,1,Atlantic,Eastern,27,2,44,0.6136363636363636,27,0,24,3
2019-20,2019-11-24,Montréal Canadiens,0,Atlantic,Eastern,27,2,46,0.5869565217391305,27,0,27,0
2019-20,2019-11-27,Montréal Canadiens,0,Atlantic,Eastern,27,2,48,0.5625,27,0,27,0
2019-20,2019-11-29,Montréal Canadiens,0,Atlantic,Eastern,27,2,50,0.54,28,-1,28,-1
2019-20,2019-11-30,Montréal Canadiens,1,Atlantic,Eastern,28,2,52,0.5384615384615384,28,0,29,-1
2019-20,2019-12-02,Montréal Canadiens,0,Atlantic,Eastern,28,2,54,0.5185185185185185,30,-2,30,-2
2019-20,2019-12-04,Montréal Canadiens,2,Atlantic,Eastern,30,2,56,0.5357142857142857,31,-1,31,-1
2019-20,2019-12-06,Montréal Canadiens,0,Atlantic,Eastern,30,2,58,0.5172413793103449,31,-1,31,-1
2019-20,2019-12-07,Montréal Canadiens,2,Atlantic,Eastern,32,2,60,0.5333333333333333,32,0,32,0
2019-20,2019-12-11,Montréal Canadiens,2,Atlantic,Eastern,34,2,62,0.5483870967741935,35,-1,35,-1
2019-20,2019-12-12,Montréal Canadiens,2,Atlantic,Eastern,36,2,64,0.5625,36,0,36,0
2019-20,2019-12-15,Montréal Canadiens,0,Atlantic,Eastern,36,2,66,0.5454545454545454,36,0,36,0
2019-20,2019-12-18,Montréal Canadiens,2,Atlantic,Eastern,38,2,68,0.5588235294117647,38,0,38,0
2019-20,2019-12-20,Montréal Canadiens,2,Atlantic,Eastern,40,2,70,0.5714285714285714,39,1,39,1
2019-20,2019-12-22,Montréal Canadiens,0,Atlantic,Eastern,40,2,72,0.5555555555555556,41,-1,41,-1
2019-20,2019-12-24,Montréal Canadiens,2,Atlantic,Eastern,42,2,74,0.5675675675675675,42,0,42,0
2019-20,2019-12-29,Montréal Canadiens,0,Atlantic,Eastern,42,2,76,0.5526315789473685,43,-1,43,-1
2019-20,2019-12-30,Montréal Canadiens,0,Atlantic,Eastern,42,2,78,0.5384615384615384,45,-3,45,-3
2019-20,2020-01-01,Montréal Canadiens,0,Atlantic,Eastern,42,2,80,0.525,46,-4,46,-4
2019-20,2020-01-03,Montréal Canadiens,0,Atlantic,Eastern,42,2,82,0.5121951219512195,48,-6,48,-6
2019-20,2020-01-05,Montréal Canadiens,1,Atlantic,Eastern,43,2,84,0.5119047619047619,52,-9,49,-6
2019-20,2020-01-07,Montréal Canadiens,0,Atlantic,Eastern,43,2,86,0.5,52,-9,49,-6
2019-20,2020-01-08,Montréal Canadiens,0,Atlantic,Eastern,43,2,88,0.48863636363636365,53,-10,50,-7
2019-20,2020-01-10,Montréal Canadiens,0,Atlantic,Eastern,43,2,90,0.4777777777777778,54,-11,52,-9
2019-20,2020-01-12,Montréal Canadiens,2,Atlantic,Eastern,45,2,92,0.4891304347826087,54,-9,52,-7
2019-20,2020-01-14,Montréal Canadiens,2,Atlantic,Eastern,47,2,94,0.5,54,-7,54,-7
2019-20,2020-01-16,Montréal Canadiens,0,Atlantic,Eastern,47,2,96,0.4895833333333333,56,-9,56,-9
2019-20,2020-01-17,Montréal Canadiens,2,Atlantic,Eastern,49,2,98,0.5,57,-8,56,-7
2019-20,2020-01-19,Montréal Canadiens,2,Atlantic,Eastern,51,2,100,0.51,57,-6,58,-7
2019-20,2020-01-28,Montréal Canadiens,0,Atlantic,Eastern,51,2,102,0.5,61,-10,61,-10
2019-20,2020-01-31,Montréal Canadiens,2,Atlantic,Eastern,53,2,104,0.5096153846153846,61,-8,61,-8
2019-20,2020-02-01,Montréal Canadiens,2,Atlantic,Eastern,55,2,106,0.5188679245283019,61,-6,61,-6
2019-20,2020-02-02,Montréal Canadiens,0,Atlantic,Eastern,55,2,108,0.5092592592592593,63,-8,63,-8
2019-20,2020-02-05,Montréal Canadiens,2,Atlantic,Eastern,57,2,110,0.5181818181818182,64,-7,64,-7
2019-20,2020-02-07,Montréal Canadiens,2,Atlantic,Eastern,59,2,112,0.5267857142857143,64,-5,65,-6
2019-20,2020-02-09,Montréal Canadiens,2,Atlantic,Eastern,61,2,114,0.5350877192982456,66,-5,67,-6
2019-20,2020-02-11,Montréal Canadiens,0,Atlantic,Eastern,61,2,116,0.5258620689655172,66,-5,67,-6
2019-20,2020-02-13,Montréal Canadiens,0,Atlantic,Eastern,61,2,118,0.5169491525423728,68,-7,68,-7
2019-20,2020-02-15,Montréal Canadiens,0,Atlantic,Eastern,61,2,120,0.5083333333333333,68,-7,69,-8
2019-20,2020-02-16,Montréal Canadiens,1,Atlantic,Eastern,62,2,122,0.5081967213114754,70,-8,70,-8
2019-20,2020-02-19,Montréal Canadiens,0,Atlantic,Eastern,62,2,124,0.5,70,-8,72,-10
2019-20,2020-02-21,Montréal Canadiens,2,Atlantic,Eastern,64,2,126,0.5079365079365079,72,-8,72,-8
2019-20,2020-02-23,Montréal Canadiens,2,Atlantic,Eastern,66,2,128,0.515625,72,-6,74,-8
2019-20,2020-02-26,Montréal Canadiens,1,Atlantic,Eastern,67,2,130,0.5153846153846153,74,-7,74,-7
2019-20,2020-02-28,Montréal Canadiens,0,Atlantic,Eastern,67,2,132,0.5075757575757576,76,-9,76,-9
2019-20,2020-03-01,Montréal Canadiens,2,Atlantic,Eastern,69,2,134,0.5149253731343284,78,-9,76,-7
2019-20,2020-03-04,Montréal Canadiens,2,Atlantic,Eastern,71,2,136,0.5220588235294118,78,-7,78,-7
2019-20,2020-03-06,Montréal Canadiens,0,Atlantic,Eastern,71,2,138,0.5144927536231884,79,-8,78,-7
2019-20,2020-03-08,Montréal Canadiens,0,Atlantic,Eastern,71,2,140,0.5071428571428571,79,-8,79,-8
2019-20,2020-03-10,Montréal Canadiens,0,Atlantic,Eastern,71,2,142,0.5,81,-10,81,-10
2019-20,2019-10-04,Nashville Predators,2,Central,Western,2,2,2,1.0,2,0,0,2
2019-20,2019-10-06,Nashville Predators,0,Central,Western,2,2,4,0.5,2,0,2,0
2019-20,2019-10-09,Nashville Predators,2,Central,Western,4,2,6,0.6666666666666666,4,0,3,1
2019-20,2019-10-11,Nashville Predators,2,Central,Western,6,2,8,0.75,6,0,4,2
2019-20,2019-10-12,Nashville Predators,0,Central,Western,6,2,10,0.6,6,0,4,2
2019-20,2019-10-16,Nashville Predators,2,Central,Western,8,2,12,0.6666666666666666,8,0,7,1
2019-20,2019-10-18,Nashville Predators,0,Central,Western,8,2,14,0.5714285714285714,8,0,8,0
2019-20,2019-10-20,Nashville Predators,1,Central,Western,9,2,16,0.5625,9,0,9,0
2019-20,2019-10-23,Nashville Predators,2,Central,Western,11,2,18,0.6111111111111112,11,0,11,0
2019-20,2019-10-25,Nashville Predators,2,Central,Western,13,2,20,0.65,13,0,12,1
2019-20,2019-10-26,Nashville Predators,2,Central,Western,15,2,22,0.6818181818181818,13,2,13,2
2019-20,2019-10-30,Nashville Predators,2,Central,Western,17,2,24,0.7083333333333334,15,2,15,2
2019-20,2019-11-01,Nashville Predators,1,Central,Western,18,2,26,0.6923076923076923,17,1,16,2
2019-20,2019-11-02,Nashville Predators,0,Central,Western,18,2,28,0.6428571428571429,18,0,17,1
2019-20,2019-11-05,Nashville Predators,2,Central,Western,20,2,30,0.6666666666666666,18,2,18,2
2019-20,2019-11-08,Nashville Predators,0,Central,Western,20,2,32,0.625,20,0,20,0
2019-20,2019-11-10,Nashville Predators,1,Central,Western,21,2,34,0.6176470588235294,21,0,21,0
2019-20,2019-11-13,Nashville Predators,0,Central,Western,21,2,36,0.5833333333333334,21,0,21,0
2019-20,2019-11-17,Nashville Predators,0,Central,Western,21,2,38,0.5526315789473685,25,-4,23,-2
2019-20,2019-11-20,Nashville Predators,0,Central,Western,21,2,40,0.525,27,-6,24,-3
2019-20,2019-11-22,Nashville Predators,0,Central,Western,21,2,42,0.5,28,-7,26,-5
2019-20,2019-11-24,Nashville Predators,2,Central,Western,23,2,44,0.5227272727272727,29,-6,26,-3
2019-20,2019-11-26,Nashville Predators,2,Central,Western,25,2,46,0.5434782608695652,29,-4,27,-2
2019-20,2019-11-28,Nashville Predators,1,Central,Western,26,2,48,0.5416666666666666,31,-5,28,-2
2019-20,2019-11-30,Nashville Predators,2,Central,Western,28,2,50,0.56,32,-4,29,-1
2019-20,2019-12-01,Nashville Predators,0,Central,Western,28,2,52,0.5384615384615384,33,-5,30,-2
2019-20,2019-12-04,Nashville Predators,1,Central,Western,29,2,54,0.5370370370370371,34,-5,32,-3
2019-20,2019-12-08,Nashville Predators,2,Central,Western,31,2,56,0.5535714285714286,38,-7,34,-3
2019-20,2019-12-11,Nashville Predators,2,Central,Western,33,2,58,0.5689655172413793,40,-7,37,-4
2019-20,2019-12-13,Nashville Predators,0,Central,Western,33,2,60,0.55,40,-7,37,-4
2019-20,2019-12-14,Nashville Predators,0,Central,Western,33,2,62,0.532258064516129,41,-8,39,-6
2019-20,2019-12-17,Nashville Predators,2,Central,Western,35,2,64,0.546875,42,-7,40,-5
2019-20,2019-12-18,Nashville Predators,2,Central,Western,37,2,66,0.5606060606060606,42,-5,40,-3
2019-20,2019-12-20,Nashville Predators,1,Central,Western,38,2,68,0.5588235294117647,44,-6,41,-3
2019-20,2019-12-22,Nashville Predators,2,Central,Western,40,2,70,0.5714285714285714,44,-4,41,-1
2019-20,2019-12-24,Nashville Predators,2,Central,Western,42,2,72,0.5833333333333334,44,-2,43,-1
2019-20,2019-12-28,Nashville Predators,0,Central,Western,42,2,74,0.5675675675675675,45,-3,44,-2
2019-20,2019-12-29,Nashville Predators,0,Central,Western,42,2,76,0.5526315789473685,46,-4,44,-2
2019-20,2020-01-01,Nashville Predators,0,Central,Western,42,2,78,0.5384615384615384,50,-8,46,-4
2019-20,2020-01-05,Nashville Predators,2,Central,Western,44,2,80,0.55,52,-8,48,-4
2019-20,2020-01-06,Nashville Predators,1,Central,Western,45,2,82,0.5487804878048781,52,-7,49,-4
2019-20,2020-01-08,Nashville Predators,0,Central,Western,45,2,84,0.5357142857142857,52,-7,50,-5
2019-20,2020-01-10,Nashville Predators,2,Central,Western,47,2,86,0.5465116279069767,54,-7,52,-5
2019-20,2020-01-12,Nashville Predators,2,Central,Western,49,2,88,0.5568181818181818,55,-6,53,-4
2019-20,2020-01-15,Nashville Predators,0,Central,Western,49,2,90,0.5444444444444444,56,-7,54,-5
2019-20,2020-01-17,Nashville Predators,0,Central,Western,49,2,92,0.532608695652174,58,-9,55,-6
2019-20,2020-01-19,Nashville Predators,2,Central,Western,51,2,94,0.5425531914893617,58,-7,57,-6
2019-20,2020-01-28,Nashville Predators,0,Central,Western,51,2,96,0.53125,60,-9,57,-6
2019-20,2020-01-30,Nashville Predators,2,Central,Western,53,2,98,0.5408163265306123,60,-7,57,-4
2019-20,2020-01-31,Nashville Predators,2,Central,Western,55,2,100,0.55,60,-5,57,-2
2019-20,2020-02-02,Nashville Predators,0,Central,Western,55,2,102,0.5392156862745098,62,-7,59,-4
2019-20,2020-02-05,Nashville Predators,2,Central,Western,57,2,104,0.5480769230769231,64,-7,60,-3
2019-20,2020-02-07,Nashville Predators,2,Central,Western,59,2,106,0.5566037735849056,65,-6,60,-1
2019-20,2020-02-09,Nashville Predators,0,Central,Western,59,2,108,0.5462962962962963,67,-8,61,-2
2019-20,2020-02-11,Nashville Predators,0,Central,Western,59,2,110,0.5363636363636364,67,-8,63,-4
2019-20,2020-02-14,Nashville Predators,2,Central,Western,61,2,112,0.5446428571428571,71,-10,64,-3
2019-20,2020-02-15,Nashville Predators,2,Central,Western,63,2,114,0.5526315789473685,71,-8,64,-1
2019-20,2020-02-16,Nashville Predators,2,Central,Western,65,2,116,0.5603448275862069,72,-7,66,-1
2019-20,2020-02-19,Nashville Predators,0,Central,Western,65,2,118,0.5508474576271186,73,-8,68,-3
2019-20,2020-02-22,Nashville Predators,1,Central,Western,66,2,120,0.55,76,-10,68,-2
2019-20,2020-02-23,Nashville Predators,2,Central,Western,68,2,122,0.5573770491803278,78,-10,69,-1
2019-20,2020-02-26,Nashville Predators,2,Central,Western,70,2,124,0.5645161290322581,79,-9,70,0
2019-20,2020-02-28,Nashville Predators,2,Central,Western,72,2,126,0.5714285714285714,80,-8,72,0
2019-20,2020-03-01,Nashville Predators,0,Central,Western,72,2,128,0.5625,81,-9,72,0
2019-20,2020-03-03,Nashville Predators,0,Central,Western,72,2,130,0.5538461538461539,81,-9,72,0
2019-20,2020-03-04,Nashville Predators,0,Central,Western,72,2,132,0.5454545454545454,82,-10,74,-2
2019-20,2020-03-06,Nashville Predators,2,Central,Western,74,2,134,0.5522388059701493,82,-8,74,0
2019-20,2020-03-07,Nashville Predators,2,Central,Western,76,2,136,0.5588235294117647,82,-6,76,0
2019-20,2020-03-10,Nashville Predators,2,Central,Western,78,2,138,0.5652173913043478,82,-4,78,0
2019-20,2019-10-04,New Jersey Devils,1,Metropolitan,Eastern,1,2,2,0.5,2,-1,1,0
2019-20,2019-10-05,New Jersey Devils,0,Metropolitan,Eastern,1,2,4,0.25,4,-3,2,-1
2019-20,2019-10-09,New Jersey Devils,0,Metropolitan,Eastern,1,2,6,0.16666666666666666,4,-3,4,-3
2019-20,2019-10-10,New Jersey Devils,1,Metropolitan,Eastern,2,2,8,0.25,4,-2,4,-2
2019-20,2019-10-12,New Jersey Devils,0,Metropolitan,Eastern,2,2,10,0.2,4,-2,5,-3
2019-20,2019-10-14,New Jersey Devils,0,Metropolitan,Eastern,2,2,12,0.16666666666666666,8,-6,6,-4
2019-20,2019-10-17,New Jersey Devils,2,Metropolitan,Eastern,4,2,14,0.2857142857142857,10,-6,8,-4
2019-20,2019-10-19,New Jersey Devils,2,Metropolitan,Eastern,6,2,16,0.375,12,-6,10,-4
2019-20,2019-10-25,New Jersey Devils,0,Metropolitan,Eastern,6,2,18,0.3333333333333333,13,-7,12,-6
2019-20,2019-10-30,New Jersey Devils,1,Metropolitan,Eastern,7,2,20,0.35,16,-9,14,-7
2019-20,2019-11-01,New Jersey Devils,1,Metropolitan,Eastern,8,2,22,0.36363636363636365,18,-10,16,-8
2019-20,2019-11-02,New Jersey Devils,2,Metropolitan,Eastern,10,2,24,0.4166666666666667,19,-9,17,-7
2019-20,2019-11-06,New Jersey Devils,2,Metropolitan,Eastern,12,2,26,0.46153846153846156,19,-7,18,-6
2019-20,2019-11-08,New Jersey Devils,0,Metropolitan,Eastern,12,2,28,0.42857142857142855,19,-7,19,-7
2019-20,2019-11-09,New Jersey Devils,0,Metropolitan,Eastern,12,2,30,0.4,19,-7,19,-7
2019-20,2019-11-10,New Jersey Devils,2,Metropolitan,Eastern,14,2,32,0.4375,21,-7,20,-6
2019-20,2019-11-14,New Jersey Devils,0,Metropolitan,Eastern,14,2,34,0.4117647058823529,23,-9,22,-8
2019-20,2019-11-16,New Jersey Devils,2,Metropolitan,Eastern,16,2,36,0.4444444444444444,25,-9,22,-6
2019-20,2019-11-17,New Jersey Devils,2,Metropolitan,Eastern,18,2,38,0.47368421052631576,25,-7,24,-6
2019-20,2019-11-20,New Jersey Devils,0,Metropolitan,Eastern,18,2,40,0.45,27,-9,24,-6
2019-20,2019-11-23,New Jersey Devils,0,Metropolitan,Eastern,18,2,42,0.42857142857142855,28,-10,27,-9
2019-20,2019-11-24,New Jersey Devils,2,Metropolitan,Eastern,20,2,44,0.45454545454545453,29,-9,27,-7
2019-20,2019-11-27,New Jersey Devils,0,Metropolitan,Eastern,20,2,46,0.43478260869565216,31,-11,27,-7
2019-20,2019-11-29,New Jersey Devils,2,Metropolitan,Eastern,22,2,48,0.4583333333333333,33,-11,28,-6
2019-20,2019-11-30,New Jersey Devils,0,Metropolitan,Eastern,22,2,50,0.44,34,-12,29,-7
2019-20,2019-12-03,New Jersey Devils,0,Metropolitan,Eastern,22,2,52,0.4230769230769231,35,-13,31,-9
2019-20,2019-12-04,New Jersey Devils,0,Metropolitan,Eastern,22,2,54,0.4074074074074074,37,-15,31,-9
2019-20,2019-12-07,New Jersey Devils,1,Metropolitan,Eastern,23,2,56,0.4107142857142857,39,-16,32,-9
2019-20,2019-12-08,New Jersey Devils,0,Metropolitan,Eastern,23,2,58,0.39655172413793105,39,-16,32,-9
2019-20,2019-12-11,New Jersey Devils,0,Metropolitan,Eastern,23,2,60,0.38333333333333336,39,-16,35,-12
2019-20,2019-12-14,New Jersey Devils,0,Metropolitan,Eastern,23,2,62,0.3709677419354839,42,-19,36,-13
2019-20,2019-12-15,New Jersey Devils,2,Metropolitan,Eastern,25,2,64,0.390625,42,-17,36,-11
2019-20,2019-12-19,New Jersey Devils,2,Metropolitan,Eastern,27,2,66,0.4090909090909091,44,-17,38,-11
2019-20,2019-12-21,New Jersey Devils,0,Metropolitan,Eastern,27,2,68,0.39705882352941174,46,-19,40,-13
2019-20,2019-12-22,New Jersey Devils,0,Metropolitan,Eastern,27,2,70,0.38571428571428573,46,-19,41,-14
2019-20,2019-12-24,New Jersey Devils,2,Metropolitan,Eastern,29,2,72,0.4027777777777778,47,-18,42,-13
2019-20,2019-12-28,New Jersey Devils,1,Metropolitan,Eastern,30,2,74,0.40540540540540543,48,-18,42,-12
2019-20,2019-12-29,New Jersey Devils,2,Metropolitan,Eastern,32,2,76,0.42105263157894735,50,-18,43,-11
2019-20,2019-12-31,New Jersey Devils,2,Metropolitan,Eastern,34,2,78,0.4358974358974359,52,-18,45,-11
2019-20,2020-01-03,New Jersey Devils,2,Metropolitan,Eastern,36,2,80,0.45,53,-17,48,-12
2019-20,2020-01-05,New Jersey Devils,0,Metropolitan,Eastern,36,2,82,0.43902439024390244,53,-17,49,-13
2019-20,2020-01-08,New Jersey Devils,1,Metropolitan,Eastern,37,2,84,0.44047619047619047,57,-20,50,-13
2019-20,2020-01-10,New Jersey Devils,0,Metropolitan,Eastern,37,2,86,0.43023255813953487,57,-20,52,-15
2019-20,2020-01-12,New Jersey Devils,2,Metropolitan,Eastern,39,2,88,0.4431818181818182,58,-19,52,-13
2019-20,2020-01-13,New Jersey Devils,2,Metropolitan,Eastern,41,2,90,0.45555555555555555,58,-17,53,-12
2019-20,2020-01-15,New Jersey Devils,0,Metropolitan,Eastern,41,2,92,0.44565217391304346,60,-19,54,-13
2019-20,2020-01-17,New Jersey Devils,0,Metropolitan,Eastern,41,2,94,0.43617021276595747,60,-19,56,-15
2019-20,2020-01-19,New Jersey Devils,0,Metropolitan,Eastern,41,2,96,0.4270833333333333,61,-20,58,-17
2019-20,2020-01-28,New Jersey Devils,2,Metropolitan,Eastern,43,2,98,0.4387755102040816,63,-20,61,-18
2019-20,2020-01-31,New Jersey Devils,1,Metropolitan,Eastern,44,2,100,0.44,63,-19,61,-17
2019-20,2020-02-02,New Jersey Devils,1,Metropolitan,Eastern,45,2,102,0.4411764705882353,65,-20,63,-18
2019-20,2020-02-05,New Jersey Devils,1,Metropolitan,Eastern,46,2,104,0.4423076923076923,67,-21,64,-18
2019-20,2020-02-07,New Jersey Devils,2,Metropolitan,Eastern,48,2,106,0.4528301886792453,68,-20,65,-17
2019-20,2020-02-09,New Jersey Devils,2,Metropolitan,Eastern,50,2,108,0.46296296296296297,69,-19,67,-17
2019-20,2020-02-12,New Jersey Devils,0,Metropolitan,Eastern,50,2,110,0.45454545454545453,72,-22,68,-18
2019-20,2020-02-14,New Jersey Devils,2,Metropolitan,Eastern,52,2,112,0.4642857142857143,72,-20,68,-16
2019-20,2020-02-15,New Jersey Devils,0,Metropolitan,Eastern,52,2,114,0.45614035087719296,72,-20,69,-17
2019-20,2020-02-16,New Jersey Devils,2,Metropolitan,Eastern,54,2,116,0.46551724137931033,72,-18,70,-16
2019-20,2020-02-19,New Jersey Devils,0,Metropolitan,Eastern,54,2,118,0.4576271186440678,73,-19,72,-18
2019-20,2020-02-21,New Jersey Devils,2,Metropolitan,Eastern,56,2,120,0.4666666666666667,75,-19,72,-16
2019-20,2020-02-22,New Jersey Devils,2,Metropolitan,Eastern,58,2,122,0.47540983606557374,77,-19,72,-14
2019-20,2020-02-26,New Jersey Devils,2,Metropolitan,Eastern,60,2,124,0.4838709677419355,79,-19,74,-14
2019-20,2020-02-28,New Jersey Devils,1,Metropolitan,Eastern,61,2,126,0.48412698412698413,79,-18,76,-15
2019-20,2020-02-29,New Jersey Devils,1,Metropolitan,Eastern,62,2,128,0.484375,80,-18,76,-14
2019-20,2020-03-02,New Jersey Devils,2,Metropolitan,Eastern,64,2,130,0.49230769230769234,80,-16,78,-14
2019-20,2020-03-04,New Jersey Devils,0,Metropolitan,Eastern,64,2,132,0.48484848484848486,82,-18,78,-14
2019-20,2020-03-07,New Jersey Devils,2,Metropolitan,Eastern,66,2,134,0.4925373134328358,84,-18,79,-13
2019-20,2020-03-08,New Jersey Devils,2,Metropolitan,Eastern,68,2,136,0.5,84,-16,79,-11
2019-20,2020-03-10,New Jersey Devils,0,Metropolitan,Eastern,68,2,138,0.4927536231884058,86,-18,81,-13
2019-20,2019-10-04,New York Islanders,0,Metropolitan,Eastern,0,2,2,0.0,2,-2,1,-1
2019-20,2019-10-06,New York Islanders,2,Metropolitan,Eastern,2,2,4,0.5,4,-2,3,-1
2019-20,2019-10-08,New York Islanders,0,Metropolitan,Eastern,2,2,6,0.3333333333333333,4,-2,3,-1
2019-20,2019-10-11,New York Islanders,0,Metropolitan,Eastern,2,2,8,0.25,4,-2,4,-2
2019-20,2019-10-12,New York Islanders,2,Metropolitan,Eastern,4,2,10,0.4,4,0,5,-1
2019-20,2019-10-14,New York Islanders,2,Metropolitan,Eastern,6,2,12,0.5,8,-2,6,0
2019-20,2019-10-18,New York Islanders,2,Metropolitan,Eastern,8,2,14,0.5714285714285714,12,-4,8,0
2019-20,2019-10-19,New York Islanders,2,Metropolitan,Eastern,10,2,16,0.625,12,-2,10,0
2019-20,2019-10-24,New York Islanders,2,Metropolitan,Eastern,12,2,18,0.6666666666666666,12,0,12,0
2019-20,2019-10-25,New York Islanders,2,Metropolitan,Eastern,14,2,20,0.7,13,1,12,2
2019-20,2019-10-27,New York Islanders,2,Metropolitan,Eastern,16,2,22,0.7272727272727273,15,1,14,2
2019-20,2019-11-01,New York Islanders,2,Metropolitan,Eastern,18,2,24,0.75,18,0,16,2
2019-20,2019-11-02,New York Islanders,2,Metropolitan,Eastern,20,2,26,0.7692307692307693,19,1,17,3
2019-20,2019-11-06,New York Islanders,2,Metropolitan,Eastern,22,2,28,0.7857142857142857,19,3,18,4
2019-20,2019-11-08,New York Islanders,1,Metropolitan,Eastern,23,2,30,0.7666666666666667,19,4,19,4
2019-20,2019-11-09,New York Islanders,2,Metropolitan,Eastern,25,2,32,0.78125,19,6,19,6
2019-20,2019-11-14,New York Islanders,2,Metropolitan,Eastern,27,2,34,0.7941176470588235,23,4,22,5
2019-20,2019-11-17,New York Islanders,2,Metropolitan,Eastern,29,2,36,0.8055555555555556,25,4,24,5
2019-20,2019-11-20,New York Islanders,2,Metropolitan,Eastern,31,2,38,0.8157894736842105,27,4,24,7
2019-20,2019-11-22,New York Islanders,2,Metropolitan,Eastern,33,2,40,0.825,27,6,26,7
2019-20,2019-11-24,New York Islanders,1,Metropolitan,Eastern,34,2,42,0.8095238095238095,29,5,27,7
2019-20,2019-11-26,New York Islanders,0,Metropolitan,Eastern,34,2,44,0.7727272727272727,31,3,27,7
2019-20,2019-11-28,New York Islanders,0,Metropolitan,Eastern,34,2,46,0.7391304347826086,32,2,28,6
2019-20,2019-12-01,New York Islanders,2,Metropolitan,Eastern,36,2,48,0.75,35,1,30,6
2019-20,2019-12-03,New York Islanders,2,Metropolitan,Eastern,38,2,50,0.76,35,3,31,7
2019-20,2019-12-04,New York Islanders,0,Metropolitan,Eastern,38,2,52,0.7307692307692307,37,1,31,7
2019-20,2019-12-06,New York Islanders,2,Metropolitan,Eastern,40,2,54,0.7407407407407407,37,3,31,9
2019-20,2019-12-08,New York Islanders,0,Metropolitan,Eastern,40,2,56,0.7142857142857143,39,1,32,8
2019-20,2019-12-10,New York Islanders,2,Metropolitan,Eastern,42,2,58,0.7241379310344828,39,3,34,8
2019-20,2019-12-13,New York Islanders,2,Metropolitan,Eastern,44,2,60,0.7333333333333333,40,4,36,8
2019-20,2019-12-14,New York Islanders,2,Metropolitan,Eastern,46,2,62,0.7419354838709677,42,4,36,10
2019-20,2019-12-18,New York Islanders,0,Metropolitan,Eastern,46,2,64,0.71875,44,2,38,8
2019-20,2019-12-20,New York Islanders,2,Metropolitan,Eastern,48,2,66,0.7272727272727273,46,2,39,9
2019-20,2019-12-21,New York Islanders,1,Metropolitan,Eastern,49,2,68,0.7205882352941176,46,3,40,9
2019-20,2019-12-24,New York Islanders,0,Metropolitan,Eastern,49,2,70,0.7,47,2,42,7
2019-20,2019-12-28,New York Islanders,0,Metropolitan,Eastern,49,2,72,0.6805555555555556,48,1,42,7
2019-20,2019-12-29,New York Islanders,2,Metropolitan,Eastern,51,2,74,0.6891891891891891,50,1,43,8
2019-20,2019-12-31,New York Islanders,2,Metropolitan,Eastern,53,2,76,0.6973684210526315,52,1,45,8
2019-20,2020-01-03,New York Islanders,0,Metropolitan,Eastern,53,2,78,0.6794871794871795,53,0,48,5
2019-20,2020-01-05,New York Islanders,0,Metropolitan,Eastern,53,2,80,0.6625,53,0,49,4
2019-20,2020-01-07,New York Islanders,2,Metropolitan,Eastern,55,2,82,0.6707317073170732,55,0,49,6
2019-20,2020-01-08,New York Islanders,2,Metropolitan,Eastern,57,2,84,0.6785714285714286,57,0,50,7
2019-20,2020-01-12,New York Islanders,1,Metropolitan,Eastern,58,2,86,0.6744186046511628,58,0,52,6
2019-20,2020-01-14,New York Islanders,0,Metropolitan,Eastern,58,2,88,0.6590909090909091,58,0,54,4
2019-20,2020-01-15,New York Islanders,2,Metropolitan,Eastern,60,2,90,0.6666666666666666,60,0,54,6
2019-20,2020-01-17,New York Islanders,0,Metropolitan,Eastern,60,2,92,0.6521739130434783,60,0,56,4
2019-20,2020-01-18,New York Islanders,0,Metropolitan,Eastern,60,2,94,0.6382978723404256,60,0,56,4
2019-20,2020-01-19,New York Islanders,1,Metropolitan,Eastern,61,2,96,0.6354166666666666,61,0,58,3
2019-20,2020-01-22,New York Islanders,2,Metropolitan,Eastern,63,2,98,0.6428571428571429,63,0,60,3
2019-20,2020-02-01,New York Islanders,1,Metropolitan,Eastern,64,2,100,0.64,64,0,61,3
2019-20,2020-02-05,New York Islanders,2,Metropolitan,Eastern,66,2,102,0.6470588235294118,67,-1,64,2
2019-20,2020-02-07,New York Islanders,2,Metropolitan,Eastern,68,2,104,0.6538461538461539,68,0,65,3
2019-20,2020-02-09,New York Islanders,0,Metropolitan,Eastern,68,2,106,0.6415094339622641,69,-1,67,1
2019-20,2020-02-11,New York Islanders,2,Metropolitan,Eastern,70,2,108,0.6481481481481481,70,0,67,3
2019-20,2020-02-12,New York Islanders,2,Metropolitan,Eastern,72,2,110,0.6545454545454545,72,0,68,4
2019-20,2020-02-14,New York Islanders,0,Metropolitan,Eastern,72,2,112,0.6428571428571429,72,0,68,4
2019-20,2020-02-16,New York Islanders,0,Metropolitan,Eastern,72,2,114,0.631578947368421,72,0,70,2
2019-20,2020-02-17,New York Islanders,0,Metropolitan,Eastern,72,2,116,0.6206896551724138,72,0,70,2
2019-20,2020-02-20,New York Islanders,0,Metropolitan,Eastern,72,2,118,0.6101694915254238,73,-1,72,0
2019-20,2020-02-22,New York Islanders,2,Metropolitan,Eastern,74,2,120,0.6166666666666667,77,-3,72,2
2019-20,2020-02-23,New York Islanders,2,Metropolitan,Eastern,76,2,122,0.6229508196721312,77,-1,74,2
2019-20,2020-02-26,New York Islanders,1,Metropolitan,Eastern,77,2,124,0.6209677419354839,79,-2,74,3
2019-20,2020-02-28,New York Islanders,1,Metropolitan,Eastern,78,2,126,0.6190476190476191,79,-1,76,2
2019-20,2020-02-29,New York Islanders,0,Metropolitan,Eastern,78,2,128,0.609375,80,-2,76,2
2019-20,2020-03-04,New York Islanders,0,Metropolitan,Eastern,78,2,130,0.6,82,-4,78,0
2019-20,2020-03-06,New York Islanders,0,Metropolitan,Eastern,78,2,132,0.5909090909090909,84,-6,78,0
2019-20,2020-03-07,New York Islanders,1,Metropolitan,Eastern,79,2,134,0.5895522388059702,84,-5,79,0
2019-20,2020-03-11,New York Islanders,1,Metropolitan,Eastern,80,2,136,0.5882352941176471,86,-6,81,-1
2019-20,2019-10-03,New York Rangers,2,Metropolitan,Eastern,2,2,2,1.0,2,0,0,2
2019-20,2019-10-05,New York Rangers,2,Metropolitan,Eastern,4,2,4,1.0,4,0,2,2
2019-20,2019-10-12,New York Rangers,0,Metropolitan,Eastern,4,2,6,0.6666666666666666,4,0,5,-1
2019-20,2019-10-17,New York Rangers,0,Metropolitan,Eastern,4,2,8,0.5,10,-6,8,-4
2019-20,2019-10-18,New York Rangers,0,Metropolitan,Eastern,4,2,10,0.4,12,-8,8,-4
2019-20,2019-10-20,New York Rangers,0,Metropolitan,Eastern,4,2,12,0.3333333333333333,12,-8,10,-6
2019-20,2019-10-22,New York Rangers,1,Metropolitan,Eastern,5,2,14,0.35714285714285715,12,-7,10,-5
2019-20,2019-10-24,New York Rangers,2,Metropolitan,Eastern,7,2,16,0.4375,12,-5,12,-5
2019-20,2019-10-27,New York Rangers,0,Metropolitan,Eastern,7,2,18,0.3888888888888889,15,-8,14,-7
2019-20,2019-10-29,New York Rangers,2,Metropolitan,Eastern,9,2,20,0.45,16,-7,14,-5
2019-20,2019-11-02,New York Rangers,2,Metropolitan,Eastern,11,2,22,0.5,19,-8,17,-6
2019-20,2019-11-05,New York Rangers,0,Metropolitan,Eastern,11,2,24,0.4583333333333333,19,-8,17,-6
2019-20,2019-11-07,New York Rangers,2,Metropolitan,Eastern,13,2,26,0.5,19,-6,18,-5
2019-20,2019-11-08,New York Rangers,2,Metropolitan,Eastern,15,2,28,0.5357142857142857,19,-4,19,-4
2019-20,2019-11-10,New York Rangers,1,Metropolitan,Eastern,16,2,30,0.5333333333333333,21,-5,20,-4
2019-20,2019-11-13,New York Rangers,2,Metropolitan,Eastern,18,2,32,0.5625,22,-4,22,-4
2019-20,2019-11-15,New York Rangers,0,Metropolitan,Eastern,18,2,34,0.5294117647058824,23,-5,22,-4
2019-20,2019-11-17,New York Rangers,0,Metropolitan,Eastern,18,2,36,0.5,25,-7,24,-6
2019-20,2019-11-21,New York Rangers,2,Metropolitan,Eastern,20,2,38,0.5263157894736842,27,-7,24,-4
2019-20,2019-11-23,New York Rangers,0,Metropolitan,Eastern,20,2,40,0.5,28,-8,27,-7
2019-20,2019-11-24,New York Rangers,2,Metropolitan,Eastern,22,2,42,0.5238095238095238,29,-7,27,-5
2019-20,2019-11-26,New York Rangers,2,Metropolitan,Eastern,24,2,44,0.5454545454545454,31,-7,27,-3
2019-20,2019-11-28,New York Rangers,2,Metropolitan,Eastern,26,2,46,0.5652173913043478,32,-6,28,-2
2019-20,2019-11-29,New York Rangers,1,Metropolitan,Eastern,27,2,48,0.5625,33,-6,28,-1
2019-20,2019-11-30,New York Rangers,2,Metropolitan,Eastern,29,2,50,0.58,34,-5,29,0
2019-20,2019-12-03,New York Rangers,0,Metropolitan,Eastern,29,2,52,0.5576923076923077,35,-6,31,-2
2019-20,2019-12-06,New York Rangers,2,Metropolitan,Eastern,31,2,54,0.5740740740740741,37,-6,31,0
2019-20,2019-12-07,New York Rangers,0,Metropolitan,Eastern,31,2,56,0.5535714285714286,39,-8,32,-1
2019-20,2019-12-09,New York Rangers,2,Metropolitan,Eastern,33,2,58,0.5689655172413793,39,-6,34,-1
2019-20,2019-12-11,New York Rangers,0,Metropolitan,Eastern,33,2,60,0.55,39,-6,35,-2
2019-20,2019-12-13,New York Rangers,2,Metropolitan,Eastern,35,2,62,0.5645161290322581,40,-5,36,-1
2019-20,2019-12-14,New York Rangers,1,Metropolitan,Eastern,36,2,64,0.5625,42,-6,36,0
2019-20,2019-12-17,New York Rangers,0,Metropolitan,Eastern,36,2,66,0.5454545454545454,42,-6,37,-1
2019-20,2019-12-21,New York Rangers,0,Metropolitan,Eastern,36,2,68,0.5294117647058824,46,-10,40,-4
2019-20,2019-12-22,New York Rangers,2,Metropolitan,Eastern,38,2,70,0.5428571428571428,46,-8,41,-3
2019-20,2019-12-24,New York Rangers,0,Metropolitan,Eastern,38,2,72,0.5277777777777778,47,-9,42,-4
2019-20,2019-12-28,New York Rangers,2,Metropolitan,Eastern,40,2,74,0.5405405405405406,48,-8,42,-2
2019-20,2019-12-29,New York Rangers,2,Metropolitan,Eastern,42,2,76,0.5526315789473685,50,-8,43,-1
2019-20,2020-01-01,New York Rangers,0,Metropolitan,Eastern,42,2,78,0.5384615384615384,52,-10,46,-4
2019-20,2020-01-03,New York Rangers,0,Metropolitan,Eastern,42,2,80,0.525,53,-11,48,-6
2019-20,2020-01-05,New York Rangers,0,Metropolitan,Eastern,42,2,82,0.5121951219512195,53,-11,49,-7
2019-20,2020-01-08,New York Rangers,2,Metropolitan,Eastern,44,2,84,0.5238095238095238,57,-13,50,-6
2019-20,2020-01-10,New York Rangers,2,Metropolitan,Eastern,46,2,86,0.5348837209302325,57,-11,52,-6
2019-20,2020-01-12,New York Rangers,0,Metropolitan,Eastern,46,2,88,0.5227272727272727,58,-12,52,-6
2019-20,2020-01-14,New York Rangers,2,Metropolitan,Eastern,48,2,90,0.5333333333333333,58,-10,54,-6
2019-20,2020-01-17,New York Rangers,2,Metropolitan,Eastern,50,2,92,0.5434782608695652,60,-10,56,-6
2019-20,2020-01-20,New York Rangers,0,Metropolitan,Eastern,50,2,94,0.5319148936170213,61,-11,58,-8
2019-20,2020-01-22,New York Rangers,0,Metropolitan,Eastern,50,2,96,0.5208333333333334,63,-13,60,-10
2019-20,2020-02-01,New York Rangers,2,Metropolitan,Eastern,52,2,98,0.5306122448979592,64,-12,61,-9
2019-20,2020-02-02,New York Rangers,2,Metropolitan,Eastern,54,2,100,0.54,65,-11,63,-9
2019-20,2020-02-04,New York Rangers,0,Metropolitan,Eastern,54,2,102,0.5294117647058824,65,-11,63,-9
2019-20,2020-02-06,New York Rangers,2,Metropolitan,Eastern,56,2,104,0.5384615384615384,67,-11,64,-8
2019-20,2020-02-08,New York Rangers,0,Metropolitan,Eastern,56,2,106,0.5283018867924528,69,-13,65,-9
2019-20,2020-02-09,New York Rangers,2,Metropolitan,Eastern,58,2,108,0.5370370370370371,69,-11,67,-9
2019-20,2020-02-12,New York Rangers,2,Metropolitan,Eastern,60,2,110,0.5454545454545454,72,-12,68,-8
2019-20,2020-02-14,New York Rangers,2,Metropolitan,Eastern,62,2,112,0.5535714285714286,72,-10,68,-6
2019-20,2020-02-15,New York Rangers,2,Metropolitan,Eastern,64,2,114,0.5614035087719298,72,-8,69,-5
2019-20,2020-02-16,New York Rangers,0,Metropolitan,Eastern,64,2,116,0.5517241379310345,72,-8,70,-6
2019-20,2020-02-20,New York Rangers,2,Metropolitan,Eastern,66,2,118,0.559322033898305,73,-7,72,-6
2019-20,2020-02-22,New York Rangers,2,Metropolitan,Eastern,68,2,120,0.5666666666666667,77,-9,72,-4
2019-20,2020-02-23,New York Rangers,2,Metropolitan,Eastern,70,2,122,0.5737704918032787,77,-7,74,-4
2019-20,2020-02-26,New York Rangers,2,Metropolitan,Eastern,72,2,124,0.5806451612903226,79,-7,74,-2
2019-20,2020-02-28,New York Rangers,2,Metropolitan,Eastern,74,2,126,0.5873015873015873,79,-5,76,-2
2019-20,2020-02-29,New York Rangers,0,Metropolitan,Eastern,74,2,128,0.578125,80,-6,76,-2
2019-20,2020-03-01,New York Rangers,0,Metropolitan,Eastern,74,2,130,0.5692307692307692,80,-6,76,-2
2019-20,2020-03-04,New York Rangers,0,Metropolitan,Eastern,74,2,132,0.5606060606060606,82,-8,78,-4
2019-20,2020-03-06,New York Rangers,2,Metropolitan,Eastern,76,2,134,0.5671641791044776,84,-8,78,-2
2019-20,2020-03-08,New York Rangers,0,Metropolitan,Eastern,76,2,136,0.5588235294117647,84,-8,79,-3
2019-20,2020-03-11,New York Rangers,2,Metropolitan,Eastern,78,2,138,0.5652173913043478,86,-8,81,-3
2019-20,2020-03-12,New York Rangers,1,Metropolitan,Eastern,79,2,140,0.5642857142857143,86,-7,81,-2
2019-20,2019-10-02,Ottawa Senators,0,Atlantic,Eastern,0,2,2,0.0,0,0,0,0
2019-20,2019-10-05,Ottawa Senators,0,Atlantic,Eastern,0,2,4,0.0,3,-3,2,-2
2019-20,2019-10-10,Ottawa Senators,0,Atlantic,Eastern,0,2,6,0.0,6,-6,4,-4
2019-20,2019-10-12,Ottawa Senators,2,Atlantic,Eastern,2,2,8,0.25,7,-5,5,-3
2019-20,2019-10-14,Ottawa Senators,0,Atlantic,Eastern,2,2,10,0.2,7,-5,6,-4
2019-20,2019-10-18,Ottawa Senators,1,Atlantic,Eastern,3,2,12,0.25,9,-6,8,-5
2019-20,2019-10-19,Ottawa Senators,0,Atlantic,Eastern,3,2,14,0.21428571428571427,11,-8,10,-7
2019-20,2019-10-22,Ottawa Senators,0,Atlantic,Eastern,3,2,16,0.1875,12,-9,10,-7
2019-20,2019-10-23,Ottawa Senators,2,Atlantic,Eastern,5,2,18,0.2777777777777778,12,-7,10,-5
2019-20,2019-10-25,Ottawa Senators,0,Atlantic,Eastern,5,2,20,0.25,14,-9,12,-7
2019-20,2019-10-27,Ottawa Senators,2,Atlantic,Eastern,7,2,22,0.3181818181818182,14,-7,14,-7
2019-20,2019-11-02,Ottawa Senators,0,Atlantic,Eastern,7,2,24,0.2916666666666667,18,-11,17,-10
2019-20,2019-11-05,Ottawa Senators,2,Atlantic,Eastern,9,2,26,0.34615384615384615,18,-9,17,-8
2019-20,2019-11-06,Ottawa Senators,0,Atlantic,Eastern,9,2,28,0.32142857142857145,19,-10,18,-9
2019-20,2019-11-08,Ottawa Senators,2,Atlantic,Eastern,11,2,30,0.36666666666666664,20,-9,19,-8
2019-20,2019-11-10,Ottawa Senators,2,Atlantic,Eastern,13,2,32,0.40625,21,-8,20,-7
2019-20,2019-11-12,Ottawa Senators,0,Atlantic,Eastern,13,2,34,0.38235294117647056,21,-8,21,-8
2019-20,2019-11-14,Ottawa Senators,2,Atlantic,Eastern,15,2,36,0.4166666666666667,23,-8,22,-7
2019-20,2019-11-16,Ottawa Senators,2,Atlantic,Eastern,17,2,38,0.4473684210526316,23,-6,22,-5
2019-20,2019-11-17,Ottawa Senators,0,Atlantic,Eastern,17,2,40,0.425,25,-8,24,-7
2019-20,2019-11-20,Ottawa Senators,2,Atlantic,Eastern,19,2,42,0.4523809523809524,26,-7,24,-5
2019-20,2019-11-21,Ottawa Senators,2,Atlantic,Eastern,21,2,44,0.4772727272727273,27,-6,24,-3
2019-20,2019-11-23,Ottawa Senators,2,Atlantic,Eastern,23,2,46,0.5,27,-4,27,-4
2019-20,2019-11-26,Ottawa Senators,0,Atlantic,Eastern,23,2,48,0.4791666666666667,27,-4,27,-4
2019-20,2019-11-28,Ottawa Senators,0,Atlantic,Eastern,23,2,50,0.46,28,-5,28,-5
2019-20,2019-11-29,Ottawa Senators,0,Atlantic,Eastern,23,2,52,0.4423076923076923,28,-5,28,-5
2019-20,2019-12-01,Ottawa Senators,0,Atlantic,Eastern,23,2,54,0.42592592592592593,30,-7,30,-7
2019-20,2019-12-04,Ottawa Senators,0,Atlantic,Eastern,23,2,56,0.4107142857142857,31,-8,31,-8
2019-20,2019-12-05,Ottawa Senators,2,Atlantic,Eastern,25,2,58,0.43103448275862066,31,-6,31,-6
2019-20,2019-12-07,Ottawa Senators,0,Atlantic,Eastern,25,2,60,0.4166666666666667,32,-7,32,-7
2019-20,2019-12-10,Ottawa Senators,2,Atlantic,Eastern,27,2,62,0.43548387096774194,34,-7,34,-7
2019-20,2019-12-12,Ottawa Senators,1,Atlantic,Eastern,28,2,64,0.4375,36,-8,36,-8
2019-20,2019-12-14,Ottawa Senators,2,Atlantic,Eastern,30,2,66,0.45454545454545453,36,-6,36,-6
2019-20,2019-12-17,Ottawa Senators,0,Atlantic,Eastern,30,2,68,0.4411764705882353,37,-7,37,-7
2019-20,2019-12-18,Ottawa Senators,1,Atlantic,Eastern,31,2,70,0.44285714285714284,38,-7,38,-7
2019-20,2019-12-20,Ottawa Senators,2,Atlantic,Eastern,33,2,72,0.4583333333333333,39,-6,39,-6
2019-20,2019-12-22,Ottawa Senators,1,Atlantic,Eastern,34,2,74,0.4594594594594595,41,-7,41,-7
2019-20,2019-12-24,Ottawa Senators,2,Atlantic,Eastern,36,2,76,0.47368421052631576,42,-6,42,-6
2019-20,2019-12-29,Ottawa Senators,1,Atlantic,Eastern,37,2,78,0.47435897435897434,43,-6,43,-6
2019-20,2019-12-31,Ottawa Senators,0,Atlantic,Eastern,37,2,80,0.4625,45,-8,45,-8
2019-20,2020-01-03,Ottawa Senators,0,Atlantic,Eastern,37,2,82,0.45121951219512196,48,-11,48,-11
2019-20,2020-01-05,Ottawa Senators,0,Atlantic,Eastern,37,2,84,0.44047619047619047,52,-15,49,-12
2019-20,2020-01-08,Ottawa Senators,0,Atlantic,Eastern,37,2,86,0.43023255813953487,53,-16,50,-13
2019-20,2020-01-11,Ottawa Senators,1,Atlantic,Eastern,38,2,88,0.4318181818181818,54,-16,52,-14
2019-20,2020-01-12,Ottawa Senators,1,Atlantic,Eastern,39,2,90,0.43333333333333335,54,-15,52,-13
2019-20,2020-01-15,Ottawa Senators,1,Atlantic,Eastern,40,2,92,0.43478260869565216,56,-16,54,-14
2019-20,2020-01-17,Ottawa Senators,0,Atlantic,Eastern,40,2,94,0.425531914893617,57,-17,56,-16
2019-20,2020-01-18,Ottawa Senators,2,Atlantic,Eastern,42,2,96,0.4375,57,-15,56,-14
2019-20,2020-01-28,Ottawa Senators,1,Atlantic,Eastern,43,2,98,0.4387755102040816,61,-18,61,-18
2019-20,2020-01-29,Ottawa Senators,2,Atlantic,Eastern,45,2,100,0.45,61,-16,61,-16
2019-20,2020-02-01,Ottawa Senators,0,Atlantic,Eastern,45,2,102,0.4411764705882353,61,-16,61,-16
2019-20,2020-02-02,Ottawa Senators,1,Atlantic,Eastern,46,2,104,0.4423076923076923,63,-17,63,-17
2019-20,2020-02-05,Ottawa Senators,1,Atlantic,Eastern,47,2,106,0.44339622641509435,64,-17,64,-17
2019-20,2020-02-07,Ottawa Senators,0,Atlantic,Eastern,47,2,108,0.4351851851851852,64,-17,65,-18
2019-20,2020-02-08,Ottawa Senators,0,Atlantic,Eastern,47,2,110,0.42727272727272725,65,-18,65,-18
2019-20,2020-02-12,Ottawa Senators,0,Atlantic,Eastern,47,2,112,0.41964285714285715,68,-21,68,-21
2019-20,2020-02-14,Ottawa Senators,2,Atlantic,Eastern,49,2,114,0.4298245614035088,68,-19,68,-19
2019-20,2020-02-16,Ottawa Senators,0,Atlantic,Eastern,49,2,116,0.4224137931034483,70,-21,70,-21
2019-20,2020-02-16,Ottawa Senators,2,Atlantic,Eastern,51,2,118,0.4322033898305085,70,-19,70,-19
2019-20,2020-02-19,Ottawa Senators,2,Atlantic,Eastern,53,2,120,0.44166666666666665,70,-17,72,-19
2019-20,2020-02-21,Ottawa Senators,0,Atlantic,Eastern,53,2,122,0.4344262295081967,72,-19,72,-19
2019-20,2020-02-23,Ottawa Senators,0,Atlantic,Eastern,53,2,124,0.4274193548387097,72,-19,74,-21
2019-20,2020-02-25,Ottawa Senators,1,Atlantic,Eastern,54,2,126,0.42857142857142855,72,-18,74,-20
2019-20,2020-02-26,Ottawa Senators,0,Atlantic,Eastern,54,2,128,0.421875,74,-20,74,-20
2019-20,2020-02-28,Ottawa Senators,2,Atlantic,Eastern,56,2,130,0.4307692307692308,76,-20,76,-20
2019-20,2020-03-01,Ottawa Senators,2,Atlantic,Eastern,58,2,132,0.4393939393939394,78,-20,76,-18
2019-20,2020-03-04,Ottawa Senators,0,Atlantic,Eastern,58,2,134,0.43283582089552236,78,-20,78,-20
2019-20,2020-03-06,Ottawa Senators,2,Atlantic,Eastern,60,2,136,0.4411764705882353,79,-19,78,-18
2019-20,2020-03-08,Ottawa Senators,2,Atlantic,Eastern,62,2,138,0.4492753623188406,79,-17,79,-17
2019-20,2020-03-11,Ottawa Senators,0,Atlantic,Eastern,62,2,140,0.44285714285714284,81,-19,81,-19
2019-20,2020-03-12,Ottawa Senators,0,Atlantic,Eastern,62,2,142,0.43661971830985913,81,-19,81,-19
2019-20,2019-10-05,Philadelphia Flyers,2,Metropolitan,Eastern,2,2,2,1.0,4,-2,2,0
2019-20,2019-10-09,Philadelphia Flyers,2,Metropolitan,Eastern,4,2,4,1.0,4,0,4,0
2019-20,2019-10-13,Philadelphia Flyers,1,Metropolitan,Eastern,5,2,6,0.8333333333333334,8,-3,6,-1
2019-20,2019-10-16,Philadelphia Flyers,0,Metropolitan,Eastern,5,2,8,0.625,10,-5,6,-1
2019-20,2019-10-17,Philadelphia Flyers,0,Metropolitan,Eastern,5,2,10,0.5,10,-5,8,-3
2019-20,2019-10-19,Philadelphia Flyers,0,Metropolitan,Eastern,5,2,12,0.4166666666666667,12,-7,10,-5
2019-20,2019-10-21,Philadelphia Flyers,2,Metropolitan,Eastern,7,2,14,0.5,12,-5,10,-3
2019-20,2019-10-25,Philadelphia Flyers,2,Metropolitan,Eastern,9,2,16,0.5625,13,-4,12,-3
2019-20,2019-10-26,Philadelphia Flyers,2,Metropolitan,Eastern,11,2,18,0.6111111111111112,14,-3,12,-1
2019-20,2019-10-27,Philadelphia Flyers,0,Metropolitan,Eastern,11,2,20,0.55,15,-4,14,-3
2019-20,2019-10-29,Philadelphia Flyers,0,Metropolitan,Eastern,11,2,22,0.5,16,-5,14,-3
2019-20,2019-11-01,Philadelphia Flyers,2,Metropolitan,Eastern,13,2,24,0.5416666666666666,18,-5,16,-3
2019-20,2019-11-02,Philadelphia Flyers,1,Metropolitan,Eastern,14,2,26,0.5384615384615384,19,-5,17,-3
2019-20,2019-11-06,Philadelphia Flyers,2,Metropolitan,Eastern,16,2,28,0.5714285714285714,19,-3,18,-2
2019-20,2019-11-08,Philadelphia Flyers,2,Metropolitan,Eastern,18,2,30,0.6,19,-1,19,-1
2019-20,2019-11-10,Philadelphia Flyers,2,Metropolitan,Eastern,20,2,32,0.625,21,-1,20,0
2019-20,2019-11-11,Philadelphia Flyers,2,Metropolitan,Eastern,22,2,34,0.6470588235294118,22,0,21,1
2019-20,2019-11-14,Philadelphia Flyers,1,Metropolitan,Eastern,23,2,36,0.6388888888888888,23,0,22,1
2019-20,2019-11-16,Philadelphia Flyers,0,Metropolitan,Eastern,23,2,38,0.6052631578947368,25,-2,22,1
2019-20,2019-11-17,Philadelphia Flyers,1,Metropolitan,Eastern,24,2,40,0.6,25,-1,24,0
2019-20,2019-11-20,Philadelphia Flyers,0,Metropolitan,Eastern,24,2,42,0.5714285714285714,27,-3,24,0
2019-20,2019-11-22,Philadelphia Flyers,2,Metropolitan,Eastern,26,2,44,0.5909090909090909,27,-1,26,0
2019-20,2019-11-23,Philadelphia Flyers,1,Metropolitan,Eastern,27,2,46,0.5869565217391305,28,-1,27,0
2019-20,2019-11-26,Philadelphia Flyers,2,Metropolitan,Eastern,29,2,48,0.6041666666666666,31,-2,27,2
2019-20,2019-11-28,Philadelphia Flyers,2,Metropolitan,Eastern,31,2,50,0.62,32,-1,28,3
2019-20,2019-11-29,Philadelphia Flyers,2,Metropolitan,Eastern,33,2,52,0.6346153846153846,33,0,28,5
2019-20,2019-11-30,Philadelphia Flyers,2,Metropolitan,Eastern,35,2,54,0.6481481481481481,34,1,29,6
2019-20,2019-12-04,Philadelphia Flyers,2,Metropolitan,Eastern,37,2,56,0.6607142857142857,37,0,31,6
2019-20,2019-12-06,Philadelphia Flyers,0,Metropolitan,Eastern,37,2,58,0.6379310344827587,37,0,31,6
2019-20,2019-12-07,Philadelphia Flyers,2,Metropolitan,Eastern,39,2,60,0.65,39,0,32,7
2019-20,2019-12-12,Philadelphia Flyers,0,Metropolitan,Eastern,39,2,62,0.6290322580645161,39,0,36,3
2019-20,2019-12-15,Philadelphia Flyers,0,Metropolitan,Eastern,39,2,64,0.609375,42,-3,36,3
2019-20,2019-12-15,Philadelphia Flyers,0,Metropolitan,Eastern,39,2,66,0.5909090909090909,42,-3,36,3
2019-20,2019-12-18,Philadelphia Flyers,2,Metropolitan,Eastern,41,2,68,0.6029411764705882,44,-3,38,3
2019-20,2019-12-20,Philadelphia Flyers,2,Metropolitan,Eastern,43,2,70,0.6142857142857143,46,-3,39,4
2019-20,2019-12-22,Philadelphia Flyers,2,Metropolitan,Eastern,45,2,72,0.625,46,-1,41,4
2019-20,2019-12-24,Philadelphia Flyers,2,Metropolitan,Eastern,47,2,74,0.6351351351351351,47,0,42,5
2019-20,2019-12-29,Philadelphia Flyers,0,Metropolitan,Eastern,47,2,76,0.618421052631579,50,-3,43,4
2019-20,2019-12-30,Philadelphia Flyers,2,Metropolitan,Eastern,49,2,78,0.6282051282051282,50,-1,45,4
2019-20,2020-01-01,Philadelphia Flyers,0,Metropolitan,Eastern,49,2,80,0.6125,52,-3,46,3
2019-20,2020-01-03,Philadelphia Flyers,0,Metropolitan,Eastern,49,2,82,0.5975609756097561,53,-4,48,1
2019-20,2020-01-05,Philadelphia Flyers,0,Metropolitan,Eastern,49,2,84,0.5833333333333334,53,-4,49,0
2019-20,2020-01-08,Philadelphia Flyers,1,Metropolitan,Eastern,50,2,86,0.5813953488372093,57,-7,50,0
2019-20,2020-01-09,Philadelphia Flyers,2,Metropolitan,Eastern,52,2,88,0.5909090909090909,57,-5,52,0
2019-20,2020-01-12,Philadelphia Flyers,0,Metropolitan,Eastern,52,2,90,0.5777777777777777,58,-6,52,0
2019-20,2020-01-14,Philadelphia Flyers,2,Metropolitan,Eastern,54,2,92,0.5869565217391305,58,-4,54,0
2019-20,2020-01-16,Philadelphia Flyers,2,Metropolitan,Eastern,56,2,94,0.5957446808510638,60,-4,56,0
2019-20,2020-01-17,Philadelphia Flyers,0,Metropolitan,Eastern,56,2,96,0.5833333333333334,60,-4,56,0
2019-20,2020-01-19,Philadelphia Flyers,2,Metropolitan,Eastern,58,2,98,0.5918367346938775,61,-3,58,0
2019-20,2020-01-22,Philadelphia Flyers,2,Metropolitan,Eastern,60,2,100,0.6,63,-3,60,0
2019-20,2020-02-01,Philadelphia Flyers,1,Metropolitan,Eastern,61,2,102,0.5980392156862745,64,-3,61,0
2019-20,2020-02-02,Philadelphia Flyers,2,Metropolitan,Eastern,63,2,104,0.6057692307692307,65,-2,63,0
2019-20,2020-02-04,Philadelphia Flyers,2,Metropolitan,Eastern,65,2,106,0.6132075471698113,65,0,63,2
2019-20,2020-02-07,Philadelphia Flyers,0,Metropolitan,Eastern,65,2,108,0.6018518518518519,68,-3,65,0
2019-20,2020-02-09,Philadelphia Flyers,2,Metropolitan,Eastern,67,2,110,0.6090909090909091,69,-2,67,0
2019-20,2020-02-11,Philadelphia Flyers,2,Metropolitan,Eastern,69,2,112,0.6160714285714286,70,-1,67,2
2019-20,2020-02-12,Philadelphia Flyers,0,Metropolitan,Eastern,69,2,114,0.6052631578947368,72,-3,68,1
2019-20,2020-02-14,Philadelphia Flyers,2,Metropolitan,Eastern,71,2,116,0.6120689655172413,72,-1,68,3
2019-20,2020-02-15,Philadelphia Flyers,0,Metropolitan,Eastern,71,2,118,0.6016949152542372,72,-1,69,2
2019-20,2020-02-19,Philadelphia Flyers,2,Metropolitan,Eastern,73,2,120,0.6083333333333333,73,0,72,1
2019-20,2020-02-21,Philadelphia Flyers,2,Metropolitan,Eastern,75,2,122,0.6147540983606558,75,0,72,3
2019-20,2020-02-22,Philadelphia Flyers,2,Metropolitan,Eastern,77,2,124,0.6209677419354839,77,0,72,5
2019-20,2020-02-26,Philadelphia Flyers,2,Metropolitan,Eastern,79,2,126,0.626984126984127,79,0,74,5
2019-20,2020-02-29,Philadelphia Flyers,2,Metropolitan,Eastern,81,2,128,0.6328125,80,1,76,5
2019-20,2020-03-01,Philadelphia Flyers,2,Metropolitan,Eastern,83,2,130,0.6384615384615384,80,3,76,7
2019-20,2020-03-05,Philadelphia Flyers,2,Metropolitan,Eastern,85,2,132,0.6439393939393939,82,3,78,7
2019-20,2020-03-06,Philadelphia Flyers,2,Metropolitan,Eastern,87,2,134,0.6492537313432836,84,3,78,9
2019-20,2020-03-08,Philadelphia Flyers,2,Metropolitan,Eastern,89,2,136,0.6544117647058824,84,5,79,10
2019-20,2020-03-10,Philadelphia Flyers,0,Metropolitan,Eastern,89,2,138,0.644927536231884,86,3,81,8
2019-20,2019-10-03,Pittsburgh Penguins,0,Metropolitan,Eastern,0,2,2,0.0,2,-2,0,0
2019-20,2019-10-05,Pittsburgh Penguins,2,Metropolitan,Eastern,2,2,4,0.5,4,-2,2,0
2019-20,2019-10-08,Pittsburgh Penguins,0,Metropolitan,Eastern,2,2,6,0.3333333333333333,4,-2,3,-1
2019-20,2019-10-10,Pittsburgh Penguins,2,Metropolitan,Eastern,4,2,8,0.5,4,0,4,0
2019-20,2019-10-13,Pittsburgh Penguins,2,Metropolitan,Eastern,6,2,10,0.6,8,-2,6,0
2019-20,2019-10-13,Pittsburgh Penguins,2,Metropolitan,Eastern,8,2,12,0.6666666666666666,8,0,6,2
2019-20,2019-10-16,Pittsburgh Penguins,2,Metropolitan,Eastern,10,2,14,0.7142857142857143,10,0,6,4
2019-20,2019-10-18,Pittsburgh Penguins,2,Metropolitan,Eastern,12,2,16,0.75,12,0,8,4
2019-20,2019-10-19,Pittsburgh Penguins,0,Metropolitan,Eastern,12,2,18,0.6666666666666666,12,0,10,2
2019-20,2019-10-22,Pittsburgh Penguins,0,Metropolitan,Eastern,12,2,20,0.6,12,0,10,2
2019-20,2019-10-24,Pittsburgh Penguins,0,Metropolitan,Eastern,12,2,22,0.5454545454545454,12,0,12,0
2019-20,2019-10-27,Pittsburgh Penguins,2,Metropolitan,Eastern,14,2,24,0.5833333333333334,15,-1,14,0
2019-20,2019-10-29,Pittsburgh Penguins,2,Metropolitan,Eastern,16,2,26,0.6153846153846154,16,0,14,2
2019-20,2019-11-02,Pittsburgh Penguins,1,Metropolitan,Eastern,17,2,28,0.6071428571428571,19,-2,17,0
2019-20,2019-11-05,Pittsburgh Penguins,0,Metropolitan,Eastern,17,2,30,0.5666666666666667,19,-2,17,0
2019-20,2019-11-08,Pittsburgh Penguins,2,Metropolitan,Eastern,19,2,32,0.59375,19,0,19,0
2019-20,2019-11-10,Pittsburgh Penguins,2,Metropolitan,Eastern,21,2,34,0.6176470588235294,21,0,20,1
2019-20,2019-11-13,Pittsburgh Penguins,1,Metropolitan,Eastern,22,2,36,0.6111111111111112,22,0,22,0
2019-20,2019-11-16,Pittsburgh Penguins,0,Metropolitan,Eastern,22,2,38,0.5789473684210527,25,-3,22,0
2019-20,2019-11-17,Pittsburgh Penguins,2,Metropolitan,Eastern,24,2,40,0.6,25,-1,24,0
2019-20,2019-11-20,Pittsburgh Penguins,1,Metropolitan,Eastern,25,2,42,0.5952380952380952,27,-2,24,1
2019-20,2019-11-22,Pittsburgh Penguins,1,Metropolitan,Eastern,26,2,44,0.5909090909090909,27,-1,26,0
2019-20,2019-11-23,Pittsburgh Penguins,2,Metropolitan,Eastern,28,2,46,0.6086956521739131,28,0,27,1
2019-20,2019-11-26,Pittsburgh Penguins,2,Metropolitan,Eastern,30,2,48,0.625,31,-1,27,3
2019-20,2019-11-28,Pittsburgh Penguins,2,Metropolitan,Eastern,32,2,50,0.64,32,0,28,4
2019-20,2019-11-30,Pittsburgh Penguins,0,Metropolitan,Eastern,32,2,52,0.6153846153846154,34,-2,29,3
2019-20,2019-12-01,Pittsburgh Penguins,0,Metropolitan,Eastern,32,2,54,0.5925925925925926,35,-3,30,2
2019-20,2019-12-05,Pittsburgh Penguins,2,Metropolitan,Eastern,34,2,56,0.6071428571428571,37,-3,31,3
2019-20,2019-12-07,Pittsburgh Penguins,2,Metropolitan,Eastern,36,2,58,0.6206896551724138,39,-3,32,4
2019-20,2019-12-08,Pittsburgh Penguins,2,Metropolitan,Eastern,38,2,60,0.6333333333333333,39,-1,32,6
2019-20,2019-12-11,Pittsburgh Penguins,0,Metropolitan,Eastern,38,2,62,0.6129032258064516,39,-1,35,3
2019-20,2019-12-13,Pittsburgh Penguins,2,Metropolitan,Eastern,40,2,64,0.625,40,0,36,4
2019-20,2019-12-15,Pittsburgh Penguins,2,Metropolitan,Eastern,42,2,66,0.6363636363636364,42,0,36,6
2019-20,2019-12-18,Pittsburgh Penguins,2,Metropolitan,Eastern,44,2,68,0.6470588235294118,44,0,38,6
2019-20,2019-12-21,Pittsburgh Penguins,2,Metropolitan,Eastern,46,2,70,0.6571428571428571,46,0,40,6
2019-20,2019-12-22,Pittsburgh Penguins,0,Metropolitan,Eastern,46,2,72,0.6388888888888888,46,0,41,5
2019-20,2019-12-28,Pittsburgh Penguins,2,Metropolitan,Eastern,48,2,74,0.6486486486486487,48,0,42,6
2019-20,2019-12-29,Pittsburgh Penguins,2,Metropolitan,Eastern,50,2,76,0.6578947368421053,50,0,43,7
2019-20,2019-12-31,Pittsburgh Penguins,2,Metropolitan,Eastern,52,2,78,0.6666666666666666,52,0,45,7
2019-20,2020-01-03,Pittsburgh Penguins,1,Metropolitan,Eastern,53,2,80,0.6625,53,0,48,5
2019-20,2020-01-05,Pittsburgh Penguins,0,Metropolitan,Eastern,53,2,82,0.6463414634146342,53,0,49,4
2019-20,2020-01-05,Pittsburgh Penguins,2,Metropolitan,Eastern,55,2,84,0.6547619047619048,53,2,49,6
2019-20,2020-01-08,Pittsburgh Penguins,2,Metropolitan,Eastern,57,2,86,0.6627906976744186,57,0,50,7
2019-20,2020-01-11,Pittsburgh Penguins,2,Metropolitan,Eastern,59,2,88,0.6704545454545454,57,2,52,7
2019-20,2020-01-12,Pittsburgh Penguins,2,Metropolitan,Eastern,61,2,90,0.6777777777777778,58,3,52,9
2019-20,2020-01-15,Pittsburgh Penguins,2,Metropolitan,Eastern,63,2,92,0.6847826086956522,60,3,54,9
2019-20,2020-01-17,Pittsburgh Penguins,0,Metropolitan,Eastern,63,2,94,0.6702127659574468,60,3,56,7
2019-20,2020-01-18,Pittsburgh Penguins,2,Metropolitan,Eastern,65,2,96,0.6770833333333334,60,5,56,9
2019-20,2020-01-19,Pittsburgh Penguins,2,Metropolitan,Eastern,67,2,98,0.6836734693877551,61,6,58,9
2019-20,2020-01-22,Pittsburgh Penguins,0,Metropolitan,Eastern,67,2,100,0.67,63,4,60,7
2019-20,2020-02-01,Pittsburgh Penguins,2,Metropolitan,Eastern,69,2,102,0.6764705882352942,64,5,61,8
2019-20,2020-02-02,Pittsburgh Penguins,2,Metropolitan,Eastern,71,2,104,0.6826923076923077,65,6,63,8
2019-20,2020-02-07,Pittsburgh Penguins,0,Metropolitan,Eastern,71,2,106,0.6698113207547169,68,3,65,6
2019-20,2020-02-09,Pittsburgh Penguins,2,Metropolitan,Eastern,73,2,108,0.6759259259259259,69,4,67,6
2019-20,2020-02-12,Pittsburgh Penguins,1,Metropolitan,Eastern,74,2,110,0.6727272727272727,72,2,68,6
2019-20,2020-02-15,Pittsburgh Penguins,2,Metropolitan,Eastern,76,2,112,0.6785714285714286,72,4,69,7
2019-20,2020-02-16,Pittsburgh Penguins,2,Metropolitan,Eastern,78,2,114,0.6842105263157895,72,6,70,8
2019-20,2020-02-19,Pittsburgh Penguins,2,Metropolitan,Eastern,80,2,116,0.6896551724137931,73,7,72,8
2019-20,2020-02-21,Pittsburgh Penguins,0,Metropolitan,Eastern,80,2,118,0.6779661016949152,75,5,72,8
2019-20,2020-02-22,Pittsburgh Penguins,0,Metropolitan,Eastern,80,2,120,0.6666666666666666,77,3,72,8
2019-20,2020-02-23,Pittsburgh Penguins,0,Metropolitan,Eastern,80,2,122,0.6557377049180327,77,3,74,6
2019-20,2020-02-27,Pittsburgh Penguins,0,Metropolitan,Eastern,80,2,124,0.6451612903225806,79,1,74,6
2019-20,2020-02-29,Pittsburgh Penguins,0,Metropolitan,Eastern,80,2,126,0.6349206349206349,80,0,76,4
2019-20,2020-03-01,Pittsburgh Penguins,0,Metropolitan,Eastern,80,2,128,0.625,80,0,76,4
2019-20,2020-03-04,Pittsburgh Penguins,2,Metropolitan,Eastern,82,2,130,0.6307692307692307,82,0,78,4
2019-20,2020-03-06,Pittsburgh Penguins,2,Metropolitan,Eastern,84,2,132,0.6363636363636364,84,0,78,6
2019-20,2020-03-07,Pittsburgh Penguins,0,Metropolitan,Eastern,84,2,134,0.6268656716417911,84,0,79,5
2019-20,2020-03-08,Pittsburgh Penguins,0,Metropolitan,Eastern,84,2,136,0.6176470588235294,84,0,79,5
2019-20,2020-03-10,Pittsburgh Penguins,2,Metropolitan,Eastern,86,2,138,0.6231884057971014,86,0,81,5
2019-20,2019-10-03,San Jose Sharks,0,Pacific,Western,0,2,2,0.0,0,0,0,0
2019-20,2019-10-05,San Jose Sharks,0,Pacific,Western,0,2,4,0.0,2,-2,0,0
2019-20,2019-10-06,San Jose Sharks,0,Pacific,Western,0,2,6,0.0,4,-4,2,-2
2019-20,2019-10-09,San Jose Sharks,0,Pacific,Western,0,2,8,0.0,4,-4,3,-3
2019-20,2019-10-11,San Jose Sharks,2,Pacific,Western,2,2,10,0.2,5,-3,4,-2
2019-20,2019-10-14,San Jose Sharks,2,Pacific,Western,4,2,12,0.3333333333333333,8,-4,5,-1
2019-20,2019-10-17,San Jose Sharks,2,Pacific,Western,6,2,14,0.42857142857142855,8,-2,7,-1
2019-20,2019-10-20,San Jose Sharks,0,Pacific,Western,6,2,16,0.375,12,-6,9,-3
2019-20,2019-10-22,San Jose Sharks,1,Pacific,Western,7,2,18,0.3888888888888889,12,-5,11,-4
2019-20,2019-10-24,San Jose Sharks,2,Pacific,Western,9,2,20,0.45,12,-3,11,-2
2019-20,2019-10-25,San Jose Sharks,0,Pacific,Western,9,2,22,0.4090909090909091,13,-4,12,-3
2019-20,2019-10-27,San Jose Sharks,0,Pacific,Western,9,2,24,0.375,14,-5,13,-4
2019-20,2019-10-29,San Jose Sharks,0,Pacific,Western,9,2,26,0.34615384615384615,15,-6,14,-5
2019-20,2019-11-02,San Jose Sharks,0,Pacific,Western,9,2,28,0.32142857142857145,18,-9,17,-8
2019-20,2019-11-03,San Jose Sharks,0,Pacific,Western,9,2,30,0.3,18,-9,18,-9
2019-20,2019-11-06,San Jose Sharks,2,Pacific,Western,11,2,32,0.34375,20,-9,19,-8
2019-20,2019-11-08,San Jose Sharks,2,Pacific,Western,13,2,34,0.38235294117647056,21,-8,20,-7
2019-20,2019-11-10,San Jose Sharks,2,Pacific,Western,15,2,36,0.4166666666666667,21,-6,21,-6
2019-20,2019-11-13,San Jose Sharks,2,Pacific,Western,17,2,38,0.4473684210526316,23,-6,21,-4
2019-20,2019-11-15,San Jose Sharks,2,Pacific,Western,19,2,40,0.475,23,-4,22,-3
2019-20,2019-11-17,San Jose Sharks,2,Pacific,Western,21,2,42,0.5,24,-3,23,-2
2019-20,2019-11-20,San Jose Sharks,0,Pacific,Western,21,2,44,0.4772727272727273,25,-4,24,-3
2019-20,2019-11-22,San Jose Sharks,2,Pacific,Western,23,2,46,0.5,26,-3,26,-3
2019-20,2019-11-24,San Jose Sharks,2,Pacific,Western,25,2,48,0.5208333333333334,28,-3,26,-1
2019-20,2019-11-26,San Jose Sharks,2,Pacific,Western,27,2,50,0.54,28,-1,27,0
2019-20,2019-11-28,San Jose Sharks,0,Pacific,Western,27,2,52,0.5192307692307693,28,-1,28,-1
2019-20,2019-11-29,San Jose Sharks,2,Pacific,Western,29,2,54,0.5370370370370371,30,-1,29,0
2019-20,2019-12-01,San Jose Sharks,2,Pacific,Western,31,2,56,0.5535714285714286,31,0,30,1
2019-20,2019-12-04,San Jose Sharks,0,Pacific,Western,31,2,58,0.5344827586206896,34,-3,32,-1
2019-20,2019-12-06,San Jose Sharks,1,Pacific,Western,32,2,60,0.5333333333333333,35,-3,32,0
2019-20,2019-12-08,San Jose Sharks,0,Pacific,Western,32,2,62,0.5161290322580645,35,-3,34,-2
2019-20,2019-12-08,San Jose Sharks,0,Pacific,Western,32,2,64,0.5,35,-3,34,-2
2019-20,2019-12-11,San Jose Sharks,0,Pacific,Western,32,2,66,0.48484848484848486,38,-6,37,-5
2019-20,2019-12-13,San Jose Sharks,0,Pacific,Western,32,2,68,0.47058823529411764,40,-8,37,-5
2019-20,2019-12-15,San Jose Sharks,2,Pacific,Western,34,2,70,0.4857142857142857,40,-6,39,-5
2019-20,2019-12-18,San Jose Sharks,0,Pacific,Western,34,2,72,0.4722222222222222,42,-8,40,-6
2019-20,2019-12-22,San Jose Sharks,0,Pacific,Western,34,2,74,0.4594594594594595,44,-10,41,-7
2019-20,2019-12-23,San Jose Sharks,0,Pacific,Western,34,2,76,0.4473684210526316,44,-10,43,-9
2019-20,2019-12-28,San Jose Sharks,1,Pacific,Western,35,2,78,0.44871794871794873,45,-10,44,-9
2019-20,2019-12-29,San Jose Sharks,2,Pacific,Western,37,2,80,0.4625,45,-8,44,-7
2019-20,2020-01-01,San Jose Sharks,0,Pacific,Western,37,2,82,0.45121951219512196,46,-9,46,-9
2019-20,2020-01-03,San Jose Sharks,2,Pacific,Western,39,2,84,0.4642857142857143,48,-9,47,-8
2019-20,2020-01-04,San Jose Sharks,2,Pacific,Western,41,2,86,0.47674418604651164,49,-8,48,-7
2019-20,2020-01-05,San Jose Sharks,1,Pacific,Western,42,2,88,0.4772727272727273,50,-8,48,-6
2019-20,2020-01-08,San Jose Sharks,0,Pacific,Western,42,2,90,0.4666666666666667,51,-9,50,-8
2019-20,2020-01-10,San Jose Sharks,2,Pacific,Western,44,2,92,0.4782608695652174,53,-9,52,-8
2019-20,2020-01-12,San Jose Sharks,2,Pacific,Western,46,2,94,0.48936170212765956,54,-8,53,-7
2019-20,2020-01-15,San Jose Sharks,0,Pacific,Western,46,2,96,0.4791666666666667,55,-9,54,-8
2019-20,2020-01-17,San Jose Sharks,0,Pacific,Western,46,2,98,0.46938775510204084,56,-10,55,-9
2019-20,2020-01-19,San Jose Sharks,0,Pacific,Western,46,2,100,0.46,57,-11,57,-11
2019-20,2020-01-28,San Jose Sharks,2,Pacific,Western,48,2,102,0.47058823529411764,57,-9,57,-9
2019-20,2020-01-30,San Jose Sharks,0,Pacific,Western,48,2,104,0.46153846153846156,58,-10,57,-9
2019-20,2020-02-02,San Jose Sharks,0,Pacific,Western,48,2,106,0.4528301886792453,61,-13,59,-11
2019-20,2020-02-05,San Jose Sharks,2,Pacific,Western,50,2,108,0.46296296296296297,61,-11,60,-10
2019-20,2020-02-07,San Jose Sharks,2,Pacific,Western,52,2,110,0.4727272727272727,62,-10,60,-8
2019-20,2020-02-11,San Jose Sharks,0,Pacific,Western,52,2,112,0.4642857142857143,64,-12,63,-11
2019-20,2020-02-15,San Jose Sharks,2,Pacific,Western,54,2,114,0.47368421052631576,66,-12,64,-10
2019-20,2020-02-15,San Jose Sharks,2,Pacific,Western,56,2,116,0.4827586206896552,66,-10,64,-8
2019-20,2020-02-17,San Jose Sharks,0,Pacific,Western,56,2,118,0.4745762711864407,69,-13,68,-12
2019-20,2020-02-21,San Jose Sharks,0,Pacific,Western,56,2,120,0.4666666666666667,70,-14,68,-12
2019-20,2020-02-23,San Jose Sharks,0,Pacific,Western,56,2,122,0.45901639344262296,71,-15,69,-13
2019-20,2020-02-23,San Jose Sharks,0,Pacific,Western,56,2,124,0.45161290322580644,71,-15,69,-13
2019-20,2020-02-26,San Jose Sharks,0,Pacific,Western,56,2,126,0.4444444444444444,74,-18,70,-14
2019-20,2020-02-28,San Jose Sharks,2,Pacific,Western,58,2,128,0.453125,74,-16,72,-14
2019-20,2020-03-01,San Jose Sharks,2,Pacific,Western,60,2,130,0.46153846153846156,75,-15,72,-12
2019-20,2020-03-04,San Jose Sharks,2,Pacific,Western,62,2,132,0.4696969696969697,75,-13,74,-12
2019-20,2020-03-06,San Jose Sharks,0,Pacific,Western,62,2,134,0.4626865671641791,77,-15,74,-12
2019-20,2020-03-08,San Jose Sharks,1,Pacific,Western,63,2,136,0.4632352941176471,79,-16,76,-13
2019-20,2020-03-09,San Jose Sharks,0,Pacific,Western,63,2,138,0.45652173913043476,79,-16,76,-13
2019-20,2020-03-12,San Jose Sharks,0,Pacific,Western,63,2,140,0.45,79,-16,78,-15
2019-20,2019-10-03,St. Louis Blues,1,Central,Western,1,2,2,0.5,0,1,0,1
2019-20,2019-10-06,St. Louis Blues,2,Central,Western,3,2,4,0.75,2,1,2,1
2019-20,2019-10-07,St. Louis Blues,2,Central,Western,5,2,6,0.8333333333333334,2,3,2,3
2019-20,2019-10-10,St. Louis Blues,2,Central,Western,7,2,8,0.875,4,3,3,4
2019-20,2019-10-12,St. Louis Blues,0,Central,Western,7,2,10,0.7,6,1,4,3
2019-20,2019-10-14,St. Louis Blues,1,Central,Western,8,2,12,0.6666666666666666,8,0,5,3
2019-20,2019-10-18,St. Louis Blues,1,Central,Western,9,2,14,0.6428571428571429,8,1,8,1
2019-20,2019-10-19,St. Louis Blues,0,Central,Western,9,2,16,0.5625,8,1,8,1
2019-20,2019-10-22,St. Louis Blues,2,Central,Western,11,2,18,0.6111111111111112,10,1,11,0
2019-20,2019-10-25,St. Louis Blues,2,Central,Western,13,2,20,0.65,13,0,12,1
2019-20,2019-10-26,St. Louis Blues,0,Central,Western,13,2,22,0.5909090909090909,13,0,13,0
2019-20,2019-10-27,St. Louis Blues,2,Central,Western,15,2,24,0.625,15,0,13,2
2019-20,2019-10-31,St. Louis Blues,2,Central,Western,17,2,26,0.6538461538461539,17,0,15,2
2019-20,2019-11-02,St. Louis Blues,2,Central,Western,19,2,28,0.6785714285714286,18,1,17,2
2019-20,2019-11-03,St. Louis Blues,2,Central,Western,21,2,30,0.7,18,3,18,3
2019-20,2019-11-06,St. Louis Blues,2,Central,Western,23,2,32,0.71875,18,5,19,4
2019-20,2019-11-07,St. Louis Blues,2,Central,Western,25,2,34,0.7352941176470589,18,7,19,6
2019-20,2019-11-10,St. Louis Blues,2,Central,Western,27,2,36,0.75,21,6,21,6
2019-20,2019-11-13,St. Louis Blues,1,Central,Western,28,2,38,0.7368421052631579,21,7,21,7
2019-20,2019-11-16,St. Louis Blues,1,Central,Western,29,2,40,0.725,24,5,23,6
2019-20,2019-11-17,St. Louis Blues,0,Central,Western,29,2,42,0.6904761904761905,25,4,23,6
2019-20,2019-11-20,St. Louis Blues,2,Central,Western,31,2,44,0.7045454545454546,27,4,24,7
2019-20,2019-11-22,St. Louis Blues,2,Central,Western,33,2,46,0.717391304347826,28,5,26,7
2019-20,2019-11-24,St. Louis Blues,0,Central,Western,33,2,48,0.6875,29,4,26,7
2019-20,2019-11-26,St. Louis Blues,1,Central,Western,34,2,50,0.68,29,5,27,7
2019-20,2019-11-28,St. Louis Blues,2,Central,Western,36,2,52,0.6923076923076923,31,5,28,8
2019-20,2019-11-30,St. Louis Blues,2,Central,Western,38,2,54,0.7037037037037037,32,6,29,9
2019-20,2019-12-01,St. Louis Blues,2,Central,Western,40,2,56,0.7142857142857143,33,7,30,10
2019-20,2019-12-03,St. Louis Blues,2,Central,Western,42,2,58,0.7241379310344828,33,9,31,11
2019-20,2019-12-05,St. Louis Blues,0,Central,Western,42,2,60,0.7,35,7,32,10
2019-20,2019-12-08,St. Louis Blues,0,Central,Western,42,2,62,0.6774193548387096,38,4,34,8
2019-20,2019-12-11,St. Louis Blues,0,Central,Western,42,2,64,0.65625,40,2,37,5
2019-20,2019-12-13,St. Louis Blues,2,Central,Western,44,2,66,0.6666666666666666,40,4,37,7
2019-20,2019-12-15,St. Louis Blues,2,Central,Western,46,2,68,0.6764705882352942,42,4,39,7
2019-20,2019-12-17,St. Louis Blues,2,Central,Western,48,2,70,0.6857142857142857,42,6,40,8
2019-20,2019-12-19,St. Louis Blues,2,Central,Western,50,2,72,0.6944444444444444,42,8,40,10
2019-20,2019-12-22,St. Louis Blues,2,Central,Western,52,2,74,0.7027027027027027,44,8,41,11
2019-20,2019-12-24,St. Louis Blues,2,Central,Western,54,2,76,0.7105263157894737,44,10,43,11
2019-20,2019-12-28,St. Louis Blues,2,Central,Western,56,2,78,0.717948717948718,45,11,44,12
2019-20,2019-12-29,St. Louis Blues,2,Central,Western,58,2,80,0.725,46,12,44,14
2019-20,2020-01-01,St. Louis Blues,0,Central,Western,58,2,82,0.7073170731707317,50,8,46,12
2019-20,2020-01-03,St. Louis Blues,0,Central,Western,58,2,84,0.6904761904761905,50,8,47,11
2019-20,2020-01-04,St. Louis Blues,1,Central,Western,59,2,86,0.686046511627907,52,7,48,11
2019-20,2020-01-08,St. Louis Blues,2,Central,Western,61,2,88,0.6931818181818182,52,9,50,11
2019-20,2020-01-10,St. Louis Blues,2,Central,Western,63,2,90,0.7,54,9,52,11
2019-20,2020-01-12,St. Louis Blues,2,Central,Western,65,2,92,0.7065217391304348,55,10,53,12
2019-20,2020-01-14,St. Louis Blues,2,Central,Western,67,2,94,0.7127659574468085,55,12,53,14
2019-20,2020-01-16,St. Louis Blues,1,Central,Western,68,2,96,0.7083333333333334,56,12,54,14
2019-20,2020-01-18,St. Louis Blues,0,Central,Western,68,2,98,0.6938775510204082,58,10,56,12
2019-20,2020-01-28,St. Louis Blues,0,Central,Western,68,2,100,0.68,60,8,57,11
2019-20,2020-01-29,St. Louis Blues,2,Central,Western,70,2,102,0.6862745098039216,60,10,57,13
2019-20,2020-02-01,St. Louis Blues,0,Central,Western,70,2,104,0.6730769230769231,60,10,58,12
2019-20,2020-02-02,St. Louis Blues,0,Central,Western,70,2,106,0.660377358490566,62,8,59,11
2019-20,2020-02-05,St. Louis Blues,2,Central,Western,72,2,108,0.6666666666666666,64,8,60,12
2019-20,2020-02-07,St. Louis Blues,0,Central,Western,72,2,110,0.6545454545454545,65,7,60,12
2019-20,2020-02-09,St. Louis Blues,1,Central,Western,73,2,112,0.6517857142857143,67,6,61,12
2019-20,2020-02-14,St. Louis Blues,1,Central,Western,74,2,114,0.6491228070175439,71,3,64,10
2019-20,2020-02-15,St. Louis Blues,0,Central,Western,74,2,116,0.6379310344827587,71,3,64,10
2019-20,2020-02-16,St. Louis Blues,0,Central,Western,74,2,118,0.6271186440677966,72,2,66,8
2019-20,2020-02-19,St. Louis Blues,2,Central,Western,76,2,120,0.6333333333333333,73,3,68,8
2019-20,2020-02-21,St. Louis Blues,2,Central,Western,78,2,122,0.639344262295082,75,3,68,10
2019-20,2020-02-22,St. Louis Blues,2,Central,Western,80,2,124,0.6451612903225806,76,4,68,12
2019-20,2020-02-24,St. Louis Blues,2,Central,Western,82,2,126,0.6507936507936508,78,4,70,12
2019-20,2020-02-26,St. Louis Blues,2,Central,Western,84,2,128,0.65625,79,5,70,14
2019-20,2020-02-28,St. Louis Blues,2,Central,Western,86,2,130,0.6615384615384615,80,6,72,14
2019-20,2020-03-01,St. Louis Blues,2,Central,Western,88,2,132,0.6666666666666666,81,7,72,16
2019-20,2020-03-04,St. Louis Blues,2,Central,Western,90,2,134,0.6716417910447762,82,8,74,16
2019-20,2020-03-07,St. Louis Blues,0,Central,Western,90,2,136,0.6617647058823529,82,8,76,14
2019-20,2020-03-08,St. Louis Blues,2,Central,Western,92,2,138,0.6666666666666666,82,10,76,16
2019-20,2020-03-10,St. Louis Blues,0,Central,Western,92,2,140,0.6571428571428571,82,10,78,14
2019-20,2020-03-12,St. Louis Blues,2,Central,Western,94,2,142,0.6619718309859155,82,12,78,16
2019-20,2019-10-03,Tampa Bay Lightning,2,Atlantic,Eastern,2,2,2,1.0,2,0,0,2
2019-20,2019-10-05,Tampa Bay Lightning,0,Atlantic,Eastern,2,2,4,0.5,3,-1,2,0
2019-20,2019-10-06,Tampa Bay Lightning,1,Atlantic,Eastern,3,2,6,0.5,4,-1,3,0
2019-20,2019-10-10,Tampa Bay Lightning,2,Atlantic,Eastern,5,2,8,0.625,6,-1,4,1
2019-20,2019-10-12,Tampa Bay Lightning,0,Atlantic,Eastern,5,2,10,0.5,7,-2,5,0
2019-20,2019-10-15,Tampa Bay Lightning,2,Atlantic,Eastern,7,2,12,0.5833333333333334,9,-2,6,1
2019-20,2019-10-17,Tampa Bay Lightning,2,Atlantic,Eastern,9,2,14,0.6428571428571429,9,0,8,1
2019-20,2019-10-19,Tampa Bay Lightning,0,Atlantic,Eastern,9,2,16,0.5625,11,-2,10,-1
2019-20,2019-10-24,Tampa Bay Lightning,2,Atlantic,Eastern,11,2,18,0.6111111111111112,12,-1,12,-1
2019-20,2019-10-26,Tampa Bay Lightning,1,Atlantic,Eastern,12,2,20,0.6,14,-2,12,0
2019-20,2019-10-29,Tampa Bay Lightning,0,Atlantic,Eastern,12,2,22,0.5454545454545454,15,-3,14,-2
2019-20,2019-10-30,Tampa Bay Lightning,2,Atlantic,Eastern,14,2,24,0.5833333333333334,15,-1,14,0
2019-20,2019-11-01,Tampa Bay Lightning,0,Atlantic,Eastern,14,2,26,0.5384615384615384,16,-2,16,-2
2019-20,2019-11-09,Tampa Bay Lightning,2,Atlantic,Eastern,16,2,28,0.5714285714285714,20,-4,19,-3
2019-20,2019-11-10,Tampa Bay Lightning,2,Atlantic,Eastern,18,2,30,0.6,21,-3,20,-2
2019-20,2019-11-15,Tampa Bay Lightning,2,Atlantic,Eastern,20,2,32,0.625,23,-3,22,-2
2019-20,2019-11-16,Tampa Bay Lightning,0,Atlantic,Eastern,20,2,34,0.5882352941176471,23,-3,22,-2
2019-20,2019-11-20,Tampa Bay Lightning,0,Atlantic,Eastern,20,2,36,0.5555555555555556,26,-6,24,-4
2019-20,2019-11-22,Tampa Bay Lightning,2,Atlantic,Eastern,22,2,38,0.5789473684210527,27,-5,26,-4
2019-20,2019-11-24,Tampa Bay Lightning,2,Atlantic,Eastern,24,2,40,0.6,27,-3,27,-3
2019-20,2019-11-26,Tampa Bay Lightning,2,Atlantic,Eastern,26,2,42,0.6190476190476191,27,-1,27,-1
2019-20,2019-11-28,Tampa Bay Lightning,0,Atlantic,Eastern,26,2,44,0.5909090909090909,28,-2,28,-2
2019-20,2019-11-29,Tampa Bay Lightning,1,Atlantic,Eastern,27,2,46,0.5869565217391305,28,-1,28,-1
2019-20,2019-12-01,Tampa Bay Lightning,0,Atlantic,Eastern,27,2,48,0.5625,30,-3,30,-3
2019-20,2019-12-04,Tampa Bay Lightning,2,Atlantic,Eastern,29,2,50,0.58,31,-2,31,-2
2019-20,2019-12-06,Tampa Bay Lightning,0,Atlantic,Eastern,29,2,52,0.5576923076923077,31,-2,31,-2
2019-20,2019-12-08,Tampa Bay Lightning,2,Atlantic,Eastern,31,2,54,0.5740740740740741,32,-1,32,-1
2019-20,2019-12-10,Tampa Bay Lightning,0,Atlantic,Eastern,31,2,56,0.5535714285714286,34,-3,34,-3
2019-20,2019-12-11,Tampa Bay Lightning,2,Atlantic,Eastern,33,2,58,0.5689655172413793,35,-2,35,-2
2019-20,2019-12-13,Tampa Bay Lightning,2,Atlantic,Eastern,35,2,60,0.5833333333333334,36,-1,36,-1
2019-20,2019-12-15,Tampa Bay Lightning,0,Atlantic,Eastern,35,2,62,0.5645161290322581,36,-1,36,-1
2019-20,2019-12-18,Tampa Bay Lightning,2,Atlantic,Eastern,37,2,64,0.578125,38,-1,38,-1
2019-20,2019-12-20,Tampa Bay Lightning,1,Atlantic,Eastern,38,2,66,0.5757575757575758,39,-1,39,-1
2019-20,2019-12-22,Tampa Bay Lightning,0,Atlantic,Eastern,38,2,68,0.5588235294117647,41,-3,41,-3
2019-20,2019-12-24,Tampa Bay Lightning,2,Atlantic,Eastern,40,2,70,0.5714285714285714,42,-2,42,-2
2019-20,2019-12-29,Tampa Bay Lightning,2,Atlantic,Eastern,42,2,72,0.5833333333333334,43,-1,43,-1
2019-20,2019-12-30,Tampa Bay Lightning,2,Atlantic,Eastern,44,2,74,0.5945945945945946,45,-1,45,-1
2019-20,2020-01-01,Tampa Bay Lightning,2,Atlantic,Eastern,46,2,76,0.6052631578947368,46,0,46,0
2019-20,2020-01-03,Tampa Bay Lightning,2,Atlantic,Eastern,48,2,78,0.6153846153846154,48,0,48,0
2019-20,2020-01-05,Tampa Bay Lightning,2,Atlantic,Eastern,50,2,80,0.625,52,-2,49,1
2019-20,2020-01-05,Tampa Bay Lightning,2,Atlantic,Eastern,52,2,82,0.6341463414634146,52,0,49,3
2019-20,2020-01-08,Tampa Bay Lightning,2,Atlantic,Eastern,54,2,84,0.6428571428571429,53,1,50,4
2019-20,2020-01-10,Tampa Bay Lightning,2,Atlantic,Eastern,56,2,86,0.6511627906976745,54,2,52,4
2019-20,2020-01-12,Tampa Bay Lightning,2,Atlantic,Eastern,58,2,88,0.6590909090909091,54,4,52,6
2019-20,2020-01-13,Tampa Bay Lightning,0,Atlantic,Eastern,58,2,90,0.6444444444444445,54,4,53,5
2019-20,2020-01-15,Tampa Bay Lightning,2,Atlantic,Eastern,60,2,92,0.6521739130434783,56,4,54,6
2019-20,2020-01-17,Tampa Bay Lightning,0,Atlantic,Eastern,60,2,94,0.6382978723404256,57,3,56,4
2019-20,2020-01-18,Tampa Bay Lightning,2,Atlantic,Eastern,62,2,96,0.6458333333333334,57,5,56,6
2019-20,2020-01-28,Tampa Bay Lightning,1,Atlantic,Eastern,63,2,98,0.6428571428571429,61,2,61,2
2019-20,2020-01-30,Tampa Bay Lightning,2,Atlantic,Eastern,65,2,100,0.65,61,4,61,4
2019-20,2020-02-01,Tampa Bay Lightning,2,Atlantic,Eastern,67,2,102,0.6568627450980392,61,6,61,6
2019-20,2020-02-02,Tampa Bay Lightning,2,Atlantic,Eastern,69,2,104,0.6634615384615384,63,6,63,6
2019-20,2020-02-05,Tampa Bay Lightning,2,Atlantic,Eastern,71,2,106,0.6698113207547169,64,7,64,7
2019-20,2020-02-07,Tampa Bay Lightning,2,Atlantic,Eastern,73,2,108,0.6759259259259259,64,9,65,8
2019-20,2020-02-09,Tampa Bay Lightning,2,Atlantic,Eastern,75,2,110,0.6818181818181818,66,9,67,8
2019-20,2020-02-11,Tampa Bay Lightning,2,Atlantic,Eastern,77,2,112,0.6875,66,11,67,10
2019-20,2020-02-12,Tampa Bay Lightning,2,Atlantic,Eastern,79,2,114,0.6929824561403509,68,11,68,11
2019-20,2020-02-14,Tampa Bay Lightning,2,Atlantic,Eastern,81,2,116,0.6982758620689655,68,13,68,13
2019-20,2020-02-15,Tampa Bay Lightning,2,Atlantic,Eastern,83,2,118,0.7033898305084746,68,15,69,14
2019-20,2020-02-18,Tampa Bay Lightning,2,Atlantic,Eastern,85,2,120,0.7083333333333334,70,15,70,15
2019-20,2020-02-21,Tampa Bay Lightning,0,Atlantic,Eastern,85,2,122,0.6967213114754098,72,13,72,13
2019-20,2020-02-23,Tampa Bay Lightning,0,Atlantic,Eastern,85,2,124,0.6854838709677419,72,13,74,11
2019-20,2020-02-26,Tampa Bay Lightning,0,Atlantic,Eastern,85,2,126,0.6746031746031746,74,11,74,11
2019-20,2020-02-28,Tampa Bay Lightning,0,Atlantic,Eastern,85,2,128,0.6640625,76,9,76,9
2019-20,2020-02-29,Tampa Bay Lightning,2,Atlantic,Eastern,87,2,130,0.6692307692307692,76,11,76,11
2019-20,2020-03-04,Tampa Bay Lightning,0,Atlantic,Eastern,87,2,132,0.6590909090909091,78,9,78,9
2019-20,2020-03-06,Tampa Bay Lightning,2,Atlantic,Eastern,89,2,134,0.664179104477612,79,10,78,11
2019-20,2020-03-08,Tampa Bay Lightning,2,Atlantic,Eastern,91,2,136,0.6691176470588235,79,12,79,12
2019-20,2020-03-08,Tampa Bay Lightning,1,Atlantic,Eastern,92,2,138,0.6666666666666666,79,13,79,13
2019-20,2020-03-10,Tampa Bay Lightning,0,Atlantic,Eastern,92,2,140,0.6571428571428571,81,11,81,11
2019-20,2019-10-02,Toronto Maple Leafs,2,Atlantic,Eastern,2,2,2,1.0,0,2,0,2
2019-20,2019-10-04,Toronto Maple Leafs,2,Atlantic,Eastern,4,2,4,1.0,2,2,1,3
2019-20,2019-10-05,Toronto Maple Leafs,1,Atlantic,Eastern,5,2,6,0.8333333333333334,3,2,2,3
2019-20,2019-10-07,Toronto Maple Leafs,0,Atlantic,Eastern,5,2,8,0.625,4,1,3,2
2019-20,2019-10-10,Toronto Maple Leafs,0,Atlantic,Eastern,5,2,10,0.5,6,-1,4,1
2019-20,2019-10-12,Toronto Maple Leafs,2,Atlantic,Eastern,7,2,12,0.5833333333333334,7,0,5,2
2019-20,2019-10-15,Toronto Maple Leafs,2,Atlantic,Eastern,9,2,14,0.6428571428571429,9,0,6,3
2019-20,2019-10-16,Toronto Maple Leafs,0,Atlantic,Eastern,9,2,16,0.5625,9,0,6,3
2019-20,2019-10-19,Toronto Maple Leafs,2,Atlantic,Eastern,11,2,18,0.6111111111111112,11,0,10,1
2019-20,2019-10-21,Toronto Maple Leafs,1,Atlantic,Eastern,12,2,20,0.6,12,0,10,2
2019-20,2019-10-22,Toronto Maple Leafs,0,Atlantic,Eastern,12,2,22,0.5454545454545454,12,0,10,2
2019-20,2019-10-25,Toronto Maple Leafs,2,Atlantic,Eastern,14,2,24,0.5833333333333334,14,0,12,2
2019-20,2019-10-26,Toronto Maple Leafs,0,Atlantic,Eastern,14,2,26,0.5384615384615384,14,0,12,2
2019-20,2019-10-29,Toronto Maple Leafs,1,Atlantic,Eastern,15,2,28,0.5357142857142857,15,0,14,1
2019-20,2019-11-02,Toronto Maple Leafs,2,Atlantic,Eastern,17,2,30,0.5666666666666667,18,-1,17,0
2019-20,2019-11-06,Toronto Maple Leafs,2,Atlantic,Eastern,19,2,32,0.59375,19,0,18,1
2019-20,2019-11-08,Toronto Maple Leafs,2,Atlantic,Eastern,21,2,34,0.6176470588235294,20,1,19,2
2019-20,2019-11-10,Toronto Maple Leafs,1,Atlantic,Eastern,22,2,36,0.6111111111111112,21,1,20,2
2019-20,2019-11-11,Toronto Maple Leafs,0,Atlantic,Eastern,22,2,38,0.5789473684210527,21,1,21,1
2019-20,2019-11-14,Toronto Maple Leafs,0,Atlantic,Eastern,22,2,40,0.55,23,-1,22,0
2019-20,2019-11-16,Toronto Maple Leafs,0,Atlantic,Eastern,22,2,42,0.5238095238095238,23,-1,22,0
2019-20,2019-11-17,Toronto Maple Leafs,0,Atlantic,Eastern,22,2,44,0.5,25,-3,24,-2
2019-20,2019-11-20,Toronto Maple Leafs,0,Atlantic,Eastern,22,2,46,0.4782608695652174,26,-4,24,-2
2019-20,2019-11-22,Toronto Maple Leafs,2,Atlantic,Eastern,24,2,48,0.5,27,-3,26,-2
2019-20,2019-11-24,Toronto Maple Leafs,2,Atlantic,Eastern,26,2,50,0.52,27,-1,27,-1
2019-20,2019-11-28,Toronto Maple Leafs,2,Atlantic,Eastern,28,2,52,0.5384615384615384,28,0,28,0
2019-20,2019-11-29,Toronto Maple Leafs,0,Atlantic,Eastern,28,2,54,0.5185185185185185,28,0,28,0
2019-20,2019-12-01,Toronto Maple Leafs,2,Atlantic,Eastern,30,2,56,0.5357142857142857,30,0,30,0
2019-20,2019-12-04,Toronto Maple Leafs,0,Atlantic,Eastern,30,2,58,0.5172413793103449,31,-1,31,-1
2019-20,2019-12-05,Toronto Maple Leafs,0,Atlantic,Eastern,30,2,60,0.5,31,-1,31,-1
2019-20,2019-12-08,Toronto Maple Leafs,2,Atlantic,Eastern,32,2,62,0.5161290322580645,32,0,32,0
2019-20,2019-12-11,Toronto Maple Leafs,2,Atlantic,Eastern,34,2,64,0.53125,35,-1,35,-1
2019-20,2019-12-13,Toronto Maple Leafs,0,Atlantic,Eastern,34,2,66,0.5151515151515151,36,-2,36,-2
2019-20,2019-12-15,Toronto Maple Leafs,2,Atlantic,Eastern,36,2,68,0.5294117647058824,36,0,36,0
2019-20,2019-12-18,Toronto Maple Leafs,2,Atlantic,Eastern,38,2,70,0.5428571428571428,38,0,38,0
2019-20,2019-12-21,Toronto Maple Leafs,2,Atlantic,Eastern,40,2,72,0.5555555555555556,40,0,40,0
2019-20,2019-12-22,Toronto Maple Leafs,2,Atlantic,Eastern,42,2,74,0.5675675675675675,41,1,41,1
2019-20,2019-12-23,Toronto Maple Leafs,2,Atlantic,Eastern,44,2,76,0.5789473684210527,41,3,41,3
2019-20,2019-12-28,Toronto Maple Leafs,2,Atlantic,Eastern,46,2,78,0.5897435897435898,42,4,42,4
2019-20,2019-12-29,Toronto Maple Leafs,1,Atlantic,Eastern,47,2,80,0.5875,43,4,43,4
2019-20,2019-12-31,Toronto Maple Leafs,2,Atlantic,Eastern,49,2,82,0.5975609756097561,45,4,45,4
2019-20,2020-01-03,Toronto Maple Leafs,2,Atlantic,Eastern,51,2,84,0.6071428571428571,48,3,48,3
2019-20,2020-01-05,Toronto Maple Leafs,2,Atlantic,Eastern,53,2,86,0.6162790697674418,52,1,49,4
2019-20,2020-01-07,Toronto Maple Leafs,0,Atlantic,Eastern,53,2,88,0.6022727272727273,52,1,49,4
2019-20,2020-01-09,Toronto Maple Leafs,1,Atlantic,Eastern,54,2,90,0.6,54,0,52,2
2019-20,2020-01-13,Toronto Maple Leafs,0,Atlantic,Eastern,54,2,92,0.5869565217391305,54,0,53,1
2019-20,2020-01-15,Toronto Maple Leafs,2,Atlantic,Eastern,56,2,94,0.5957446808510638,56,0,54,2
2019-20,2020-01-17,Toronto Maple Leafs,1,Atlantic,Eastern,57,2,96,0.59375,57,0,56,1
2019-20,2020-01-19,Toronto Maple Leafs,0,Atlantic,Eastern,57,2,98,0.5816326530612245,57,0,58,-1
2019-20,2020-01-28,Toronto Maple Leafs,2,Atlantic,Eastern,59,2,100,0.59,61,-2,61,-2
2019-20,2020-01-30,Toronto Maple Leafs,2,Atlantic,Eastern,61,2,102,0.5980392156862745,61,0,61,0
2019-20,2020-02-02,Toronto Maple Leafs,2,Atlantic,Eastern,63,2,104,0.6057692307692307,63,0,63,0
2019-20,2020-02-04,Toronto Maple Leafs,0,Atlantic,Eastern,63,2,106,0.5943396226415094,63,0,63,0
2019-20,2020-02-06,Toronto Maple Leafs,0,Atlantic,Eastern,63,2,108,0.5833333333333334,64,-1,64,-1
2019-20,2020-02-08,Toronto Maple Leafs,2,Atlantic,Eastern,65,2,110,0.5909090909090909,65,0,65,0
2019-20,2020-02-09,Toronto Maple Leafs,1,Atlantic,Eastern,66,2,112,0.5892857142857143,66,0,67,-1
2019-20,2020-02-12,Toronto Maple Leafs,2,Atlantic,Eastern,68,2,114,0.5964912280701754,68,0,68,0
2019-20,2020-02-14,Toronto Maple Leafs,0,Atlantic,Eastern,68,2,116,0.5862068965517241,68,0,68,0
2019-20,2020-02-16,Toronto Maple Leafs,2,Atlantic,Eastern,70,2,118,0.5932203389830508,70,0,70,0
2019-20,2020-02-17,Toronto Maple Leafs,0,Atlantic,Eastern,70,2,120,0.5833333333333334,70,0,70,0
2019-20,2020-02-19,Toronto Maple Leafs,0,Atlantic,Eastern,70,2,122,0.5737704918032787,70,0,72,-2
2019-20,2020-02-21,Toronto Maple Leafs,2,Atlantic,Eastern,72,2,124,0.5806451612903226,72,0,72,0
2019-20,2020-02-23,Toronto Maple Leafs,0,Atlantic,Eastern,72,2,126,0.5714285714285714,72,0,74,-2
2019-20,2020-02-26,Toronto Maple Leafs,2,Atlantic,Eastern,74,2,128,0.578125,74,0,74,0
2019-20,2020-02-28,Toronto Maple Leafs,2,Atlantic,Eastern,76,2,130,0.5846153846153846,76,0,76,0
2019-20,2020-03-01,Toronto Maple Leafs,2,Atlantic,Eastern,78,2,132,0.5909090909090909,78,0,76,2
2019-20,2020-03-04,Toronto Maple Leafs,0,Atlantic,Eastern,78,2,134,0.582089552238806,78,0,78,0
2019-20,2020-03-06,Toronto Maple Leafs,1,Atlantic,Eastern,79,2,136,0.5808823529411765,79,0,78,1
2019-20,2020-03-07,Toronto Maple Leafs,0,Atlantic,Eastern,79,2,138,0.572463768115942,79,0,79,0
2019-20,2020-03-10,Toronto Maple Leafs,2,Atlantic,Eastern,81,2,140,0.5785714285714286,81,0,81,0
2019-20,2019-10-03,Vancouver Canucks,0,Pacific,Western,0,2,2,0.0,0,0,0,0
2019-20,2019-10-06,Vancouver Canucks,0,Pacific,Western,0,2,4,0.0,4,-4,2,-2
2019-20,2019-10-10,Vancouver Canucks,2,Pacific,Western,2,2,6,0.3333333333333333,4,-2,3,-1
2019-20,2019-10-13,Vancouver Canucks,2,Pacific,Western,4,2,8,0.5,6,-2,5,-1
2019-20,2019-10-16,Vancouver Canucks,2,Pacific,Western,6,2,10,0.6,8,-2,7,-1
2019-20,2019-10-18,Vancouver Canucks,2,Pacific,Western,8,2,12,0.6666666666666666,10,-2,8,0
2019-20,2019-10-19,Vancouver Canucks,0,Pacific,Western,8,2,14,0.5714285714285714,12,-4,8,0
2019-20,2019-10-20,Vancouver Canucks,2,Pacific,Western,10,2,16,0.625,12,-2,9,1
2019-20,2019-10-22,Vancouver Canucks,2,Pacific,Western,12,2,18,0.6666666666666666,12,0,11,1
2019-20,2019-10-26,Vancouver Canucks,1,Pacific,Western,13,2,20,0.65,13,0,13,0
2019-20,2019-10-29,Vancouver Canucks,2,Pacific,Western,15,2,22,0.6818181818181818,15,0,14,1
2019-20,2019-10-31,Vancouver Canucks,2,Pacific,Western,17,2,24,0.7083333333333334,16,1,15,2
2019-20,2019-11-02,Vancouver Canucks,1,Pacific,Western,18,2,26,0.6923076923076923,18,0,17,1
2019-20,2019-11-03,Vancouver Canucks,2,Pacific,Western,20,2,28,0.7142857142857143,18,2,18,2
2019-20,2019-11-06,Vancouver Canucks,1,Pacific,Western,21,2,30,0.7,20,1,19,2
2019-20,2019-11-08,Vancouver Canucks,0,Pacific,Western,21,2,32,0.65625,21,0,20,1
2019-20,2019-11-09,Vancouver Canucks,0,Pacific,Western,21,2,34,0.6176470588235294,21,0,20,1
2019-20,2019-11-10,Vancouver Canucks,0,Pacific,Western,21,2,36,0.5833333333333334,21,0,21,0
2019-20,2019-11-13,Vancouver Canucks,2,Pacific,Western,23,2,38,0.6052631578947368,23,0,21,2
2019-20,2019-11-15,Vancouver Canucks,0,Pacific,Western,23,2,40,0.575,23,0,22,1
2019-20,2019-11-17,Vancouver Canucks,1,Pacific,Western,24,2,42,0.5714285714285714,24,0,23,1
2019-20,2019-11-20,Vancouver Canucks,0,Pacific,Western,24,2,44,0.5454545454545454,25,-1,24,0
2019-20,2019-11-22,Vancouver Canucks,2,Pacific,Western,26,2,46,0.5652173913043478,26,0,26,0
2019-20,2019-11-23,Vancouver Canucks,2,Pacific,Western,28,2,48,0.5833333333333334,28,0,26,2
2019-20,2019-11-26,Vancouver Canucks,0,Pacific,Western,28,2,50,0.56,28,0,27,1
2019-20,2019-11-28,Vancouver Canucks,0,Pacific,Western,28,2,52,0.5384615384615384,28,0,28,0
2019-20,2019-12-01,Vancouver Canucks,2,Pacific,Western,30,2,54,0.5555555555555556,31,-1,30,0
2019-20,2019-12-02,Vancouver Canucks,0,Pacific,Western,30,2,56,0.5357142857142857,31,-1,30,0
2019-20,2019-12-04,Vancouver Canucks,2,Pacific,Western,32,2,58,0.5517241379310345,34,-2,32,0
2019-20,2019-12-07,Vancouver Canucks,2,Pacific,Western,34,2,60,0.5666666666666667,35,-1,34,0
2019-20,2019-12-11,Vancouver Canucks,0,Pacific,Western,34,2,62,0.5483870967741935,38,-4,37,-3
2019-20,2019-12-13,Vancouver Canucks,2,Pacific,Western,36,2,64,0.5625,40,-4,37,-1
2019-20,2019-12-15,Vancouver Canucks,0,Pacific,Western,36,2,66,0.5454545454545454,40,-4,39,-3
2019-20,2019-12-16,Vancouver Canucks,0,Pacific,Western,36,2,68,0.5294117647058824,40,-4,40,-4
2019-20,2019-12-18,Vancouver Canucks,0,Pacific,Western,36,2,70,0.5142857142857142,42,-6,40,-4
2019-20,2019-12-20,Vancouver Canucks,2,Pacific,Western,38,2,72,0.5277777777777778,42,-4,41,-3
2019-20,2019-12-22,Vancouver Canucks,2,Pacific,Western,40,2,74,0.5405405405405406,44,-4,41,-1
2019-20,2019-12-24,Vancouver Canucks,2,Pacific,Western,42,2,76,0.5526315789473685,44,-2,43,-1
2019-20,2019-12-29,Vancouver Canucks,2,Pacific,Western,44,2,78,0.5641025641025641,45,-1,44,0
2019-20,2019-12-30,Vancouver Canucks,2,Pacific,Western,46,2,80,0.575,46,0,45,1
2019-20,2020-01-03,Vancouver Canucks,2,Pacific,Western,48,2,82,0.5853658536585366,48,0,47,1
2019-20,2020-01-05,Vancouver Canucks,2,Pacific,Western,50,2,84,0.5952380952380952,50,0,48,2
2019-20,2020-01-08,Vancouver Canucks,0,Pacific,Western,50,2,86,0.5813953488372093,51,-1,50,0
2019-20,2020-01-10,Vancouver Canucks,0,Pacific,Western,50,2,88,0.5681818181818182,53,-3,52,-2
2019-20,2020-01-11,Vancouver Canucks,2,Pacific,Western,52,2,90,0.5777777777777777,53,-1,52,0
2019-20,2020-01-12,Vancouver Canucks,2,Pacific,Western,54,2,92,0.5869565217391305,54,0,53,1
2019-20,2020-01-15,Vancouver Canucks,0,Pacific,Western,54,2,94,0.574468085106383,55,-1,54,0
2019-20,2020-01-17,Vancouver Canucks,2,Pacific,Western,56,2,96,0.5833333333333334,56,0,55,1
2019-20,2020-01-19,Vancouver Canucks,2,Pacific,Western,58,2,98,0.5918367346938775,57,1,57,1
2019-20,2020-01-28,Vancouver Canucks,2,Pacific,Western,60,2,100,0.6,57,3,57,3
2019-20,2020-01-30,Vancouver Canucks,2,Pacific,Western,62,2,102,0.6078431372549019,58,4,57,5
2019-20,2020-02-01,Vancouver Canucks,2,Pacific,Western,64,2,104,0.6153846153846154,60,4,58,6
2019-20,2020-02-02,Vancouver Canucks,1,Pacific,Western,65,2,106,0.6132075471698113,61,4,59,6
2019-20,2020-02-05,Vancouver Canucks,0,Pacific,Western,65,2,108,0.6018518518518519,61,4,60,5
2019-20,2020-02-07,Vancouver Canucks,0,Pacific,Western,65,2,110,0.5909090909090909,62,3,60,5
2019-20,2020-02-09,Vancouver Canucks,0,Pacific,Western,65,2,112,0.5803571428571429,64,1,61,4
2019-20,2020-02-11,Vancouver Canucks,2,Pacific,Western,67,2,114,0.5877192982456141,64,3,63,4
2019-20,2020-02-13,Vancouver Canucks,2,Pacific,Western,69,2,116,0.5948275862068966,64,5,64,5
2019-20,2020-02-16,Vancouver Canucks,0,Pacific,Western,69,2,118,0.5847457627118644,68,1,66,3
2019-20,2020-02-20,Vancouver Canucks,1,Pacific,Western,70,2,120,0.5833333333333334,70,0,68,2
2019-20,2020-02-23,Vancouver Canucks,2,Pacific,Western,72,2,122,0.5901639344262295,71,1,69,3
2019-20,2020-02-26,Vancouver Canucks,2,Pacific,Western,74,2,124,0.5967741935483871,74,0,70,4
2019-20,2020-02-28,Vancouver Canucks,0,Pacific,Western,74,2,126,0.5873015873015873,74,0,72,2
2019-20,2020-03-01,Vancouver Canucks,0,Pacific,Western,74,2,128,0.578125,75,-1,72,2
2019-20,2020-03-02,Vancouver Canucks,0,Pacific,Western,74,2,130,0.5692307692307692,75,-1,72,2
2019-20,2020-03-05,Vancouver Canucks,0,Pacific,Western,74,2,132,0.5606060606060606,77,-3,74,0
2019-20,2020-03-07,Vancouver Canucks,2,Pacific,Western,76,2,134,0.5671641791044776,79,-3,76,0
2019-20,2020-03-09,Vancouver Canucks,0,Pacific,Western,76,2,136,0.5588235294117647,79,-3,76,0
2019-20,2020-03-11,Vancouver Canucks,2,Pacific,Western,78,2,138,0.5652173913043478,79,-1,78,0
2019-20,2019-10-03,Vegas Golden Knights,2,Pacific,Western,2,2,2,1.0,0,2,0,2
2019-20,2019-10-05,Vegas Golden Knights,2,Pacific,Western,4,2,4,1.0,2,2,0,4
2019-20,2019-10-09,Vegas Golden Knights,0,Pacific,Western,4,2,6,0.6666666666666666,4,0,3,1
2019-20,2019-10-11,Vegas Golden Knights,0,Pacific,Western,4,2,8,0.5,5,-1,4,0
2019-20,2019-10-13,Vegas Golden Knights,2,Pacific,Western,6,2,10,0.6,6,0,5,1
2019-20,2019-10-14,Vegas Golden Knights,2,Pacific,Western,8,2,12,0.6666666666666666,8,0,5,3
2019-20,2019-10-16,Vegas Golden Knights,0,Pacific,Western,8,2,14,0.5714285714285714,8,0,7,1
2019-20,2019-10-18,Vegas Golden Knights,2,Pacific,Western,10,2,16,0.625,10,0,8,2
2019-20,2019-10-19,Vegas Golden Knights,2,Pacific,Western,12,2,18,0.6666666666666666,12,0,8,4
2019-20,2019-10-21,Vegas Golden Knights,0,Pacific,Western,12,2,20,0.6,12,0,9,3
2019-20,2019-10-23,Vegas Golden Knights,2,Pacific,Western,14,2,22,0.6363636363636364,12,2,11,3
2019-20,2019-10-25,Vegas Golden Knights,0,Pacific,Western,14,2,24,0.5833333333333334,13,1,12,2
2019-20,2019-10-28,Vegas Golden Knights,2,Pacific,Western,16,2,26,0.6153846153846154,15,1,14,2
2019-20,2019-11-01,Vegas Golden Knights,1,Pacific,Western,17,2,28,0.6071428571428571,17,0,16,1
2019-20,2019-11-03,Vegas Golden Knights,1,Pacific,Western,18,2,30,0.6,18,0,18,0
2019-20,2019-11-06,Vegas Golden Knights,2,Pacific,Western,20,2,32,0.625,20,0,19,1
2019-20,2019-11-08,Vegas Golden Knights,1,Pacific,Western,21,2,34,0.6176470588235294,21,0,20,1
2019-20,2019-11-10,Vegas Golden Knights,0,Pacific,Western,21,2,36,0.5833333333333334,21,0,21,0
2019-20,2019-11-10,Vegas Golden Knights,0,Pacific,Western,21,2,38,0.5526315789473685,21,0,21,0
2019-20,2019-11-14,Vegas Golden Knights,0,Pacific,Western,21,2,40,0.525,23,-2,21,0
2019-20,2019-11-16,Vegas Golden Knights,0,Pacific,Western,21,2,42,0.5,23,-2,23,-2
2019-20,2019-11-18,Vegas Golden Knights,2,Pacific,Western,23,2,44,0.5227272727272727,24,-1,23,0
2019-20,2019-11-20,Vegas Golden Knights,2,Pacific,Western,25,2,46,0.5434782608695652,25,0,24,1
2019-20,2019-11-22,Vegas Golden Knights,1,Pacific,Western,26,2,48,0.5416666666666666,26,0,26,0
2019-20,2019-11-24,Vegas Golden Knights,0,Pacific,Western,26,2,50,0.52,28,-2,26,0
2019-20,2019-11-26,Vegas Golden Knights,0,Pacific,Western,26,2,52,0.5,28,-2,27,-1
2019-20,2019-11-28,Vegas Golden Knights,2,Pacific,Western,28,2,54,0.5185185185185185,28,0,28,0
2019-20,2019-11-29,Vegas Golden Knights,2,Pacific,Western,30,2,56,0.5357142857142857,30,0,29,1
2019-20,2019-12-03,Vegas Golden Knights,2,Pacific,Western,32,2,58,0.5517241379310345,32,0,31,1
2019-20,2019-12-04,Vegas Golden Knights,2,Pacific,Western,34,2,60,0.5666666666666667,34,0,32,2
2019-20,2019-12-06,Vegas Golden Knights,1,Pacific,Western,35,2,62,0.5645161290322581,35,0,32,3
2019-20,2019-12-09,Vegas Golden Knights,0,Pacific,Western,35,2,64,0.546875,35,0,34,1
2019-20,2019-12-11,Vegas Golden Knights,2,Pacific,Western,37,2,66,0.5606060606060606,38,-1,37,0
2019-20,2019-12-13,Vegas Golden Knights,0,Pacific,Western,37,2,68,0.5441176470588235,40,-3,37,0
2019-20,2019-12-14,Vegas Golden Knights,2,Pacific,Western,39,2,70,0.5571428571428572,40,-1,39,0
2019-20,2019-12-16,Vegas Golden Knights,2,Pacific,Western,41,2,72,0.5694444444444444,40,1,40,1
2019-20,2019-12-18,Vegas Golden Knights,2,Pacific,Western,43,2,74,0.581081081081081,42,1,40,3
2019-20,2019-12-20,Vegas Golden Knights,1,Pacific,Western,44,2,76,0.5789473684210527,42,2,41,3
2019-20,2019-12-23,Vegas Golden Knights,2,Pacific,Western,46,2,78,0.5897435897435898,44,2,43,3
2019-20,2019-12-24,Vegas Golden Knights,0,Pacific,Western,46,2,80,0.575,44,2,43,3
2019-20,2019-12-28,Vegas Golden Knights,0,Pacific,Western,46,2,82,0.5609756097560976,45,1,44,2
2019-20,2019-12-29,Vegas Golden Knights,2,Pacific,Western,48,2,84,0.5714285714285714,45,3,44,4
2019-20,2019-12-31,Vegas Golden Knights,2,Pacific,Western,50,2,86,0.5813953488372093,46,4,45,5
2019-20,2020-01-03,Vegas Golden Knights,2,Pacific,Western,52,2,88,0.5909090909090909,48,4,47,5
2019-20,2020-01-04,Vegas Golden Knights,2,Pacific,Western,54,2,90,0.6,49,5,48,6
2019-20,2020-01-08,Vegas Golden Knights,0,Pacific,Western,54,2,92,0.5869565217391305,51,3,50,4
2019-20,2020-01-10,Vegas Golden Knights,0,Pacific,Western,54,2,94,0.574468085106383,53,1,52,2
2019-20,2020-01-12,Vegas Golden Knights,0,Pacific,Western,54,2,96,0.5625,54,0,53,1
2019-20,2020-01-15,Vegas Golden Knights,0,Pacific,Western,54,2,98,0.5510204081632653,55,-1,54,0
2019-20,2020-01-17,Vegas Golden Knights,2,Pacific,Western,56,2,100,0.56,56,0,55,1
2019-20,2020-01-19,Vegas Golden Knights,1,Pacific,Western,57,2,102,0.5588235294117647,57,0,57,0
2019-20,2020-01-22,Vegas Golden Knights,0,Pacific,Western,57,2,104,0.5480769230769231,57,0,57,0
2019-20,2020-02-01,Vegas Golden Knights,2,Pacific,Western,59,2,106,0.5566037735849056,60,-1,58,1
2019-20,2020-02-02,Vegas Golden Knights,2,Pacific,Western,61,2,108,0.5648148148148148,61,0,59,2
2019-20,2020-02-05,Vegas Golden Knights,0,Pacific,Western,61,2,110,0.5545454545454546,61,0,60,1
2019-20,2020-02-07,Vegas Golden Knights,2,Pacific,Western,63,2,112,0.5625,62,1,60,3
2019-20,2020-02-09,Vegas Golden Knights,1,Pacific,Western,64,2,114,0.5614035087719298,64,0,61,3
2019-20,2020-02-12,Vegas Golden Knights,0,Pacific,Western,64,2,116,0.5517241379310345,64,0,64,0
2019-20,2020-02-14,Vegas Golden Knights,2,Pacific,Western,66,2,118,0.559322033898305,66,0,64,2
2019-20,2020-02-16,Vegas Golden Knights,2,Pacific,Western,68,2,120,0.5666666666666667,68,0,66,2
2019-20,2020-02-17,Vegas Golden Knights,2,Pacific,Western,70,2,122,0.5737704918032787,69,1,68,2
2019-20,2020-02-21,Vegas Golden Knights,2,Pacific,Western,72,2,124,0.5806451612903226,70,2,68,4
2019-20,2020-02-23,Vegas Golden Knights,2,Pacific,Western,74,2,126,0.5873015873015873,71,3,69,5
2019-20,2020-02-24,Vegas Golden Knights,2,Pacific,Western,76,2,128,0.59375,72,4,70,6
2019-20,2020-02-27,Vegas Golden Knights,2,Pacific,Western,78,2,130,0.6,74,4,70,8
2019-20,2020-02-29,Vegas Golden Knights,2,Pacific,Western,80,2,132,0.6060606060606061,74,6,72,8
2019-20,2020-03-02,Vegas Golden Knights,0,Pacific,Western,80,2,134,0.5970149253731343,75,5,72,8
2019-20,2020-03-04,Vegas Golden Knights,2,Pacific,Western,82,2,136,0.6029411764705882,75,7,74,8
2019-20,2020-03-07,Vegas Golden Knights,0,Pacific,Western,82,2,138,0.5942028985507246,79,3,76,6
2019-20,2020-03-08,Vegas Golden Knights,2,Pacific,Western,84,2,140,0.6,79,5,76,8
2019-20,2020-03-10,Vegas Golden Knights,2,Pacific,Western,86,2,142,0.6056338028169014,79,7,78,8
2019-20,2019-10-03,Washington Capitals,2,Metropolitan,Eastern,2,2,2,1.0,2,0,0,2
2019-20,2019-10-04,Washington Capitals,2,Metropolitan,Eastern,4,2,4,1.0,2,2,1,3
2019-20,2019-10-05,Washington Capitals,1,Metropolitan,Eastern,5,2,6,0.8333333333333334,4,1,2,3
2019-20,2019-10-08,Washington Capitals,1,Metropolitan,Eastern,6,2,8,0.75,4,2,3,3
2019-20,2019-10-11,Washington Capitals,0,Metropolitan,Eastern,6,2,10,0.6,4,2,4,2
2019-20,2019-10-13,Washington Capitals,2,Metropolitan,Eastern,8,2,12,0.6666666666666666,8,0,6,2
2019-20,2019-10-14,Washington Capitals,0,Metropolitan,Eastern,8,2,14,0.5714285714285714,8,0,6,2
2019-20,2019-10-16,Washington Capitals,2,Metropolitan,Eastern,10,2,16,0.625,10,0,6,4
2019-20,2019-10-18,Washington Capitals,2,Metropolitan,Eastern,12,2,18,0.6666666666666666,12,0,8,4
2019-20,2019-10-20,Washington Capitals,2,Metropolitan,Eastern,14,2,20,0.7,12,2,10,4
2019-20,2019-10-23,Washington Capitals,2,Metropolitan,Eastern,16,2,22,0.7272727272727273,12,4,10,6
2019-20,2019-10-25,Washington Capitals,1,Metropolitan,Eastern,17,2,24,0.7083333333333334,13,4,12,5
2019-20,2019-10-26,Washington Capitals,2,Metropolitan,Eastern,19,2,26,0.7307692307692307,14,5,12,7
2019-20,2019-10-29,Washington Capitals,2,Metropolitan,Eastern,21,2,28,0.75,16,5,14,7
2019-20,2019-11-01,Washington Capitals,2,Metropolitan,Eastern,23,2,30,0.7666666666666667,18,5,16,7
2019-20,2019-11-04,Washington Capitals,2,Metropolitan,Eastern,25,2,32,0.78125,19,6,17,8
2019-20,2019-11-08,Washington Capitals,2,Metropolitan,Eastern,27,2,34,0.7941176470588235,19,8,19,8
2019-20,2019-11-10,Washington Capitals,2,Metropolitan,Eastern,29,2,36,0.8055555555555556,21,8,20,9
2019-20,2019-11-12,Washington Capitals,1,Metropolitan,Eastern,30,2,38,0.7894736842105263,22,8,21,9
2019-20,2019-11-14,Washington Capitals,2,Metropolitan,Eastern,32,2,40,0.8,23,9,22,10
2019-20,2019-11-16,Washington Capitals,0,Metropolitan,Eastern,32,2,42,0.7619047619047619,25,7,22,10
2019-20,2019-11-17,Washington Capitals,2,Metropolitan,Eastern,34,2,44,0.7727272727272727,25,9,24,10
2019-20,2019-11-19,Washington Capitals,2,Metropolitan,Eastern,36,2,46,0.782608695652174,25,11,24,12
2019-20,2019-11-21,Washington Capitals,0,Metropolitan,Eastern,36,2,48,0.75,27,9,24,12
2019-20,2019-11-23,Washington Capitals,1,Metropolitan,Eastern,37,2,50,0.74,28,9,27,10
2019-20,2019-11-28,Washington Capitals,2,Metropolitan,Eastern,39,2,52,0.75,32,7,28,11
2019-20,2019-11-29,Washington Capitals,2,Metropolitan,Eastern,41,2,54,0.7592592592592593,33,8,28,13
2019-20,2019-12-01,Washington Capitals,2,Metropolitan,Eastern,43,2,56,0.7678571428571429,35,8,30,13
2019-20,2019-12-04,Washington Capitals,2,Metropolitan,Eastern,45,2,58,0.7758620689655172,37,8,31,14
2019-20,2019-12-05,Washington Capitals,2,Metropolitan,Eastern,47,2,60,0.7833333333333333,37,10,31,16
2019-20,2019-12-07,Washington Capitals,2,Metropolitan,Eastern,49,2,62,0.7903225806451613,39,10,32,17
2019-20,2019-12-10,Washington Capitals,0,Metropolitan,Eastern,49,2,64,0.765625,39,10,34,15
2019-20,2019-12-12,Washington Capitals,2,Metropolitan,Eastern,51,2,66,0.7727272727272727,39,12,36,15
2019-20,2019-12-15,Washington Capitals,2,Metropolitan,Eastern,53,2,68,0.7794117647058824,42,11,36,17
2019-20,2019-12-17,Washington Capitals,0,Metropolitan,Eastern,53,2,70,0.7571428571428571,42,11,37,16
2019-20,2019-12-21,Washington Capitals,2,Metropolitan,Eastern,55,2,72,0.7638888888888888,46,9,40,15
2019-20,2019-12-22,Washington Capitals,2,Metropolitan,Eastern,57,2,74,0.7702702702702703,46,11,41,16
2019-20,2019-12-24,Washington Capitals,0,Metropolitan,Eastern,57,2,76,0.75,47,10,42,15
2019-20,2019-12-28,Washington Capitals,2,Metropolitan,Eastern,59,2,78,0.7564102564102564,48,11,42,17
2019-20,2019-12-29,Washington Capitals,0,Metropolitan,Eastern,59,2,80,0.7375,50,9,43,16
2019-20,2019-12-31,Washington Capitals,0,Metropolitan,Eastern,59,2,82,0.7195121951219512,52,7,45,14
2019-20,2020-01-04,Washington Capitals,2,Metropolitan,Eastern,61,2,84,0.7261904761904762,53,8,48,13
2019-20,2020-01-05,Washington Capitals,2,Metropolitan,Eastern,63,2,86,0.7325581395348837,53,10,49,14
2019-20,2020-01-08,Washington Capitals,2,Metropolitan,Eastern,65,2,88,0.7386363636363636,57,8,50,15
2019-20,2020-01-09,Washington Capitals,0,Metropolitan,Eastern,65,2,90,0.7222222222222222,57,8,52,13
2019-20,2020-01-12,Washington Capitals,0,Metropolitan,Eastern,65,2,92,0.7065217391304348,58,7,52,13
2019-20,2020-01-14,Washington Capitals,2,Metropolitan,Eastern,67,2,94,0.7127659574468085,58,9,54,13
2019-20,2020-01-17,Washington Capitals,2,Metropolitan,Eastern,69,2,96,0.71875,60,9,56,13
2019-20,2020-01-18,Washington Capitals,2,Metropolitan,Eastern,71,2,98,0.7244897959183674,60,11,56,15
2019-20,2020-01-28,Washington Capitals,2,Metropolitan,Eastern,73,2,100,0.73,63,10,61,12
2019-20,2020-01-30,Washington Capitals,0,Metropolitan,Eastern,73,2,102,0.7156862745098039,63,10,61,12
2019-20,2020-02-01,Washington Capitals,2,Metropolitan,Eastern,75,2,104,0.7211538461538461,64,11,61,14
2019-20,2020-02-02,Washington Capitals,0,Metropolitan,Eastern,75,2,106,0.7075471698113207,65,10,63,12
2019-20,2020-02-05,Washington Capitals,2,Metropolitan,Eastern,77,2,108,0.7129629629629629,67,10,64,13
2019-20,2020-02-09,Washington Capitals,0,Metropolitan,Eastern,77,2,110,0.7,69,8,67,10
2019-20,2020-02-11,Washington Capitals,0,Metropolitan,Eastern,77,2,112,0.6875,70,7,67,10
2019-20,2020-02-14,Washington Capitals,2,Metropolitan,Eastern,79,2,114,0.6929824561403509,72,7,68,11
2019-20,2020-02-16,Washington Capitals,0,Metropolitan,Eastern,79,2,116,0.6810344827586207,72,7,70,9
2019-20,2020-02-17,Washington Capitals,0,Metropolitan,Eastern,79,2,118,0.6694915254237288,72,7,70,9
2019-20,2020-02-21,Washington Capitals,1,Metropolitan,Eastern,80,2,120,0.6666666666666666,75,5,72,8
2019-20,2020-02-22,Washington Capitals,0,Metropolitan,Eastern,80,2,122,0.6557377049180327,77,3,72,8
2019-20,2020-02-23,Washington Capitals,2,Metropolitan,Eastern,82,2,124,0.6612903225806451,77,5,74,8
2019-20,2020-02-26,Washington Capitals,2,Metropolitan,Eastern,84,2,126,0.6666666666666666,79,5,74,10
2019-20,2020-02-28,Washington Capitals,0,Metropolitan,Eastern,84,2,128,0.65625,79,5,76,8
2019-20,2020-03-02,Washington Capitals,2,Metropolitan,Eastern,86,2,130,0.6615384615384615,80,6,78,8
2019-20,2020-03-05,Washington Capitals,0,Metropolitan,Eastern,86,2,132,0.6515151515151515,82,4,78,8
2019-20,2020-03-06,Washington Capitals,1,Metropolitan,Eastern,87,2,134,0.6492537313432836,84,3,78,9
2019-20,2020-03-07,Washington Capitals,2,Metropolitan,Eastern,89,2,136,0.6544117647058824,84,5,79,10
2019-20,2020-03-09,Washington Capitals,1,Metropolitan,Eastern,90,2,138,0.6521739130434783,84,6,79,11
2019-20,2019-10-03,Winnipeg Jets,0,Central,Western,0,2,2,0.0,0,0,0,0
2019-20,2019-10-04,Winnipeg Jets,2,Central,Western,2,2,4,0.5,2,0,0,2
2019-20,2019-10-06,Winnipeg Jets,0,Central,Western,2,2,6,0.3333333333333333,2,0,2,0
2019-20,2019-10-08,Winnipeg Jets,2,Central,Western,4,2,8,0.5,4,0,2,2
2019-20,2019-10-11,Winnipeg Jets,2,Central,Western,6,2,10,0.6,6,0,4,2
2019-20,2019-10-12,Winnipeg Jets,2,Central,Western,8,2,12,0.6666666666666666,6,2,4,4
2019-20,2019-10-13,Winnipeg Jets,0,Central,Western,8,2,14,0.5714285714285714,7,1,5,3
2019-20,2019-10-16,Winnipeg Jets,0,Central,Western,8,2,16,0.5,8,0,7,1
2019-20,2019-10-18,Winnipeg Jets,0,Central,Western,8,2,18,0.4444444444444444,8,0,8,0
2019-20,2019-10-20,Winnipeg Jets,2,Central,Western,10,2,20,0.5,9,1,9,1
2019-20,2019-10-23,Winnipeg Jets,0,Central,Western,10,2,22,0.45454545454545453,11,-1,11,-1
2019-20,2019-10-27,Winnipeg Jets,2,Central,Western,12,2,24,0.5,15,-3,13,-1
2019-20,2019-10-30,Winnipeg Jets,0,Central,Western,12,2,26,0.46153846153846156,15,-3,15,-3
2019-20,2019-11-02,Winnipeg Jets,2,Central,Western,14,2,28,0.5,18,-4,17,-3
2019-20,2019-11-03,Winnipeg Jets,2,Central,Western,16,2,30,0.5333333333333333,18,-2,18,-2
2019-20,2019-11-06,Winnipeg Jets,1,Central,Western,17,2,32,0.53125,18,-1,19,-2
2019-20,2019-11-09,Winnipeg Jets,2,Central,Western,19,2,34,0.5588235294117647,20,-1,20,-1
2019-20,2019-11-10,Winnipeg Jets,2,Central,Western,21,2,36,0.5833333333333334,21,0,21,0
2019-20,2019-11-13,Winnipeg Jets,0,Central,Western,21,2,38,0.5526315789473685,21,0,21,0
2019-20,2019-11-15,Winnipeg Jets,2,Central,Western,23,2,40,0.575,23,0,22,1
2019-20,2019-11-16,Winnipeg Jets,2,Central,Western,25,2,42,0.5952380952380952,24,1,23,2
2019-20,2019-11-20,Winnipeg Jets,2,Central,Western,27,2,44,0.6136363636363636,27,0,24,3
2019-20,2019-11-22,Winnipeg Jets,0,Central,Western,27,2,46,0.5869565217391305,28,-1,26,1
2019-20,2019-11-24,Winnipeg Jets,2,Central,Western,29,2,48,0.6041666666666666,29,0,26,3
2019-20,2019-11-28,Winnipeg Jets,2,Central,Western,31,2,50,0.62,31,0,28,3
2019-20,2019-11-29,Winnipeg Jets,2,Central,Western,33,2,52,0.6346153846153846,32,1,29,4
2019-20,2019-12-01,Winnipeg Jets,0,Central,Western,33,2,54,0.6111111111111112,33,0,30,3
2019-20,2019-12-04,Winnipeg Jets,2,Central,Western,35,2,56,0.625,34,1,32,3
2019-20,2019-12-06,Winnipeg Jets,1,Central,Western,36,2,58,0.6206896551724138,36,0,32,4
2019-20,2019-12-08,Winnipeg Jets,2,Central,Western,38,2,60,0.6333333333333333,38,0,34,4
2019-20,2019-12-11,Winnipeg Jets,2,Central,Western,40,2,62,0.6451612903225806,40,0,37,3
2019-20,2019-12-13,Winnipeg Jets,0,Central,Western,40,2,64,0.625,40,0,37,3
2019-20,2019-12-15,Winnipeg Jets,2,Central,Western,42,2,66,0.6363636363636364,42,0,39,3
2019-20,2019-12-18,Winnipeg Jets,0,Central,Western,42,2,68,0.6176470588235294,42,0,40,2
2019-20,2019-12-20,Winnipeg Jets,0,Central,Western,42,2,70,0.6,44,-2,41,1
2019-20,2019-12-21,Winnipeg Jets,2,Central,Western,44,2,72,0.6111111111111112,44,0,41,3
2019-20,2019-12-24,Winnipeg Jets,0,Central,Western,44,2,74,0.5945945945945946,44,0,43,1
2019-20,2019-12-28,Winnipeg Jets,1,Central,Western,45,2,76,0.5921052631578947,45,0,44,1
2019-20,2019-12-29,Winnipeg Jets,0,Central,Western,45,2,78,0.5769230769230769,46,-1,44,1
2019-20,2020-01-01,Winnipeg Jets,2,Central,Western,47,2,80,0.5875,50,-3,46,1
2019-20,2020-01-03,Winnipeg Jets,0,Central,Western,47,2,82,0.573170731707317,50,-3,47,0
2019-20,2020-01-04,Winnipeg Jets,1,Central,Western,48,2,84,0.5714285714285714,52,-4,48,0
2019-20,2020-01-07,Winnipeg Jets,2,Central,Western,50,2,86,0.5813953488372093,52,-2,50,0
2019-20,2020-01-09,Winnipeg Jets,2,Central,Western,52,2,88,0.5909090909090909,54,-2,51,1
2019-20,2020-01-10,Winnipeg Jets,0,Central,Western,52,2,90,0.5777777777777777,54,-2,52,0
2019-20,2020-01-12,Winnipeg Jets,0,Central,Western,52,2,92,0.5652173913043478,55,-3,53,-1
2019-20,2020-01-15,Winnipeg Jets,2,Central,Western,54,2,94,0.574468085106383,56,-2,54,0
2019-20,2020-01-18,Winnipeg Jets,0,Central,Western,54,2,96,0.5625,58,-4,56,-2
2019-20,2020-01-20,Winnipeg Jets,0,Central,Western,54,2,98,0.5510204081632653,58,-4,57,-3
2019-20,2020-01-22,Winnipeg Jets,0,Central,Western,54,2,100,0.54,58,-4,57,-3
2019-20,2020-01-23,Winnipeg Jets,0,Central,Western,54,2,102,0.5294117647058824,58,-4,57,-3
2019-20,2020-02-01,Winnipeg Jets,0,Central,Western,54,2,104,0.5192307692307693,60,-6,58,-4
2019-20,2020-02-02,Winnipeg Jets,2,Central,Western,56,2,106,0.5283018867924528,62,-6,59,-3
2019-20,2020-02-05,Winnipeg Jets,1,Central,Western,57,2,108,0.5277777777777778,64,-7,60,-3
2019-20,2020-02-07,Winnipeg Jets,2,Central,Western,59,2,110,0.5363636363636364,65,-6,60,-1
2019-20,2020-02-08,Winnipeg Jets,2,Central,Western,61,2,112,0.5446428571428571,65,-4,61,0
2019-20,2020-02-10,Winnipeg Jets,2,Central,Western,63,2,114,0.5526315789473685,67,-4,62,1
2019-20,2020-02-12,Winnipeg Jets,0,Central,Western,63,2,116,0.5431034482758621,69,-6,64,-1
2019-20,2020-02-15,Winnipeg Jets,0,Central,Western,63,2,118,0.5338983050847458,71,-8,64,-1
2019-20,2020-02-17,Winnipeg Jets,2,Central,Western,65,2,120,0.5416666666666666,72,-7,68,-3
2019-20,2020-02-19,Winnipeg Jets,2,Central,Western,67,2,122,0.5491803278688525,73,-6,68,-1
2019-20,2020-02-21,Winnipeg Jets,2,Central,Western,69,2,124,0.5564516129032258,75,-6,68,1
2019-20,2020-02-22,Winnipeg Jets,0,Central,Western,69,2,126,0.5476190476190477,76,-7,68,1
2019-20,2020-02-23,Winnipeg Jets,0,Central,Western,69,2,128,0.5390625,78,-9,69,0
2019-20,2020-02-26,Winnipeg Jets,1,Central,Western,70,2,130,0.5384615384615384,79,-9,70,0
2019-20,2020-02-28,Winnipeg Jets,2,Central,Western,72,2,132,0.5454545454545454,80,-8,72,0
2019-20,2020-03-01,Winnipeg Jets,0,Central,Western,72,2,134,0.5373134328358209,81,-9,72,0
2019-20,2020-03-04,Winnipeg Jets,2,Central,Western,74,2,136,0.5441176470588235,82,-8,74,0
2019-20,2020-03-07,Winnipeg Jets,2,Central,Western,76,2,138,0.5507246376811594,82,-6,76,0
2019-20,2020-03-10,Winnipeg Jets,2,Central,Western,78,2,140,0.5571428571428572,82,-4,78,0
2019-20,2020-03-12,Winnipeg Jets,2,Central,Western,80,2,142,0.5633802816901409,82,-2,78,2
2020-21,2021-01-15,Anaheim Ducks,0,Honda West,Western,0,2,2,0.0,2,-2,2,-2
2020-21,2021-01-17,Anaheim Ducks,1,Honda West,Western,1,2,4,0.25,2,-1,2,-1
2020-21,2021-01-19,Anaheim Ducks,2,Honda West,Western,3,2,6,0.5,3,0,2,1
2020-21,2021-01-21,Anaheim Ducks,0,Honda West,Western,3,2,8,0.375,4,-1,4,-1
2020-21,2021-01-23,Anaheim Ducks,1,Honda West,Western,4,2,10,0.4,5,-1,4,0
2020-21,2021-01-25,Anaheim Ducks,2,Honda West,Western,6,2,12,0.5,6,0,6,0
2020-21,2021-01-27,Anaheim Ducks,2,Honda West,Western,8,2,14,0.5714285714285714,8,0,6,2
2020-21,2021-01-29,Anaheim Ducks,0,Honda West,Western,8,2,16,0.5,9,-1,8,0
2020-21,2021-01-31,Anaheim Ducks,0,Honda West,Western,8,2,18,0.4444444444444444,10,-2,8,0
2020-21,2021-02-01,Anaheim Ducks,0,Honda West,Western,8,2,20,0.4,11,-3,9,-1
2020-21,2021-02-03,Anaheim Ducks,2,Honda West,Western,10,2,22,0.45454545454545453,11,-1,11,-1
2020-21,2021-02-06,Anaheim Ducks,1,Honda West,Western,11,2,24,0.4583333333333333,12,-1,12,-1
2020-21,2021-02-07,Anaheim Ducks,2,Honda West,Western,13,2,26,0.5,13,0,12,1
2020-21,2021-02-10,Anaheim Ducks,0,Honda West,Western,13,2,28,0.4642857142857143,13,0,13,0
2020-21,2021-02-12,Anaheim Ducks,2,Honda West,Western,15,2,30,0.5,15,0,15,0
2020-21,2021-02-16,Anaheim Ducks,0,Honda West,Western,15,2,32,0.46875,15,0,15,0
2020-21,2021-02-19,Anaheim Ducks,0,Honda West,Western,15,2,34,0.4411764705882353,17,-2,17,-2
2020-21,2021-02-21,Anaheim Ducks,0,Honda West,Western,15,2,36,0.4166666666666667,17,-2,17,-2
2020-21,2021-02-23,Anaheim Ducks,0,Honda West,Western,15,2,38,0.39473684210526316,19,-4,19,-4
2020-21,2021-02-25,Anaheim Ducks,1,Honda West,Western,16,2,40,0.4,21,-5,20,-4
2020-21,2021-02-28,Anaheim Ducks,1,Honda West,Western,17,2,42,0.40476190476190477,23,-6,22,-5
2020-21,2021-03-02,Anaheim Ducks,0,Honda West,Western,17,2,44,0.38636363636363635,23,-6,22,-5
2020-21,2021-03-04,Anaheim Ducks,0,Honda West,Western,17,2,46,0.3695652173913043,25,-8,23,-6
2020-21,2021-03-06,Anaheim Ducks,1,Honda West,Western,18,2,48,0.375,27,-9,24,-6
2020-21,2021-03-07,Anaheim Ducks,2,Honda West,Western,20,2,50,0.4,27,-7,25,-5
2020-21,2021-03-09,Anaheim Ducks,2,Honda West,Western,22,2,52,0.4230769230769231,28,-6,27,-5
2020-21,2021-03-11,Anaheim Ducks,0,Honda West,Western,22,2,54,0.4074074074074074,30,-8,28,-6
2020-21,2021-03-13,Anaheim Ducks,0,Honda West,Western,22,2,56,0.39285714285714285,32,-10,28,-6
2020-21,2021-03-14,Anaheim Ducks,0,Honda West,Western,22,2,58,0.3793103448275862,33,-11,29,-7
2020-21,2021-03-17,Anaheim Ducks,0,Honda West,Western,22,2,60,0.36666666666666664,33,-11,32,-10
2020-21,2021-03-19,Anaheim Ducks,2,Honda West,Western,24,2,62,0.3870967741935484,33,-9,33,-9
2020-21,2021-03-21,Anaheim Ducks,0,Honda West,Western,24,2,64,0.375,37,-13,33,-9
2020-21,2021-03-22,Anaheim Ducks,0,Honda West,Western,24,2,66,0.36363636363636365,37,-13,33,-9
2020-21,2021-03-24,Anaheim Ducks,0,Honda West,Western,24,2,68,0.35294117647058826,37,-13,35,-11
2020-21,2021-03-27,Anaheim Ducks,2,Honda West,Western,26,2,70,0.37142857142857144,37,-11,35,-9
2020-21,2021-03-28,Anaheim Ducks,2,Honda West,Western,28,2,72,0.3888888888888889,38,-10,37,-9
2020-21,2021-03-30,Anaheim Ducks,0,Honda West,Western,28,2,74,0.3783783783783784,38,-10,37,-9
2020-21,2021-04-03,Anaheim Ducks,0,Honda West,Western,28,2,76,0.3684210526315789,39,-11,39,-11
2020-21,2021-04-05,Anaheim Ducks,1,Honda West,Western,29,2,78,0.3717948717948718,41,-12,39,-10
2020-21,2021-04-07,Anaheim Ducks,2,Honda West,Western,31,2,80,0.3875,43,-12,41,-10
2020-21,2021-04-10,Anaheim Ducks,0,Honda West,Western,31,2,82,0.3780487804878049,43,-12,43,-12
2020-21,2021-04-11,Anaheim Ducks,0,Honda West,Western,31,2,84,0.36904761904761907,44,-13,43,-12
2020-21,2021-04-13,Anaheim Ducks,2,Honda West,Western,33,2,86,0.38372093023255816,44,-11,44,-11
2020-21,2021-04-15,Anaheim Ducks,2,Honda West,Western,35,2,88,0.3977272727272727,44,-9,44,-9
2020-21,2021-04-17,Anaheim Ducks,0,Honda West,Western,35,2,90,0.3888888888888889,45,-10,45,-10
2020-21,2021-04-18,Anaheim Ducks,0,Honda West,Western,35,2,92,0.3804347826086957,45,-10,46,-11
2020-21,2021-04-21,Anaheim Ducks,0,Honda West,Western,35,2,94,0.3723404255319149,45,-10,49,-14
2020-21,2021-04-25,Anaheim Ducks,0,Honda West,Western,35,2,96,0.3645833333333333,47,-12,49,-14
2020-21,2021-04-27,Anaheim Ducks,0,Honda West,Western,35,2,98,0.35714285714285715,48,-13,49,-14
2020-21,2021-04-29,Anaheim Ducks,2,Honda West,Western,37,2,100,0.37,50,-13,50,-13
2020-21,2021-05-01,Anaheim Ducks,0,Honda West,Western,37,2,102,0.3627450980392157,52,-15,52,-15
2020-21,2021-05-02,Anaheim Ducks,2,Honda West,Western,39,2,104,0.375,53,-14,53,-14
2020-21,2021-05-04,Anaheim Ducks,0,Honda West,Western,39,2,106,0.36792452830188677,55,-16,55,-16
2020-21,2021-05-06,Anaheim Ducks,2,Honda West,Western,41,2,108,0.37962962962962965,56,-15,56,-15
2020-21,2021-05-08,Anaheim Ducks,1,Honda West,Western,42,2,110,0.38181818181818183,57,-15,57,-15
2020-21,2021-05-09,Anaheim Ducks,1,Honda West,Western,43,2,112,0.38392857142857145,57,-14,57,-14
2020-21,2021-01-15,Arizona Coyotes,1,Honda West,Western,1,2,2,0.5,2,-1,2,-1
2020-21,2021-01-16,Arizona Coyotes,2,Honda West,Western,3,2,4,0.75,2,1,2,1
2020-21,2021-01-19,Arizona Coyotes,0,Honda West,Western,3,2,6,0.5,3,0,2,1
2020-21,2021-01-21,Arizona Coyotes,0,Honda West,Western,3,2,8,0.375,4,-1,4,-1
2020-21,2021-01-23,Arizona Coyotes,2,Honda West,Western,5,2,10,0.5,5,0,4,1
2020-21,2021-01-24,Arizona Coyotes,0,Honda West,Western,5,2,12,0.4166666666666667,6,-1,5,0
2020-21,2021-01-27,Arizona Coyotes,0,Honda West,Western,5,2,14,0.35714285714285715,8,-3,6,-1
2020-21,2021-01-29,Arizona Coyotes,2,Honda West,Western,7,2,16,0.4375,9,-2,8,-1
2020-21,2021-02-03,Arizona Coyotes,0,Honda West,Western,7,2,18,0.3888888888888889,11,-4,11,-4
2020-21,2021-02-05,Arizona Coyotes,2,Honda West,Western,9,2,20,0.45,11,-2,11,-2
2020-21,2021-02-06,Arizona Coyotes,2,Honda West,Western,11,2,22,0.5,12,-1,12,-1
2020-21,2021-02-09,Arizona Coyotes,2,Honda West,Western,13,2,24,0.5416666666666666,13,0,13,0
2020-21,2021-02-13,Arizona Coyotes,0,Honda West,Western,13,2,26,0.5,15,-2,15,-2
2020-21,2021-02-14,Arizona Coyotes,1,Honda West,Western,14,2,28,0.5,15,-1,15,-1
2020-21,2021-02-15,Arizona Coyotes,2,Honda West,Western,16,2,30,0.5333333333333333,15,1,15,1
2020-21,2021-02-19,Arizona Coyotes,1,Honda West,Western,17,2,32,0.53125,17,0,17,0
2020-21,2021-02-21,Arizona Coyotes,0,Honda West,Western,17,2,34,0.5,17,0,17,0
2020-21,2021-02-23,Arizona Coyotes,2,Honda West,Western,19,2,36,0.5277777777777778,19,0,19,0
2020-21,2021-02-25,Arizona Coyotes,2,Honda West,Western,21,2,38,0.5526315789473685,21,0,20,1
2020-21,2021-02-27,Arizona Coyotes,0,Honda West,Western,21,2,40,0.525,21,0,21,0
2020-21,2021-02-28,Arizona Coyotes,0,Honda West,Western,21,2,42,0.5,23,-2,22,-1
2020-21,2021-03-04,Arizona Coyotes,2,Honda West,Western,23,2,44,0.5227272727272727,25,-2,23,0
2020-21,2021-03-06,Arizona Coyotes,0,Honda West,Western,23,2,46,0.5,27,-4,24,-1
2020-21,2021-03-07,Arizona Coyotes,2,Honda West,Western,25,2,48,0.5208333333333334,27,-2,25,0
2020-21,2021-03-09,Arizona Coyotes,2,Honda West,Western,27,2,50,0.54,28,-1,27,0
2020-21,2021-03-11,Arizona Coyotes,1,Honda West,Western,28,2,52,0.5384615384615384,30,-2,28,0
2020-21,2021-03-13,Arizona Coyotes,0,Honda West,Western,28,2,54,0.5185185185185185,32,-4,28,0
2020-21,2021-03-14,Arizona Coyotes,0,Honda West,Western,28,2,56,0.5,33,-5,29,-1
2020-21,2021-03-17,Arizona Coyotes,0,Honda West,Western,28,2,58,0.4827586206896552,33,-5,32,-4
2020-21,2021-03-19,Arizona Coyotes,1,Honda West,Western,29,2,60,0.48333333333333334,33,-4,33,-4
2020-21,2021-03-21,Arizona Coyotes,2,Honda West,Western,31,2,62,0.5,37,-6,33,-2
2020-21,2021-03-23,Arizona Coyotes,0,Honda West,Western,31,2,64,0.484375,37,-6,33,-2
2020-21,2021-03-24,Arizona Coyotes,2,Honda West,Western,33,2,66,0.5,37,-4,35,-2
2020-21,2021-03-27,Arizona Coyotes,2,Honda West,Western,35,2,68,0.5147058823529411,37,-2,35,0
2020-21,2021-03-28,Arizona Coyotes,2,Honda West,Western,37,2,70,0.5285714285714286,38,-1,37,0
2020-21,2021-04-01,Arizona Coyotes,0,Honda West,Western,37,2,72,0.5138888888888888,38,-1,38,-1
2020-21,2021-04-03,Arizona Coyotes,2,Honda West,Western,39,2,74,0.527027027027027,39,0,39,0
2020-21,2021-04-05,Arizona Coyotes,2,Honda West,Western,41,2,76,0.5394736842105263,41,0,39,2
2020-21,2021-04-06,Arizona Coyotes,2,Honda West,Western,43,2,78,0.5512820512820513,43,0,39,4
2020-21,2021-04-08,Arizona Coyotes,0,Honda West,Western,43,2,80,0.5375,43,0,41,2
2020-21,2021-04-10,Arizona Coyotes,0,Honda West,Western,43,2,82,0.524390243902439,43,0,43,0
2020-21,2021-04-11,Arizona Coyotes,0,Honda West,Western,43,2,84,0.5119047619047619,44,-1,43,0
2020-21,2021-04-13,Arizona Coyotes,0,Honda West,Western,43,2,86,0.5,44,-1,44,-1
2020-21,2021-04-14,Arizona Coyotes,0,Honda West,Western,43,2,88,0.48863636363636365,44,-1,44,-1
2020-21,2021-04-17,Arizona Coyotes,2,Honda West,Western,45,2,90,0.5,45,0,45,0
2020-21,2021-04-20,Arizona Coyotes,0,Honda West,Western,45,2,92,0.4891304347826087,45,0,47,-2
2020-21,2021-04-22,Arizona Coyotes,0,Honda West,Western,45,2,94,0.4787234042553192,45,0,49,-4
2020-21,2021-04-25,Arizona Coyotes,2,Honda West,Western,47,2,96,0.4895833333333333,47,0,49,-2
2020-21,2021-04-27,Arizona Coyotes,0,Honda West,Western,47,2,98,0.47959183673469385,48,-1,49,-2
2020-21,2021-04-29,Arizona Coyotes,0,Honda West,Western,47,2,100,0.47,50,-3,50,-3
2020-21,2021-05-01,Arizona Coyotes,2,Honda West,Western,49,2,102,0.4803921568627451,52,-3,52,-3
2020-21,2021-05-02,Arizona Coyotes,1,Honda West,Western,50,2,104,0.4807692307692308,53,-3,53,-3
2020-21,2021-05-04,Arizona Coyotes,0,Honda West,Western,50,2,106,0.4716981132075472,55,-5,55,-5
2020-21,2021-05-06,Arizona Coyotes,0,Honda West,Western,50,2,108,0.46296296296296297,56,-6,56,-6
2020-21,2021-05-08,Arizona Coyotes,2,Honda West,Western,52,2,110,0.4727272727272727,57,-5,57,-5
2020-21,2021-05-09,Arizona Coyotes,2,Honda West,Western,54,2,112,0.48214285714285715,57,-3,57,-3
2020-21,2021-01-15,Boston Bruins,2,MassMutual East,Eastern,2,2,2,1.0,2,0,1,1
2020-21,2021-01-16,Boston Bruins,1,MassMutual East,Eastern,3,2,4,0.75,3,0,2,1
2020-21,2021-01-18,Boston Bruins,0,MassMutual East,Eastern,3,2,6,0.5,3,0,3,0
2020-21,2021-01-22,Boston Bruins,2,MassMutual East,Eastern,5,2,8,0.625,5,0,5,0
2020-21,2021-01-24,Boston Bruins,2,MassMutual East,Eastern,7,2,10,0.7,6,1,6,1
2020-21,2021-01-27,Boston Bruins,2,MassMutual East,Eastern,9,2,12,0.75,9,0,7,2
2020-21,2021-01-29,Boston Bruins,2,MassMutual East,Eastern,11,2,14,0.7857142857142857,9,2,8,3
2020-21,2021-01-31,Boston Bruins,1,MassMutual East,Eastern,12,2,16,0.75,11,1,10,2
2020-21,2021-02-02,Boston Bruins,2,MassMutual East,Eastern,14,2,18,0.7777777777777778,11,3,11,3
2020-21,2021-02-04,Boston Bruins,2,MassMutual East,Eastern,16,2,20,0.8,11,5,11,5
2020-21,2021-02-06,Boston Bruins,2,MassMutual East,Eastern,18,2,22,0.8181818181818182,11,7,13,5
2020-21,2021-02-11,Boston Bruins,2,MassMutual East,Eastern,20,2,24,0.8333333333333334,12,8,15,5
2020-21,2021-02-13,Boston Bruins,2,MassMutual East,Eastern,22,2,26,0.8461538461538461,13,9,16,6
2020-21,2021-02-14,Boston Bruins,0,MassMutual East,Eastern,22,2,28,0.7857142857142857,15,7,18,4
2020-21,2021-02-19,Boston Bruins,0,MassMutual East,Eastern,22,2,30,0.7333333333333333,19,3,19,3
2020-21,2021-02-22,Boston Bruins,2,MassMutual East,Eastern,24,2,32,0.75,19,5,20,4
2020-21,2021-02-26,Boston Bruins,0,MassMutual East,Eastern,24,2,34,0.7058823529411765,21,3,22,2
2020-21,2021-02-27,Boston Bruins,0,MassMutual East,Eastern,24,2,36,0.6666666666666666,23,1,23,1
2020-21,2021-02-28,Boston Bruins,2,MassMutual East,Eastern,26,2,38,0.6842105263157895,25,1,25,1
2020-21,2021-03-04,Boston Bruins,1,MassMutual East,Eastern,27,2,40,0.675,25,2,25,2
2020-21,2021-03-06,Boston Bruins,2,MassMutual East,Eastern,29,2,42,0.6904761904761905,27,2,27,2
2020-21,2021-03-07,Boston Bruins,0,MassMutual East,Eastern,29,2,44,0.6590909090909091,27,2,28,1
2020-21,2021-03-10,Boston Bruins,1,MassMutual East,Eastern,30,2,46,0.6521739130434783,30,0,30,0
2020-21,2021-03-12,Boston Bruins,2,MassMutual East,Eastern,32,2,48,0.6666666666666666,32,0,32,0
2020-21,2021-03-13,Boston Bruins,0,MassMutual East,Eastern,32,2,50,0.64,32,0,32,0
2020-21,2021-03-15,Boston Bruins,0,MassMutual East,Eastern,32,2,52,0.6153846153846154,32,0,32,0
2020-21,2021-03-16,Boston Bruins,2,MassMutual East,Eastern,34,2,54,0.6296296296296297,34,0,34,0
2020-21,2021-03-18,Boston Bruins,2,MassMutual East,Eastern,36,2,56,0.6428571428571429,36,0,36,0
2020-21,2021-03-25,Boston Bruins,1,MassMutual East,Eastern,37,2,58,0.6379310344827587,37,0,37,0
2020-21,2021-03-27,Boston Bruins,2,MassMutual East,Eastern,39,2,60,0.65,39,0,39,0
2020-21,2021-03-28,Boston Bruins,0,MassMutual East,Eastern,39,2,62,0.6290322580645161,39,0,39,0
2020-21,2021-03-30,Boston Bruins,2,MassMutual East,Eastern,41,2,64,0.640625,41,0,41,0
2020-21,2021-04-01,Boston Bruins,0,MassMutual East,Eastern,41,2,66,0.6212121212121212,41,0,41,0
2020-21,2021-04-03,Boston Bruins,2,MassMutual East,Eastern,43,2,68,0.6323529411764706,43,0,43,0
2020-21,2021-04-05,Boston Bruins,1,MassMutual East,Eastern,44,2,70,0.6285714285714286,44,0,44,0
2020-21,2021-04-06,Boston Bruins,2,MassMutual East,Eastern,46,2,72,0.6388888888888888,46,0,46,0
2020-21,2021-04-08,Boston Bruins,2,MassMutual East,Eastern,48,2,74,0.6486486486486487,48,0,48,0
2020-21,2021-04-10,Boston Bruins,0,MassMutual East,Eastern,48,2,76,0.631578947368421,48,0,48,0
2020-21,2021-04-11,Boston Bruins,0,MassMutual East,Eastern,48,2,78,0.6153846153846154,48,0,48,0
2020-21,2021-04-13,Boston Bruins,2,MassMutual East,Eastern,50,2,80,0.625,50,0,50,0
2020-21,2021-04-15,Boston Bruins,2,MassMutual East,Eastern,52,2,82,0.6341463414634146,52,0,52,0
2020-21,2021-04-16,Boston Bruins,2,MassMutual East,Eastern,54,2,84,0.6428571428571429,54,0,54,0
2020-21,2021-04-18,Boston Bruins,2,MassMutual East,Eastern,56,2,86,0.6511627906976745,56,0,56,0
2020-21,2021-04-20,Boston Bruins,2,MassMutual East,Eastern,58,2,88,0.6590909090909091,58,0,58,0
2020-21,2021-04-22,Boston Bruins,2,MassMutual East,Eastern,60,2,90,0.6666666666666666,60,0,60,0
2020-21,2021-04-23,Boston Bruins,0,MassMutual East,Eastern,60,2,92,0.6521739130434783,60,0,60,0
2020-21,2021-04-25,Boston Bruins,0,MassMutual East,Eastern,60,2,94,0.6382978723404256,60,0,60,0
2020-21,2021-04-27,Boston Bruins,2,MassMutual East,Eastern,62,2,96,0.6458333333333334,62,0,62,0
2020-21,2021-04-29,Boston Bruins,2,MassMutual East,Eastern,64,2,98,0.6530612244897959,64,0,64,0
2020-21,2021-05-01,Boston Bruins,2,MassMutual East,Eastern,66,2,100,0.66,66,0,66,0
2020-21,2021-05-03,Boston Bruins,2,MassMutual East,Eastern,68,2,102,0.6666666666666666,67,1,67,1
2020-21,2021-05-04,Boston Bruins,1,MassMutual East,Eastern,69,2,104,0.6634615384615384,68,1,68,1
2020-21,2021-05-06,Boston Bruins,2,MassMutual East,Eastern,71,2,106,0.6698113207547169,68,3,68,3
2020-21,2021-05-08,Boston Bruins,0,MassMutual East,Eastern,71,2,108,0.6574074074074074,70,1,70,1
2020-21,2021-05-10,Boston Bruins,2,MassMutual East,Eastern,73,2,110,0.6636363636363637,71,2,71,2
2020-21,2021-05-11,Boston Bruins,0,MassMutual East,Eastern,73,2,112,0.6517857142857143,71,2,71,2
2020-21,2021-01-15,Buffalo Sabres,0,MassMutual East,Eastern,0,2,2,0.0,2,-2,1,-1
2020-21,2021-01-16,Buffalo Sabres,0,MassMutual East,Eastern,0,2,4,0.0,3,-3,2,-2
2020-21,2021-01-19,Buffalo Sabres,2,MassMutual East,Eastern,2,2,6,0.3333333333333333,3,-1,3,-1
2020-21,2021-01-20,Buffalo Sabres,0,MassMutual East,Eastern,2,2,8,0.25,4,-2,4,-2
2020-21,2021-01-23,Buffalo Sabres,1,MassMutual East,Eastern,3,2,10,0.3,6,-3,6,-3
2020-21,2021-01-24,Buffalo Sabres,2,MassMutual East,Eastern,5,2,12,0.4166666666666667,6,-1,6,-1
2020-21,2021-01-27,Buffalo Sabres,2,MassMutual East,Eastern,7,2,14,0.5,9,-2,7,0
2020-21,2021-01-29,Buffalo Sabres,1,MassMutual East,Eastern,8,2,16,0.5,9,-1,8,0
2020-21,2021-01-30,Buffalo Sabres,2,MassMutual East,Eastern,10,2,18,0.5555555555555556,10,0,9,1
2020-21,2021-01-31,Buffalo Sabres,0,MassMutual East,Eastern,10,2,20,0.5,11,-1,10,0
2020-21,2021-02-16,Buffalo Sabres,0,MassMutual East,Eastern,10,2,22,0.45454545454545453,15,-5,18,-8
2020-21,2021-02-17,Buffalo Sabres,0,MassMutual East,Eastern,10,2,24,0.4166666666666667,17,-7,18,-8
2020-21,2021-02-19,Buffalo Sabres,0,MassMutual East,Eastern,10,2,26,0.38461538461538464,19,-9,19,-9
2020-21,2021-02-20,Buffalo Sabres,2,MassMutual East,Eastern,12,2,28,0.42857142857142855,19,-7,19,-7
2020-21,2021-02-23,Buffalo Sabres,0,MassMutual East,Eastern,12,2,30,0.4,19,-7,21,-9
2020-21,2021-02-24,Buffalo Sabres,2,MassMutual East,Eastern,14,2,32,0.4375,21,-7,21,-7
2020-21,2021-02-26,Buffalo Sabres,1,MassMutual East,Eastern,15,2,34,0.4411764705882353,21,-6,22,-7
2020-21,2021-02-27,Buffalo Sabres,0,MassMutual East,Eastern,15,2,36,0.4166666666666667,23,-8,23,-8
2020-21,2021-02-28,Buffalo Sabres,0,MassMutual East,Eastern,15,2,38,0.39473684210526316,25,-10,25,-10
2020-21,2021-03-03,Buffalo Sabres,0,MassMutual East,Eastern,15,2,40,0.375,25,-10,25,-10
2020-21,2021-03-05,Buffalo Sabres,0,MassMutual East,Eastern,15,2,42,0.35714285714285715,27,-12,27,-12
2020-21,2021-03-06,Buffalo Sabres,0,MassMutual East,Eastern,15,2,44,0.3409090909090909,27,-12,27,-12
2020-21,2021-03-07,Buffalo Sabres,0,MassMutual East,Eastern,15,2,46,0.32608695652173914,27,-12,28,-13
2020-21,2021-03-10,Buffalo Sabres,1,MassMutual East,Eastern,16,2,48,0.3333333333333333,30,-14,30,-14
2020-21,2021-03-12,Buffalo Sabres,0,MassMutual East,Eastern,16,2,50,0.32,32,-16,32,-16
2020-21,2021-03-14,Buffalo Sabres,0,MassMutual East,Eastern,16,2,52,0.3076923076923077,32,-16,32,-16
2020-21,2021-03-15,Buffalo Sabres,0,MassMutual East,Eastern,16,2,54,0.2962962962962963,32,-16,32,-16
2020-21,2021-03-16,Buffalo Sabres,0,MassMutual East,Eastern,16,2,56,0.2857142857142857,34,-18,34,-18
2020-21,2021-03-18,Buffalo Sabres,0,MassMutual East,Eastern,16,2,58,0.27586206896551724,36,-20,36,-20
2020-21,2021-03-22,Buffalo Sabres,0,MassMutual East,Eastern,16,2,60,0.26666666666666666,36,-20,37,-21
2020-21,2021-03-25,Buffalo Sabres,0,MassMutual East,Eastern,16,2,62,0.25806451612903225,37,-21,37,-21
2020-21,2021-03-25,Buffalo Sabres,0,MassMutual East,Eastern,16,2,64,0.25,37,-21,37,-21
2020-21,2021-03-27,Buffalo Sabres,0,MassMutual East,Eastern,16,2,66,0.24242424242424243,39,-23,39,-23
2020-21,2021-03-29,Buffalo Sabres,1,MassMutual East,Eastern,17,2,68,0.25,39,-22,39,-22
2020-21,2021-03-31,Buffalo Sabres,2,MassMutual East,Eastern,19,2,70,0.2714285714285714,41,-22,41,-22
2020-21,2021-04-01,Buffalo Sabres,1,MassMutual East,Eastern,20,2,72,0.2777777777777778,41,-21,41,-21
2020-21,2021-04-03,Buffalo Sabres,2,MassMutual East,Eastern,22,2,74,0.2972972972972973,43,-21,43,-21
2020-21,2021-04-06,Buffalo Sabres,2,MassMutual East,Eastern,24,2,76,0.3157894736842105,46,-22,46,-22
2020-21,2021-04-08,Buffalo Sabres,0,MassMutual East,Eastern,24,2,78,0.3076923076923077,48,-24,48,-24
2020-21,2021-04-09,Buffalo Sabres,0,MassMutual East,Eastern,24,2,80,0.3,48,-24,48,-24
2020-21,2021-04-11,Buffalo Sabres,2,MassMutual East,Eastern,26,2,82,0.3170731707317073,48,-22,48,-22
2020-21,2021-04-13,Buffalo Sabres,1,MassMutual East,Eastern,27,2,84,0.32142857142857145,50,-23,50,-23
2020-21,2021-04-15,Buffalo Sabres,2,MassMutual East,Eastern,29,2,86,0.3372093023255814,52,-23,52,-23
2020-21,2021-04-17,Buffalo Sabres,0,MassMutual East,Eastern,29,2,88,0.32954545454545453,54,-25,54,-25
2020-21,2021-04-18,Buffalo Sabres,2,MassMutual East,Eastern,31,2,90,0.34444444444444444,56,-25,56,-25
2020-21,2021-04-20,Buffalo Sabres,0,MassMutual East,Eastern,31,2,92,0.33695652173913043,58,-27,58,-27
2020-21,2021-04-22,Buffalo Sabres,0,MassMutual East,Eastern,31,2,94,0.32978723404255317,60,-29,60,-29
2020-21,2021-04-23,Buffalo Sabres,2,MassMutual East,Eastern,33,2,96,0.34375,60,-27,60,-27
2020-21,2021-04-25,Buffalo Sabres,0,MassMutual East,Eastern,33,2,98,0.336734693877551,60,-27,60,-27
2020-21,2021-04-27,Buffalo Sabres,0,MassMutual East,Eastern,33,2,100,0.33,62,-29,62,-29
2020-21,2021-04-29,Buffalo Sabres,0,MassMutual East,Eastern,33,2,102,0.3235294117647059,64,-31,64,-31
2020-21,2021-05-01,Buffalo Sabres,0,MassMutual East,Eastern,33,2,104,0.3173076923076923,66,-33,66,-33
2020-21,2021-05-03,Buffalo Sabres,2,MassMutual East,Eastern,35,2,106,0.330188679245283,67,-32,67,-32
2020-21,2021-05-04,Buffalo Sabres,2,MassMutual East,Eastern,37,2,108,0.3425925925925926,68,-31,68,-31
2020-21,2021-05-06,Buffalo Sabres,0,MassMutual East,Eastern,37,2,110,0.33636363636363636,68,-31,68,-31
2020-21,2021-05-08,Buffalo Sabres,0,MassMutual East,Eastern,37,2,112,0.33035714285714285,70,-33,70,-33
2020-21,2021-01-15,Calgary Flames,1,Scotia North,Western,1,2,2,0.5,2,-1,2,-1
2020-21,2021-01-17,Calgary Flames,2,Scotia North,Western,3,2,4,0.75,2,1,2,1
2020-21,2021-01-19,Calgary Flames,2,Scotia North,Western,5,2,6,0.8333333333333334,2,3,2,3
2020-21,2021-01-24,Calgary Flames,0,Scotia North,Western,5,2,8,0.625,5,0,5,0
2020-21,2021-01-27,Calgary Flames,0,Scotia North,Western,5,2,10,0.5,6,-1,6,-1
2020-21,2021-01-29,Calgary Flames,0,Scotia North,Western,5,2,12,0.4166666666666667,10,-5,8,-3
2020-21,2021-01-31,Calgary Flames,2,Scotia North,Western,7,2,14,0.5,10,-3,8,-1
2020-21,2021-02-02,Calgary Flames,2,Scotia North,Western,9,2,16,0.5625,11,-2,9,0
2020-21,2021-02-03,Calgary Flames,0,Scotia North,Western,9,2,18,0.5,12,-3,11,-2
2020-21,2021-02-05,Calgary Flames,0,Scotia North,Western,9,2,20,0.45,12,-3,11,-2
2020-21,2021-02-07,Calgary Flames,2,Scotia North,Western,11,2,22,0.5,12,-1,12,-1
2020-21,2021-02-10,Calgary Flames,2,Scotia North,Western,13,2,24,0.5416666666666666,15,-2,13,0
2020-21,2021-02-12,Calgary Flames,2,Scotia North,Western,15,2,26,0.5769230769230769,17,-2,15,0
2020-21,2021-02-14,Calgary Flames,0,Scotia North,Western,15,2,28,0.5357142857142857,17,-2,15,0
2020-21,2021-02-16,Calgary Flames,2,Scotia North,Western,17,2,30,0.5666666666666667,18,-1,15,2
2020-21,2021-02-18,Calgary Flames,0,Scotia North,Western,17,2,32,0.53125,19,-2,17,0
2020-21,2021-02-20,Calgary Flames,0,Scotia North,Western,17,2,34,0.5,20,-3,17,0
2020-21,2021-02-21,Calgary Flames,0,Scotia North,Western,17,2,36,0.4722222222222222,20,-3,17,0
2020-21,2021-02-23,Calgary Flames,2,Scotia North,Western,19,2,38,0.5,21,-2,19,0
2020-21,2021-02-25,Calgary Flames,1,Scotia North,Western,20,2,40,0.5,22,-2,20,0
2020-21,2021-02-26,Calgary Flames,0,Scotia North,Western,20,2,42,0.47619047619047616,22,-2,20,0
2020-21,2021-02-27,Calgary Flames,2,Scotia North,Western,22,2,44,0.5,22,0,21,1
2020-21,2021-03-02,Calgary Flames,0,Scotia North,Western,22,2,46,0.4782608695652174,23,-1,22,0
2020-21,2021-03-05,Calgary Flames,2,Scotia North,Western,24,2,48,0.5,26,-2,24,0
2020-21,2021-03-07,Calgary Flames,0,Scotia North,Western,24,2,50,0.48,28,-4,25,-1
2020-21,2021-03-08,Calgary Flames,1,Scotia North,Western,25,2,52,0.4807692307692308,28,-3,25,0
2020-21,2021-03-12,Calgary Flames,2,Scotia North,Western,27,2,54,0.5,31,-4,28,-1
2020-21,2021-03-14,Calgary Flames,2,Scotia North,Western,29,2,56,0.5178571428571429,31,-2,29,0
2020-21,2021-03-16,Calgary Flames,2,Scotia North,Western,31,2,58,0.5344827586206896,33,-2,31,0
2020-21,2021-03-18,Calgary Flames,0,Scotia North,Western,31,2,60,0.5166666666666667,34,-3,32,-1
2020-21,2021-03-19,Calgary Flames,2,Scotia North,Western,33,2,62,0.532258064516129,35,-2,33,0
2020-21,2021-03-20,Calgary Flames,0,Scotia North,Western,33,2,64,0.515625,37,-4,33,0
2020-21,2021-03-22,Calgary Flames,0,Scotia North,Western,33,2,66,0.5,37,-4,33,0
2020-21,2021-03-24,Calgary Flames,0,Scotia North,Western,33,2,68,0.4852941176470588,37,-4,35,-2
2020-21,2021-03-27,Calgary Flames,0,Scotia North,Western,33,2,70,0.4714285714285714,37,-4,35,-2
2020-21,2021-03-28,Calgary Flames,2,Scotia North,Western,35,2,72,0.4861111111111111,37,-2,37,-2
2020-21,2021-03-30,Calgary Flames,0,Scotia North,Western,35,2,74,0.47297297297297297,39,-4,37,-2
2020-21,2021-04-03,Calgary Flames,0,Scotia North,Western,35,2,76,0.4605263157894737,41,-6,39,-4
2020-21,2021-04-05,Calgary Flames,0,Scotia North,Western,35,2,78,0.44871794871794873,43,-8,39,-4
2020-21,2021-04-06,Calgary Flames,0,Scotia North,Western,35,2,80,0.4375,43,-8,39,-4
2020-21,2021-04-11,Calgary Flames,2,Scotia North,Western,37,2,82,0.45121951219512196,43,-6,43,-6
2020-21,2021-04-13,Calgary Flames,2,Scotia North,Western,39,2,84,0.4642857142857143,45,-6,44,-5
2020-21,2021-04-14,Calgary Flames,2,Scotia North,Western,41,2,86,0.47674418604651164,45,-4,44,-3
2020-21,2021-04-16,Calgary Flames,0,Scotia North,Western,41,2,88,0.4659090909090909,47,-6,44,-3
2020-21,2021-04-20,Calgary Flames,0,Scotia North,Western,41,2,90,0.45555555555555555,47,-6,47,-6
2020-21,2021-04-24,Calgary Flames,2,Scotia North,Western,43,2,92,0.4673913043478261,49,-6,49,-6
2020-21,2021-04-24,Calgary Flames,2,Scotia North,Western,45,2,94,0.4787234042553192,49,-4,49,-4
2020-21,2021-04-26,Calgary Flames,0,Scotia North,Western,45,2,96,0.46875,51,-6,49,-4
2020-21,2021-04-30,Calgary Flames,2,Scotia North,Western,47,2,98,0.47959183673469385,53,-6,52,-5
2020-21,2021-05-02,Calgary Flames,0,Scotia North,Western,47,2,100,0.47,55,-8,53,-6
2020-21,2021-05-06,Calgary Flames,0,Scotia North,Western,47,2,102,0.46078431372549017,57,-10,56,-9
2020-21,2021-05-10,Calgary Flames,2,Scotia North,Western,49,2,104,0.47115384615384615,58,-9,57,-8
2020-21,2021-05-14,Calgary Flames,2,Scotia North,Western,51,2,106,0.4811320754716981,59,-8,60,-9
2020-21,2021-05-17,Calgary Flames,2,Scotia North,Western,53,2,108,0.49074074074074076,59,-6,60,-7
2020-21,2021-05-18,Calgary Flames,0,Scotia North,Western,53,2,110,0.4818181818181818,59,-6,60,-7
2020-21,2021-05-19,Calgary Flames,2,Scotia North,Western,55,2,112,0.49107142857142855,59,-4,60,-5
2020-21,2021-01-15,Carolina Hurricanes,2,Discover Central,Eastern,2,2,2,1.0,0,2,1,1
2020-21,2021-01-17,Carolina Hurricanes,0,Discover Central,Eastern,2,2,4,0.5,2,0,2,0
2020-21,2021-01-19,Carolina Hurricanes,2,Discover Central,Eastern,4,2,6,0.6666666666666666,2,2,3,1
2020-21,2021-01-29,Carolina Hurricanes,2,Discover Central,Eastern,6,2,8,0.75,7,-1,8,-2
2020-21,2021-01-31,Carolina Hurricanes,2,Discover Central,Eastern,8,2,10,0.8,8,0,10,-2
2020-21,2021-01-31,Carolina Hurricanes,2,Discover Central,Eastern,10,2,12,0.8333333333333334,8,2,10,0
2020-21,2021-02-03,Carolina Hurricanes,2,Discover Central,Eastern,12,2,14,0.8571428571428571,11,1,11,1
2020-21,2021-02-05,Carolina Hurricanes,0,Discover Central,Eastern,12,2,16,0.75,12,0,12,0
2020-21,2021-02-07,Carolina Hurricanes,2,Discover Central,Eastern,14,2,18,0.7777777777777778,14,0,14,0
2020-21,2021-02-09,Carolina Hurricanes,0,Discover Central,Eastern,14,2,20,0.7,14,0,14,0
2020-21,2021-02-12,Carolina Hurricanes,2,Discover Central,Eastern,16,2,22,0.7272727272727273,16,0,16,0
2020-21,2021-02-14,Carolina Hurricanes,2,Discover Central,Eastern,18,2,24,0.75,18,0,18,0
2020-21,2021-02-16,Carolina Hurricanes,2,Discover Central,Eastern,20,2,26,0.7692307692307693,20,0,18,2
2020-21,2021-02-17,Carolina Hurricanes,1,Discover Central,Eastern,21,2,28,0.75,20,1,18,3
2020-21,2021-02-20,Carolina Hurricanes,2,Discover Central,Eastern,23,2,30,0.7666666666666667,21,2,19,4
2020-21,2021-02-21,Carolina Hurricanes,2,Discover Central,Eastern,25,2,32,0.78125,21,4,20,5
2020-21,2021-02-23,Carolina Hurricanes,0,Discover Central,Eastern,25,2,34,0.7352941176470589,22,3,21,4
2020-21,2021-02-24,Carolina Hurricanes,0,Discover Central,Eastern,25,2,36,0.6944444444444444,24,1,21,4
2020-21,2021-02-26,Carolina Hurricanes,0,Discover Central,Eastern,25,2,38,0.6578947368421053,25,0,22,3
2020-21,2021-02-28,Carolina Hurricanes,2,Discover Central,Eastern,27,2,40,0.675,26,1,25,2
2020-21,2021-03-02,Carolina Hurricanes,2,Discover Central,Eastern,29,2,42,0.6904761904761905,28,1,25,4
2020-21,2021-03-03,Carolina Hurricanes,2,Discover Central,Eastern,31,2,44,0.7045454545454546,28,3,25,6
2020-21,2021-03-05,Carolina Hurricanes,2,Discover Central,Eastern,33,2,46,0.717391304347826,29,4,27,6
2020-21,2021-03-07,Carolina Hurricanes,2,Discover Central,Eastern,35,2,48,0.7291666666666666,31,4,28,7
2020-21,2021-03-10,Carolina Hurricanes,2,Discover Central,Eastern,37,2,50,0.74,31,6,30,7
2020-21,2021-03-12,Carolina Hurricanes,2,Discover Central,Eastern,39,2,52,0.75,33,6,32,7
2020-21,2021-03-14,Carolina Hurricanes,2,Discover Central,Eastern,41,2,54,0.7592592592592593,33,8,32,9
2020-21,2021-03-16,Carolina Hurricanes,0,Discover Central,Eastern,41,2,56,0.7321428571428571,33,8,34,7
2020-21,2021-03-18,Carolina Hurricanes,1,Discover Central,Eastern,42,2,58,0.7241379310344828,33,9,36,6
2020-21,2021-03-20,Carolina Hurricanes,1,Discover Central,Eastern,43,2,60,0.7166666666666667,33,10,37,6
2020-21,2021-03-22,Carolina Hurricanes,2,Discover Central,Eastern,45,2,62,0.7258064516129032,33,12,37,8
2020-21,2021-03-25,Carolina Hurricanes,2,Discover Central,Eastern,47,2,64,0.734375,35,12,37,10
2020-21,2021-03-27,Carolina Hurricanes,2,Discover Central,Eastern,49,2,66,0.7424242424242424,37,12,39,10
2020-21,2021-03-30,Carolina Hurricanes,0,Discover Central,Eastern,49,2,68,0.7205882352941176,39,10,41,8
2020-21,2021-04-02,Carolina Hurricanes,2,Discover Central,Eastern,51,2,70,0.7285714285714285,39,12,41,10
2020-21,2021-04-03,Carolina Hurricanes,0,Discover Central,Eastern,51,2,72,0.7083333333333334,41,10,43,8
2020-21,2021-04-04,Carolina Hurricanes,2,Discover Central,Eastern,53,2,74,0.7162162162162162,41,12,43,10
2020-21,2021-04-06,Carolina Hurricanes,2,Discover Central,Eastern,55,2,76,0.7236842105263158,43,12,46,9
2020-21,2021-04-08,Carolina Hurricanes,2,Discover Central,Eastern,57,2,78,0.7307692307692307,45,12,48,9
2020-21,2021-04-10,Carolina Hurricanes,1,Discover Central,Eastern,58,2,80,0.725,45,13,48,10
2020-21,2021-04-12,Carolina Hurricanes,0,Discover Central,Eastern,58,2,82,0.7073170731707317,47,11,48,10
2020-21,2021-04-15,Carolina Hurricanes,2,Discover Central,Eastern,60,2,84,0.7142857142857143,49,11,52,8
2020-21,2021-04-17,Carolina Hurricanes,2,Discover Central,Eastern,62,2,86,0.7209302325581395,49,13,54,8
2020-21,2021-04-19,Carolina Hurricanes,1,Discover Central,Eastern,63,2,88,0.7159090909090909,49,14,56,7
2020-21,2021-04-20,Carolina Hurricanes,2,Discover Central,Eastern,65,2,90,0.7222222222222222,51,14,58,7
2020-21,2021-04-22,Carolina Hurricanes,2,Discover Central,Eastern,67,2,92,0.7282608695652174,52,15,60,7
2020-21,2021-04-24,Carolina Hurricanes,1,Discover Central,Eastern,68,2,94,0.723404255319149,54,14,60,8
2020-21,2021-04-26,Carolina Hurricanes,1,Discover Central,Eastern,69,2,96,0.71875,54,15,60,9
2020-21,2021-04-28,Carolina Hurricanes,2,Discover Central,Eastern,71,2,98,0.7244897959183674,56,15,62,9
2020-21,2021-04-29,Carolina Hurricanes,2,Discover Central,Eastern,73,2,100,0.73,56,17,64,9
2020-21,2021-05-01,Carolina Hurricanes,2,Discover Central,Eastern,75,2,102,0.7352941176470589,56,19,66,9
2020-21,2021-05-03,Carolina Hurricanes,2,Discover Central,Eastern,77,2,104,0.7403846153846154,60,17,67,10
2020-21,2021-05-04,Carolina Hurricanes,2,Discover Central,Eastern,79,2,106,0.7452830188679245,60,19,68,11
2020-21,2021-05-06,Carolina Hurricanes,1,Discover Central,Eastern,80,2,108,0.7407407407407407,60,20,68,12
2020-21,2021-05-09,Carolina Hurricanes,0,Discover Central,Eastern,80,2,110,0.7272727272727273,62,18,70,10
2020-21,2021-05-11,Carolina Hurricanes,0,Discover Central,Eastern,80,2,112,0.7142857142857143,64,16,71,9
2020-21,2021-01-14,Chicago Blackhawks,0,Discover Central,Western,0,2,2,0.0,0,0,0,0
2020-21,2021-01-16,Chicago Blackhawks,0,Discover Central,Western,0,2,4,0.0,0,0,2,-2
2020-21,2021-01-18,Chicago Blackhawks,0,Discover Central,Western,0,2,6,0.0,2,-2,2,-2
2020-21,2021-01-20,Chicago Blackhawks,1,Discover Central,Western,1,2,8,0.125,4,-3,3,-2
2020-21,2021-01-23,Chicago Blackhawks,2,Discover Central,Western,3,2,10,0.3,4,-1,4,-1
2020-21,2021-01-24,Chicago Blackhawks,2,Discover Central,Western,5,2,12,0.4166666666666667,4,1,5,0
2020-21,2021-01-27,Chicago Blackhawks,1,Discover Central,Western,6,2,14,0.42857142857142855,6,0,6,0
2020-21,2021-01-28,Chicago Blackhawks,1,Discover Central,Western,7,2,16,0.4375,6,1,8,-1
2020-21,2021-01-30,Chicago Blackhawks,0,Discover Central,Western,7,2,18,0.3888888888888889,7,0,8,-1
2020-21,2021-02-01,Chicago Blackhawks,2,Discover Central,Western,9,2,20,0.45,9,0,9,0
2020-21,2021-02-03,Chicago Blackhawks,1,Discover Central,Western,10,2,22,0.45454545454545453,11,-1,11,-1
2020-21,2021-02-05,Chicago Blackhawks,2,Discover Central,Western,12,2,24,0.5,12,0,11,1
2020-21,2021-02-07,Chicago Blackhawks,2,Discover Central,Western,14,2,26,0.5384615384615384,14,0,12,2
2020-21,2021-02-10,Chicago Blackhawks,2,Discover Central,Western,16,2,28,0.5714285714285714,15,1,13,3
2020-21,2021-02-12,Chicago Blackhawks,0,Discover Central,Western,16,2,30,0.5333333333333333,16,0,15,1
2020-21,2021-02-14,Chicago Blackhawks,2,Discover Central,Western,18,2,32,0.5625,18,0,15,3
2020-21,2021-02-16,Chicago Blackhawks,2,Discover Central,Western,20,2,34,0.5882352941176471,20,0,15,5
2020-21,2021-02-18,Chicago Blackhawks,2,Discover Central,Western,22,2,36,0.6111111111111112,21,1,17,5
2020-21,2021-02-20,Chicago Blackhawks,0,Discover Central,Western,22,2,38,0.5789473684210527,21,1,17,5
2020-21,2021-02-24,Chicago Blackhawks,2,Discover Central,Western,24,2,40,0.6,24,0,19,5
2020-21,2021-02-26,Chicago Blackhawks,2,Discover Central,Western,26,2,42,0.6190476190476191,25,1,20,6
2020-21,2021-02-28,Chicago Blackhawks,0,Discover Central,Western,26,2,44,0.5909090909090909,26,0,22,4
2020-21,2021-03-01,Chicago Blackhawks,2,Discover Central,Western,28,2,46,0.6086956521739131,27,1,22,6
2020-21,2021-03-05,Chicago Blackhawks,1,Discover Central,Western,29,2,48,0.6041666666666666,29,0,24,5
2020-21,2021-03-06,Chicago Blackhawks,2,Discover Central,Western,31,2,50,0.62,31,0,24,7
2020-21,2021-03-07,Chicago Blackhawks,0,Discover Central,Western,31,2,52,0.5961538461538461,31,0,25,6
2020-21,2021-03-10,Chicago Blackhawks,0,Discover Central,Western,31,2,54,0.5740740740740741,31,0,27,4
2020-21,2021-03-12,Chicago Blackhawks,2,Discover Central,Western,33,2,56,0.5892857142857143,33,0,28,5
2020-21,2021-03-14,Chicago Blackhawks,0,Discover Central,Western,33,2,58,0.5689655172413793,33,0,29,4
2020-21,2021-03-15,Chicago Blackhawks,0,Discover Central,Western,33,2,60,0.55,33,0,30,3
2020-21,2021-03-18,Chicago Blackhawks,0,Discover Central,Western,33,2,62,0.532258064516129,33,0,32,1
2020-21,2021-03-20,Chicago Blackhawks,0,Discover Central,Western,33,2,64,0.515625,33,0,33,0
2020-21,2021-03-24,Chicago Blackhawks,2,Discover Central,Western,35,2,66,0.5303030303030303,35,0,35,0
2020-21,2021-03-26,Chicago Blackhawks,2,Discover Central,Western,37,2,68,0.5441176470588235,37,0,35,2
2020-21,2021-03-28,Chicago Blackhawks,0,Discover Central,Western,37,2,70,0.5285714285714286,37,0,37,0
2020-21,2021-03-29,Chicago Blackhawks,0,Discover Central,Western,37,2,72,0.5138888888888888,37,0,37,0
2020-21,2021-03-30,Chicago Blackhawks,2,Discover Central,Western,39,2,74,0.527027027027027,39,0,37,2
2020-21,2021-04-02,Chicago Blackhawks,0,Discover Central,Western,39,2,76,0.5131578947368421,39,0,38,1
2020-21,2021-04-03,Chicago Blackhawks,0,Discover Central,Western,39,2,78,0.5,41,-2,39,0
2020-21,2021-04-07,Chicago Blackhawks,2,Discover Central,Western,41,2,80,0.5125,43,-2,41,0
2020-21,2021-04-09,Chicago Blackhawks,0,Discover Central,Western,41,2,82,0.5,45,-4,41,0
2020-21,2021-04-10,Chicago Blackhawks,2,Discover Central,Western,43,2,84,0.5119047619047619,45,-2,43,0
2020-21,2021-04-12,Chicago Blackhawks,2,Discover Central,Western,45,2,86,0.5232558139534884,47,-2,44,1
2020-21,2021-04-15,Chicago Blackhawks,0,Discover Central,Western,45,2,88,0.5113636363636364,49,-4,44,1
2020-21,2021-04-17,Chicago Blackhawks,2,Discover Central,Western,47,2,90,0.5222222222222223,49,-2,45,2
2020-21,2021-04-20,Chicago Blackhawks,0,Discover Central,Western,47,2,92,0.5108695652173914,51,-4,47,0
2020-21,2021-04-21,Chicago Blackhawks,2,Discover Central,Western,49,2,94,0.5212765957446809,52,-3,49,0
2020-21,2021-04-24,Chicago Blackhawks,0,Discover Central,Western,49,2,96,0.5104166666666666,54,-5,49,0
2020-21,2021-04-28,Chicago Blackhawks,0,Discover Central,Western,49,2,98,0.5,56,-7,50,-1
2020-21,2021-04-30,Chicago Blackhawks,1,Discover Central,Western,50,2,100,0.5,56,-6,52,-2
2020-21,2021-05-02,Chicago Blackhawks,0,Discover Central,Western,50,2,102,0.49019607843137253,58,-8,53,-3
2020-21,2021-05-03,Chicago Blackhawks,0,Discover Central,Western,50,2,104,0.4807692307692308,60,-10,53,-3
2020-21,2021-05-04,Chicago Blackhawks,0,Discover Central,Western,50,2,106,0.4716981132075472,60,-10,55,-5
2020-21,2021-05-06,Chicago Blackhawks,2,Discover Central,Western,52,2,108,0.48148148148148145,60,-8,56,-4
2020-21,2021-05-09,Chicago Blackhawks,2,Discover Central,Western,54,2,110,0.4909090909090909,62,-8,57,-3
2020-21,2021-05-11,Chicago Blackhawks,1,Discover Central,Western,55,2,112,0.49107142857142855,64,-9,59,-4
2020-21,2021-01-14,Colorado Avalanche,0,Honda West,Western,0,2,2,0.0,0,0,0,0
2020-21,2021-01-16,Colorado Avalanche,2,Honda West,Western,2,2,4,0.5,2,0,2,0
2020-21,2021-01-20,Colorado Avalanche,2,Honda West,Western,4,2,6,0.6666666666666666,4,0,3,1
2020-21,2021-01-22,Colorado Avalanche,0,Honda West,Western,4,2,8,0.5,4,0,4,0
2020-21,2021-01-23,Colorado Avalanche,2,Honda West,Western,6,2,10,0.6,5,1,4,2
2020-21,2021-01-25,Colorado Avalanche,0,Honda West,Western,6,2,12,0.5,6,0,6,0
2020-21,2021-01-27,Colorado Avalanche,2,Honda West,Western,8,2,14,0.5714285714285714,8,0,6,2
2020-21,2021-01-29,Colorado Avalanche,2,Honda West,Western,10,2,16,0.625,9,1,8,2
2020-21,2021-01-31,Colorado Avalanche,2,Honda West,Western,12,2,18,0.6666666666666666,10,2,8,4
2020-21,2021-02-01,Colorado Avalanche,1,Honda West,Western,13,2,20,0.65,11,2,9,4
2020-21,2021-02-03,Colorado Avalanche,2,Honda West,Western,15,2,22,0.6818181818181818,11,4,11,4
2020-21,2021-02-15,Colorado Avalanche,0,Honda West,Western,15,2,24,0.625,15,0,15,0
2020-21,2021-02-17,Colorado Avalanche,2,Honda West,Western,17,2,26,0.6538461538461539,16,1,16,1
2020-21,2021-02-20,Colorado Avalanche,2,Honda West,Western,19,2,28,0.6785714285714286,17,2,17,2
2020-21,2021-02-23,Colorado Avalanche,0,Honda West,Western,19,2,30,0.6333333333333333,19,0,19,0
2020-21,2021-02-25,Colorado Avalanche,0,Honda West,Western,19,2,32,0.59375,21,-2,20,-1
2020-21,2021-02-27,Colorado Avalanche,2,Honda West,Western,21,2,34,0.6176470588235294,21,0,21,0
2020-21,2021-02-28,Colorado Avalanche,2,Honda West,Western,23,2,36,0.6388888888888888,23,0,22,1
2020-21,2021-03-02,Colorado Avalanche,0,Honda West,Western,23,2,38,0.6052631578947368,23,0,22,1
2020-21,2021-03-04,Colorado Avalanche,2,Honda West,Western,25,2,40,0.625,25,0,23,2
2020-21,2021-03-06,Colorado Avalanche,2,Honda West,Western,27,2,42,0.6428571428571429,27,0,24,3
2020-21,2021-03-07,Colorado Avalanche,1,Honda West,Western,28,2,44,0.6363636363636364,27,1,25,3
2020-21,2021-03-09,Colorado Avalanche,0,Honda West,Western,28,2,46,0.6086956521739131,28,0,27,1
2020-21,2021-03-11,Colorado Avalanche,2,Honda West,Western,30,2,48,0.625,30,0,28,2
2020-21,2021-03-13,Colorado Avalanche,2,Honda West,Western,32,2,50,0.64,32,0,28,4
2020-21,2021-03-14,Colorado Avalanche,2,Honda West,Western,34,2,52,0.6538461538461539,33,1,29,5
2020-21,2021-03-17,Colorado Avalanche,2,Honda West,Western,36,2,54,0.6666666666666666,33,3,32,4
2020-21,2021-03-19,Colorado Avalanche,2,Honda West,Western,38,2,56,0.6785714285714286,33,5,33,5
2020-21,2021-03-20,Colorado Avalanche,2,Honda West,Western,40,2,58,0.6896551724137931,35,5,33,7
2020-21,2021-03-23,Colorado Avalanche,2,Honda West,Western,42,2,60,0.7,37,5,33,9
2020-21,2021-03-24,Colorado Avalanche,1,Honda West,Western,43,2,62,0.6935483870967742,37,6,35,8
2020-21,2021-03-26,Colorado Avalanche,2,Honda West,Western,45,2,64,0.703125,37,8,35,10
2020-21,2021-03-27,Colorado Avalanche,1,Honda West,Western,46,2,66,0.696969696969697,37,9,35,11
2020-21,2021-03-30,Colorado Avalanche,2,Honda West,Western,48,2,68,0.7058823529411765,38,10,37,11
2020-21,2021-04-01,Colorado Avalanche,2,Honda West,Western,50,2,70,0.7142857142857143,38,12,38,12
2020-21,2021-04-03,Colorado Avalanche,2,Honda West,Western,52,2,72,0.7222222222222222,39,13,39,13
2020-21,2021-04-04,Colorado Avalanche,2,Honda West,Western,54,2,74,0.7297297297297297,39,15,39,15
2020-21,2021-04-06,Colorado Avalanche,2,Honda West,Western,56,2,76,0.7368421052631579,43,13,39,17
2020-21,2021-04-08,Colorado Avalanche,0,Honda West,Western,56,2,78,0.717948717948718,43,13,41,15
2020-21,2021-04-10,Colorado Avalanche,2,Honda West,Western,58,2,80,0.725,43,15,43,15
2020-21,2021-04-11,Colorado Avalanche,2,Honda West,Western,60,2,82,0.7317073170731707,44,16,43,17
2020-21,2021-04-13,Colorado Avalanche,2,Honda West,Western,62,2,84,0.7380952380952381,44,18,44,18
2020-21,2021-04-14,Colorado Avalanche,2,Honda West,Western,64,2,86,0.7441860465116279,44,20,44,20
2020-21,2021-04-23,Colorado Avalanche,2,Honda West,Western,66,2,88,0.75,45,21,49,17
2020-21,2021-04-24,Colorado Avalanche,0,Honda West,Western,66,2,90,0.7333333333333333,46,20,49,17
2020-21,2021-04-26,Colorado Avalanche,0,Honda West,Western,66,2,92,0.717391304347826,48,18,49,17
2020-21,2021-04-29,Colorado Avalanche,0,Honda West,Western,66,2,94,0.7021276595744681,50,16,50,16
2020-21,2021-05-01,Colorado Avalanche,2,Honda West,Western,68,2,96,0.7083333333333334,52,16,52,16
2020-21,2021-05-02,Colorado Avalanche,2,Honda West,Western,70,2,98,0.7142857142857143,53,17,53,17
2020-21,2021-05-04,Colorado Avalanche,2,Honda West,Western,72,2,100,0.72,55,17,55,17
2020-21,2021-05-06,Colorado Avalanche,0,Honda West,Western,72,2,102,0.7058823529411765,56,16,56,16
2020-21,2021-05-08,Colorado Avalanche,2,Honda West,Western,74,2,104,0.7115384615384616,57,17,57,17
2020-21,2021-05-09,Colorado Avalanche,2,Honda West,Western,76,2,106,0.7169811320754716,57,19,57,19
2020-21,2021-05-11,Colorado Avalanche,2,Honda West,Western,78,2,108,0.7222222222222222,59,19,59,19
2020-21,2021-05-13,Colorado Avalanche,2,Honda West,Western,80,2,110,0.7272727272727273,61,19,60,20
2020-21,2021-05-14,Colorado Avalanche,2,Honda West,Western,82,2,112,0.7321428571428571,63,19,60,22
2020-21,2021-01-15,Columbus Blue Jackets,0,Discover Central,Eastern,0,2,2,0.0,0,0,1,-1
2020-21,2021-01-17,Columbus Blue Jackets,0,Discover Central,Eastern,0,2,4,0.0,2,-2,2,-2
2020-21,2021-01-18,Columbus Blue Jackets,2,Discover Central,Eastern,2,2,6,0.3333333333333333,2,0,3,-1
2020-21,2021-01-20,Columbus Blue Jackets,1,Discover Central,Eastern,3,2,8,0.375,4,-1,4,-1
2020-21,2021-01-22,Columbus Blue Jackets,1,Discover Central,Eastern,4,2,10,0.4,4,0,5,-1
2020-21,2021-01-23,Columbus Blue Jackets,2,Discover Central,Eastern,6,2,12,0.5,4,2,6,0
2020-21,2021-01-27,Columbus Blue Jackets,1,Discover Central,Eastern,7,2,14,0.5,6,1,7,0
2020-21,2021-01-29,Columbus Blue Jackets,2,Discover Central,Eastern,9,2,16,0.5625,7,2,8,1
2020-21,2021-01-30,Columbus Blue Jackets,2,Discover Central,Eastern,11,2,18,0.6111111111111112,7,4,9,2
2020-21,2021-02-01,Columbus Blue Jackets,0,Discover Central,Eastern,11,2,20,0.55,9,2,10,1
2020-21,2021-02-03,Columbus Blue Jackets,0,Discover Central,Eastern,11,2,22,0.5,11,0,11,0
2020-21,2021-02-05,Columbus Blue Jackets,2,Discover Central,Eastern,13,2,24,0.5416666666666666,12,1,12,1
2020-21,2021-02-07,Columbus Blue Jackets,0,Discover Central,Eastern,13,2,26,0.5,14,-1,14,-1
2020-21,2021-02-09,Columbus Blue Jackets,2,Discover Central,Eastern,15,2,28,0.5357142857142857,14,1,14,1
2020-21,2021-02-12,Columbus Blue Jackets,2,Discover Central,Eastern,17,2,30,0.5666666666666667,16,1,16,1
2020-21,2021-02-14,Columbus Blue Jackets,1,Discover Central,Eastern,18,2,32,0.5625,18,0,18,0
2020-21,2021-02-16,Columbus Blue Jackets,0,Discover Central,Eastern,18,2,34,0.5294117647058824,20,-2,18,0
2020-21,2021-02-19,Columbus Blue Jackets,2,Discover Central,Eastern,20,2,36,0.5555555555555556,21,-1,19,1
2020-21,2021-02-21,Columbus Blue Jackets,0,Discover Central,Eastern,20,2,38,0.5263157894736842,21,-1,20,0
2020-21,2021-02-24,Columbus Blue Jackets,1,Discover Central,Eastern,21,2,40,0.525,24,-3,21,0
2020-21,2021-02-26,Columbus Blue Jackets,0,Discover Central,Eastern,21,2,42,0.5,25,-4,22,-1
2020-21,2021-02-27,Columbus Blue Jackets,0,Discover Central,Eastern,21,2,44,0.4772727272727273,25,-4,23,-2
2020-21,2021-02-28,Columbus Blue Jackets,0,Discover Central,Eastern,21,2,46,0.45652173913043476,26,-5,25,-4
2020-21,2021-03-03,Columbus Blue Jackets,2,Discover Central,Eastern,23,2,48,0.4791666666666667,28,-5,25,-2
2020-21,2021-03-05,Columbus Blue Jackets,2,Discover Central,Eastern,25,2,50,0.5,29,-4,27,-2
2020-21,2021-03-07,Columbus Blue Jackets,0,Discover Central,Eastern,25,2,52,0.4807692307692308,31,-6,28,-3
2020-21,2021-03-10,Columbus Blue Jackets,0,Discover Central,Eastern,25,2,54,0.46296296296296297,31,-6,30,-5
2020-21,2021-03-12,Columbus Blue Jackets,1,Discover Central,Eastern,26,2,56,0.4642857142857143,33,-7,32,-6
2020-21,2021-03-13,Columbus Blue Jackets,2,Discover Central,Eastern,28,2,58,0.4827586206896552,33,-5,32,-4
2020-21,2021-03-14,Columbus Blue Jackets,1,Discover Central,Eastern,29,2,60,0.48333333333333334,33,-4,32,-3
2020-21,2021-03-18,Columbus Blue Jackets,2,Discover Central,Eastern,31,2,62,0.5,33,-2,36,-5
2020-21,2021-03-20,Columbus Blue Jackets,2,Discover Central,Eastern,33,2,64,0.515625,33,0,37,-4
2020-21,2021-03-22,Columbus Blue Jackets,0,Discover Central,Eastern,33,2,66,0.5,33,0,37,-4
2020-21,2021-03-25,Columbus Blue Jackets,1,Discover Central,Eastern,34,2,68,0.5,35,-1,37,-3
2020-21,2021-03-27,Columbus Blue Jackets,0,Discover Central,Eastern,34,2,70,0.4857142857142857,37,-3,39,-5
2020-21,2021-03-28,Columbus Blue Jackets,0,Discover Central,Eastern,34,2,72,0.4722222222222222,37,-3,39,-5
2020-21,2021-03-30,Columbus Blue Jackets,2,Discover Central,Eastern,36,2,74,0.4864864864864865,39,-3,41,-5
2020-21,2021-04-01,Columbus Blue Jackets,0,Discover Central,Eastern,36,2,76,0.47368421052631576,39,-3,41,-5
2020-21,2021-04-03,Columbus Blue Jackets,0,Discover Central,Eastern,36,2,78,0.46153846153846156,41,-5,43,-7
2020-21,2021-04-04,Columbus Blue Jackets,0,Discover Central,Eastern,36,2,80,0.45,41,-5,43,-7
2020-21,2021-04-06,Columbus Blue Jackets,2,Discover Central,Eastern,38,2,82,0.4634146341463415,43,-5,46,-8
2020-21,2021-04-08,Columbus Blue Jackets,0,Discover Central,Eastern,38,2,84,0.4523809523809524,45,-7,48,-10
2020-21,2021-04-10,Columbus Blue Jackets,0,Discover Central,Eastern,38,2,86,0.4418604651162791,45,-7,48,-10
2020-21,2021-04-12,Columbus Blue Jackets,1,Discover Central,Eastern,39,2,88,0.4431818181818182,47,-8,48,-9
2020-21,2021-04-16,Columbus Blue Jackets,0,Discover Central,Eastern,39,2,90,0.43333333333333335,49,-10,54,-15
2020-21,2021-04-18,Columbus Blue Jackets,0,Discover Central,Eastern,39,2,92,0.42391304347826086,49,-10,56,-17
2020-21,2021-04-19,Columbus Blue Jackets,0,Discover Central,Eastern,39,2,94,0.4148936170212766,49,-10,56,-17
2020-21,2021-04-20,Columbus Blue Jackets,0,Discover Central,Eastern,39,2,96,0.40625,51,-12,58,-19
2020-21,2021-04-22,Columbus Blue Jackets,0,Discover Central,Eastern,39,2,98,0.3979591836734694,52,-13,60,-21
2020-21,2021-04-25,Columbus Blue Jackets,1,Discover Central,Eastern,40,2,100,0.4,54,-14,60,-20
2020-21,2021-04-27,Columbus Blue Jackets,2,Discover Central,Eastern,42,2,102,0.4117647058823529,56,-14,62,-20
2020-21,2021-05-01,Columbus Blue Jackets,1,Discover Central,Eastern,43,2,104,0.41346153846153844,56,-13,66,-23
2020-21,2021-05-03,Columbus Blue Jackets,1,Discover Central,Eastern,44,2,106,0.41509433962264153,60,-16,67,-23
2020-21,2021-05-05,Columbus Blue Jackets,2,Discover Central,Eastern,46,2,108,0.42592592592592593,60,-14,68,-22
2020-21,2021-05-07,Columbus Blue Jackets,0,Discover Central,Eastern,46,2,110,0.41818181818181815,60,-14,68,-22
2020-21,2021-05-08,Columbus Blue Jackets,2,Discover Central,Eastern,48,2,112,0.42857142857142855,60,-12,70,-22
2020-21,2021-01-23,Dallas Stars,2,Discover Central,Western,2,2,2,1.0,4,-2,4,-2
2020-21,2021-01-25,Dallas Stars,2,Discover Central,Western,4,2,4,1.0,4,0,6,-2
2020-21,2021-01-27,Dallas Stars,2,Discover Central,Western,6,2,6,1.0,6,0,6,0
2020-21,2021-01-29,Dallas Stars,2,Discover Central,Western,8,2,8,1.0,7,1,8,0
2020-21,2021-01-31,Dallas Stars,0,Discover Central,Western,8,2,10,0.8,8,0,8,0
2020-21,2021-01-31,Dallas Stars,1,Discover Central,Western,9,2,12,0.75,8,1,8,1
2020-21,2021-02-03,Dallas Stars,2,Discover Central,Western,11,2,14,0.7857142857142857,11,0,11,0
2020-21,2021-02-05,Dallas Stars,0,Discover Central,Western,11,2,16,0.6875,12,-1,11,0
2020-21,2021-02-07,Dallas Stars,1,Discover Central,Western,12,2,18,0.6666666666666666,14,-2,12,0
2020-21,2021-02-10,Dallas Stars,1,Discover Central,Western,13,2,20,0.65,15,-2,13,0
2020-21,2021-02-12,Dallas Stars,0,Discover Central,Western,13,2,22,0.5909090909090909,16,-3,15,-2
2020-21,2021-02-14,Dallas Stars,1,Discover Central,Western,14,2,24,0.5833333333333334,18,-4,15,-1
2020-21,2021-02-23,Dallas Stars,0,Discover Central,Western,14,2,26,0.5384615384615384,22,-8,19,-5
2020-21,2021-02-24,Dallas Stars,2,Discover Central,Western,16,2,28,0.5714285714285714,24,-8,19,-3
2020-21,2021-02-26,Dallas Stars,0,Discover Central,Western,16,2,30,0.5333333333333333,25,-9,20,-4
2020-21,2021-02-28,Dallas Stars,0,Discover Central,Western,16,2,32,0.5,26,-10,22,-6
2020-21,2021-03-03,Dallas Stars,0,Discover Central,Western,16,2,34,0.47058823529411764,28,-12,22,-6
2020-21,2021-03-05,Dallas Stars,0,Discover Central,Western,16,2,36,0.4444444444444444,29,-13,24,-8
2020-21,2021-03-07,Dallas Stars,2,Discover Central,Western,18,2,38,0.47368421052631576,31,-13,25,-7
2020-21,2021-03-08,Dallas Stars,1,Discover Central,Western,19,2,40,0.475,31,-12,25,-6
2020-21,2021-03-10,Dallas Stars,2,Discover Central,Western,21,2,42,0.5,31,-10,27,-6
2020-21,2021-03-12,Dallas Stars,0,Discover Central,Western,21,2,44,0.4772727272727273,33,-12,28,-7
2020-21,2021-03-13,Dallas Stars,1,Discover Central,Western,22,2,46,0.4782608695652174,33,-11,28,-6
2020-21,2021-03-14,Dallas Stars,2,Discover Central,Western,24,2,48,0.5,33,-9,29,-5
2020-21,2021-03-17,Dallas Stars,1,Discover Central,Western,25,2,50,0.5,33,-8,32,-7
2020-21,2021-03-18,Dallas Stars,0,Discover Central,Western,25,2,52,0.4807692307692308,33,-8,32,-7
2020-21,2021-03-20,Dallas Stars,2,Discover Central,Western,27,2,54,0.5,33,-6,33,-6
2020-21,2021-03-22,Dallas Stars,1,Discover Central,Western,28,2,56,0.5,33,-5,33,-5
2020-21,2021-03-24,Dallas Stars,0,Discover Central,Western,28,2,58,0.4827586206896552,35,-7,35,-7
2020-21,2021-03-26,Dallas Stars,2,Discover Central,Western,30,2,60,0.5,37,-7,35,-5
2020-21,2021-03-28,Dallas Stars,0,Discover Central,Western,30,2,62,0.4838709677419355,37,-7,37,-7
2020-21,2021-03-28,Dallas Stars,1,Discover Central,Western,31,2,64,0.484375,37,-6,37,-6
2020-21,2021-03-31,Dallas Stars,1,Discover Central,Western,32,2,66,0.48484848484848486,39,-7,38,-6
2020-21,2021-04-02,Dallas Stars,2,Discover Central,Western,34,2,68,0.5,39,-5,38,-4
2020-21,2021-04-03,Dallas Stars,2,Discover Central,Western,36,2,70,0.5142857142857142,41,-5,39,-3
2020-21,2021-04-04,Dallas Stars,0,Discover Central,Western,36,2,72,0.5,41,-5,39,-3
2020-21,2021-04-07,Dallas Stars,0,Discover Central,Western,36,2,74,0.4864864864864865,43,-7,41,-5
2020-21,2021-04-09,Dallas Stars,2,Discover Central,Western,38,2,76,0.5,45,-7,41,-3
2020-21,2021-04-10,Dallas Stars,2,Discover Central,Western,40,2,78,0.5128205128205128,45,-5,43,-3
2020-21,2021-04-12,Dallas Stars,1,Discover Central,Western,41,2,80,0.5125,47,-6,44,-3
2020-21,2021-04-14,Dallas Stars,1,Discover Central,Western,42,2,82,0.5121951219512195,49,-7,44,-2
2020-21,2021-04-16,Dallas Stars,2,Discover Central,Western,44,2,84,0.5238095238095238,49,-5,44,0
2020-21,2021-04-18,Dallas Stars,2,Discover Central,Western,46,2,86,0.5348837209302325,49,-3,46,0
2020-21,2021-04-19,Dallas Stars,2,Discover Central,Western,48,2,88,0.5454545454545454,49,-1,47,1
2020-21,2021-04-21,Dallas Stars,2,Discover Central,Western,50,2,90,0.5555555555555556,52,-2,49,1
2020-21,2021-04-22,Dallas Stars,0,Discover Central,Western,50,2,92,0.5434782608695652,52,-2,49,1
2020-21,2021-04-24,Dallas Stars,2,Discover Central,Western,52,2,94,0.5531914893617021,54,-2,49,3
2020-21,2021-04-26,Dallas Stars,2,Discover Central,Western,54,2,96,0.5625,54,0,49,5
2020-21,2021-04-28,Dallas Stars,0,Discover Central,Western,54,2,98,0.5510204081632653,56,-2,50,4
2020-21,2021-04-29,Dallas Stars,0,Discover Central,Western,54,2,100,0.54,56,-2,50,4
2020-21,2021-05-02,Dallas Stars,1,Discover Central,Western,55,2,102,0.5392156862745098,58,-3,53,2
2020-21,2021-05-03,Dallas Stars,1,Discover Central,Western,56,2,104,0.5384615384615384,60,-4,53,3
2020-21,2021-05-05,Dallas Stars,0,Discover Central,Western,56,2,106,0.5283018867924528,60,-4,55,1
2020-21,2021-05-07,Dallas Stars,2,Discover Central,Western,58,2,108,0.5370370370370371,60,-2,56,2
2020-21,2021-05-09,Dallas Stars,0,Discover Central,Western,58,2,110,0.5272727272727272,62,-4,57,1
2020-21,2021-05-11,Dallas Stars,2,Discover Central,Western,60,2,112,0.5357142857142857,64,-4,59,1
2020-21,2021-01-15,Detroit Red Wings,0,Discover Central,Eastern,0,2,2,0.0,0,0,1,-1
2020-21,2021-01-17,Detroit Red Wings,2,Discover Central,Eastern,2,2,4,0.5,2,0,2,0
2020-21,2021-01-18,Detroit Red Wings,0,Discover Central,Eastern,2,2,6,0.3333333333333333,2,0,3,-1
2020-21,2021-01-20,Detroit Red Wings,2,Discover Central,Eastern,4,2,8,0.5,4,0,4,0
2020-21,2021-01-23,Detroit Red Wings,0,Discover Central,Eastern,4,2,10,0.4,4,0,6,-2
2020-21,2021-01-24,Detroit Red Wings,0,Discover Central,Eastern,4,2,12,0.3333333333333333,4,0,6,-2
2020-21,2021-01-27,Detroit Red Wings,1,Discover Central,Eastern,5,2,14,0.35714285714285715,6,-1,7,-2
2020-21,2021-01-29,Detroit Red Wings,0,Discover Central,Eastern,5,2,16,0.3125,7,-2,8,-3
2020-21,2021-01-31,Detroit Red Wings,1,Discover Central,Eastern,6,2,18,0.3333333333333333,8,-2,10,-4
2020-21,2021-01-31,Detroit Red Wings,0,Discover Central,Eastern,6,2,20,0.3,8,-2,10,-4
2020-21,2021-02-03,Detroit Red Wings,0,Discover Central,Eastern,6,2,22,0.2727272727272727,11,-5,11,-5
2020-21,2021-02-06,Detroit Red Wings,0,Discover Central,Eastern,6,2,24,0.25,12,-6,13,-7
2020-21,2021-02-07,Detroit Red Wings,2,Discover Central,Eastern,8,2,26,0.3076923076923077,14,-6,14,-6
2020-21,2021-02-10,Detroit Red Wings,0,Discover Central,Eastern,8,2,28,0.2857142857142857,15,-7,15,-7
2020-21,2021-02-12,Detroit Red Wings,0,Discover Central,Eastern,8,2,30,0.26666666666666666,16,-8,16,-8
2020-21,2021-02-14,Detroit Red Wings,2,Discover Central,Eastern,10,2,32,0.3125,18,-8,18,-8
2020-21,2021-02-16,Detroit Red Wings,1,Discover Central,Eastern,11,2,34,0.3235294117647059,20,-9,18,-7
2020-21,2021-02-18,Detroit Red Wings,0,Discover Central,Eastern,11,2,36,0.3055555555555556,21,-10,18,-7
2020-21,2021-02-20,Detroit Red Wings,2,Discover Central,Eastern,13,2,38,0.34210526315789475,21,-8,19,-6
2020-21,2021-02-20,Detroit Red Wings,0,Discover Central,Eastern,13,2,40,0.325,21,-8,19,-6
2020-21,2021-02-24,Detroit Red Wings,0,Discover Central,Eastern,13,2,42,0.30952380952380953,24,-11,21,-8
2020-21,2021-02-26,Detroit Red Wings,2,Discover Central,Eastern,15,2,44,0.3409090909090909,25,-10,22,-7
2020-21,2021-02-28,Detroit Red Wings,2,Discover Central,Eastern,17,2,46,0.3695652173913043,26,-9,25,-8
2020-21,2021-03-01,Detroit Red Wings,0,Discover Central,Eastern,17,2,48,0.3541666666666667,27,-10,25,-8
2020-21,2021-03-03,Detroit Red Wings,0,Discover Central,Eastern,17,2,50,0.34,28,-11,25,-8
2020-21,2021-03-05,Detroit Red Wings,0,Discover Central,Eastern,17,2,52,0.3269230769230769,29,-12,27,-10
2020-21,2021-03-10,Detroit Red Wings,1,Discover Central,Eastern,18,2,54,0.3333333333333333,31,-13,30,-12
2020-21,2021-03-12,Detroit Red Wings,2,Discover Central,Eastern,20,2,56,0.35714285714285715,33,-13,32,-12
2020-21,2021-03-14,Detroit Red Wings,0,Discover Central,Eastern,20,2,58,0.3448275862068966,33,-13,32,-12
2020-21,2021-03-16,Detroit Red Wings,2,Discover Central,Eastern,22,2,60,0.36666666666666664,33,-11,34,-12
2020-21,2021-03-18,Detroit Red Wings,2,Discover Central,Eastern,24,2,62,0.3870967741935484,33,-9,36,-12
2020-21,2021-03-20,Detroit Red Wings,0,Discover Central,Eastern,24,2,64,0.375,33,-9,37,-13
2020-21,2021-03-24,Detroit Red Wings,0,Discover Central,Eastern,24,2,66,0.36363636363636365,35,-11,37,-13
2020-21,2021-03-26,Detroit Red Wings,0,Discover Central,Eastern,24,2,68,0.35294117647058826,37,-13,37,-13
2020-21,2021-03-27,Detroit Red Wings,2,Discover Central,Eastern,26,2,70,0.37142857142857144,37,-11,39,-13
2020-21,2021-03-28,Detroit Red Wings,2,Discover Central,Eastern,28,2,72,0.3888888888888889,37,-9,39,-11
2020-21,2021-03-30,Detroit Red Wings,0,Discover Central,Eastern,28,2,74,0.3783783783783784,39,-11,41,-13
2020-21,2021-04-01,Detroit Red Wings,1,Discover Central,Eastern,29,2,76,0.3815789473684211,39,-10,41,-12
2020-21,2021-04-03,Detroit Red Wings,0,Discover Central,Eastern,29,2,78,0.3717948717948718,41,-12,43,-14
2020-21,2021-04-04,Detroit Red Wings,2,Discover Central,Eastern,31,2,80,0.3875,41,-10,43,-12
2020-21,2021-04-06,Detroit Red Wings,1,Discover Central,Eastern,32,2,82,0.3902439024390244,43,-11,46,-14
2020-21,2021-04-08,Detroit Red Wings,0,Discover Central,Eastern,32,2,84,0.38095238095238093,45,-13,48,-16
2020-21,2021-04-10,Detroit Red Wings,2,Discover Central,Eastern,34,2,86,0.3953488372093023,45,-11,48,-14
2020-21,2021-04-12,Detroit Red Wings,2,Discover Central,Eastern,36,2,88,0.4090909090909091,47,-11,48,-12
2020-21,2021-04-15,Detroit Red Wings,2,Discover Central,Eastern,38,2,90,0.4222222222222222,49,-11,52,-14
2020-21,2021-04-17,Detroit Red Wings,0,Discover Central,Eastern,38,2,92,0.41304347826086957,49,-11,54,-16
2020-21,2021-04-19,Detroit Red Wings,1,Discover Central,Eastern,39,2,94,0.4148936170212766,49,-10,56,-17
2020-21,2021-04-21,Detroit Red Wings,0,Discover Central,Eastern,39,2,96,0.40625,52,-13,58,-19
2020-21,2021-04-22,Detroit Red Wings,2,Discover Central,Eastern,41,2,98,0.41836734693877553,52,-11,60,-19
2020-21,2021-04-24,Detroit Red Wings,1,Discover Central,Eastern,42,2,100,0.42,54,-12,60,-18
2020-21,2021-04-27,Detroit Red Wings,1,Discover Central,Eastern,43,2,102,0.4215686274509804,56,-13,62,-19
2020-21,2021-04-29,Detroit Red Wings,0,Discover Central,Eastern,43,2,104,0.41346153846153844,56,-13,64,-21
2020-21,2021-05-01,Detroit Red Wings,2,Discover Central,Eastern,45,2,106,0.42452830188679247,56,-11,66,-21
2020-21,2021-05-02,Detroit Red Wings,0,Discover Central,Eastern,45,2,108,0.4166666666666667,58,-13,66,-21
2020-21,2021-05-07,Detroit Red Wings,2,Discover Central,Eastern,47,2,110,0.42727272727272725,60,-13,68,-21
2020-21,2021-05-08,Detroit Red Wings,1,Discover Central,Eastern,48,2,112,0.42857142857142855,60,-12,70,-22
2020-21,2021-01-14,Edmonton Oilers,0,Scotia North,Western,0,2,2,0.0,0,0,0,0
2020-21,2021-01-15,Edmonton Oilers,2,Scotia North,Western,2,2,4,0.5,2,0,2,0
2020-21,2021-01-17,Edmonton Oilers,0,Scotia North,Western,2,2,6,0.3333333333333333,2,0,2,0
2020-21,2021-01-19,Edmonton Oilers,0,Scotia North,Western,2,2,8,0.25,2,0,2,0
2020-21,2021-01-21,Edmonton Oilers,2,Scotia North,Western,4,2,10,0.4,4,0,4,0
2020-21,2021-01-23,Edmonton Oilers,0,Scotia North,Western,4,2,12,0.3333333333333333,5,-1,4,0
2020-21,2021-01-25,Edmonton Oilers,2,Scotia North,Western,6,2,14,0.42857142857142855,6,0,6,0
2020-21,2021-01-27,Edmonton Oilers,0,Scotia North,Western,6,2,16,0.375,6,0,6,0
2020-21,2021-01-29,Edmonton Oilers,0,Scotia North,Western,6,2,18,0.3333333333333333,10,-4,8,-2
2020-21,2021-01-31,Edmonton Oilers,2,Scotia North,Western,8,2,20,0.4,10,-2,8,0
2020-21,2021-02-01,Edmonton Oilers,2,Scotia North,Western,10,2,22,0.45454545454545453,10,0,9,1
2020-21,2021-02-03,Edmonton Oilers,2,Scotia North,Western,12,2,24,0.5,12,0,11,1
2020-21,2021-02-07,Edmonton Oilers,0,Scotia North,Western,12,2,26,0.46153846153846156,12,0,12,0
2020-21,2021-02-09,Edmonton Oilers,2,Scotia North,Western,14,2,28,0.5,14,0,13,1
2020-21,2021-02-10,Edmonton Oilers,2,Scotia North,Western,16,2,30,0.5333333333333333,15,1,13,3
2020-21,2021-02-12,Edmonton Oilers,2,Scotia North,Western,18,2,32,0.5625,17,1,15,3
2020-21,2021-02-16,Edmonton Oilers,0,Scotia North,Western,18,2,34,0.5294117647058824,18,0,15,3
2020-21,2021-02-18,Edmonton Oilers,2,Scotia North,Western,20,2,36,0.5555555555555556,19,1,17,3
2020-21,2021-02-20,Edmonton Oilers,2,Scotia North,Western,22,2,38,0.5789473684210527,20,2,17,5
2020-21,2021-02-21,Edmonton Oilers,2,Scotia North,Western,24,2,40,0.6,20,4,17,7
2020-21,2021-02-24,Edmonton Oilers,2,Scotia North,Western,26,2,42,0.6190476190476191,22,4,19,7
2020-21,2021-02-26,Edmonton Oilers,2,Scotia North,Western,28,2,44,0.6363636363636364,22,6,20,8
2020-21,2021-02-28,Edmonton Oilers,0,Scotia North,Western,28,2,46,0.6086956521739131,23,5,22,6
2020-21,2021-03-02,Edmonton Oilers,0,Scotia North,Western,28,2,48,0.5833333333333334,23,5,22,6
2020-21,2021-03-04,Edmonton Oilers,0,Scotia North,Western,28,2,50,0.56,25,3,23,5
2020-21,2021-03-07,Edmonton Oilers,2,Scotia North,Western,30,2,52,0.5769230769230769,28,2,25,5
2020-21,2021-03-09,Edmonton Oilers,2,Scotia North,Western,32,2,54,0.5925925925925926,29,3,27,5
2020-21,2021-03-11,Edmonton Oilers,2,Scotia North,Western,34,2,56,0.6071428571428571,31,3,28,6
2020-21,2021-03-13,Edmonton Oilers,2,Scotia North,Western,36,2,58,0.6206896551724138,31,5,28,8
2020-21,2021-03-14,Edmonton Oilers,0,Scotia North,Western,36,2,60,0.6,31,5,29,7
2020-21,2021-03-16,Edmonton Oilers,0,Scotia North,Western,36,2,62,0.5806451612903226,33,3,31,5
2020-21,2021-03-18,Edmonton Oilers,2,Scotia North,Western,38,2,64,0.59375,34,4,32,6
2020-21,2021-03-19,Edmonton Oilers,2,Scotia North,Western,40,2,66,0.6060606060606061,35,5,33,7
2020-21,2021-03-21,Edmonton Oilers,2,Scotia North,Western,42,2,68,0.6176470588235294,37,5,33,9
2020-21,2021-03-27,Edmonton Oilers,1,Scotia North,Western,43,2,70,0.6142857142857143,37,6,35,8
2020-21,2021-03-29,Edmonton Oilers,2,Scotia North,Western,45,2,72,0.625,37,8,37,8
2020-21,2021-03-30,Edmonton Oilers,0,Scotia North,Western,45,2,74,0.6081081081081081,39,6,37,8
2020-21,2021-04-03,Edmonton Oilers,2,Scotia North,Western,47,2,76,0.618421052631579,41,6,39,8
2020-21,2021-04-05,Edmonton Oilers,1,Scotia North,Western,48,2,78,0.6153846153846154,43,5,39,9
2020-21,2021-04-07,Edmonton Oilers,2,Scotia North,Western,50,2,80,0.625,43,7,41,9
2020-21,2021-04-08,Edmonton Oilers,2,Scotia North,Western,52,2,82,0.6341463414634146,43,9,41,11
2020-21,2021-04-11,Edmonton Oilers,0,Scotia North,Western,52,2,84,0.6190476190476191,43,9,43,9
2020-21,2021-04-17,Edmonton Oilers,2,Scotia North,Western,54,2,86,0.627906976744186,47,7,45,9
2020-21,2021-04-20,Edmonton Oilers,2,Scotia North,Western,56,2,88,0.6363636363636364,47,9,47,9
2020-21,2021-04-22,Edmonton Oilers,0,Scotia North,Western,56,2,90,0.6222222222222222,49,7,49,7
2020-21,2021-04-27,Edmonton Oilers,2,Scotia North,Western,58,2,92,0.6304347826086957,51,7,49,9
2020-21,2021-04-29,Edmonton Oilers,2,Scotia North,Western,60,2,94,0.6382978723404256,51,9,50,10
2020-21,2021-04-30,Edmonton Oilers,0,Scotia North,Western,60,2,96,0.625,53,7,52,8
2020-21,2021-05-02,Edmonton Oilers,2,Scotia North,Western,62,2,98,0.6326530612244898,55,7,53,9
2020-21,2021-05-04,Edmonton Oilers,2,Scotia North,Western,64,2,100,0.64,57,7,55,9
2020-21,2021-05-05,Edmonton Oilers,2,Scotia North,Western,66,2,102,0.6470588235294118,57,9,55,11
2020-21,2021-05-07,Edmonton Oilers,0,Scotia North,Western,66,2,104,0.6346153846153846,57,9,56,10
2020-21,2021-05-09,Edmonton Oilers,2,Scotia North,Western,68,2,106,0.6415094339622641,57,11,57,11
2020-21,2021-05-10,Edmonton Oilers,2,Scotia North,Western,70,2,108,0.6481481481481481,58,12,57,13
2020-21,2021-05-12,Edmonton Oilers,2,Scotia North,Western,72,2,110,0.6545454545454545,59,13,59,13
2020-21,2021-05-15,Edmonton Oilers,0,Scotia North,Western,72,2,112,0.6428571428571429,59,13,60,12
2020-21,2021-01-18,Florida Panthers,2,Discover Central,Eastern,2,2,2,1.0,2,0,3,-1
2020-21,2021-01-20,Florida Panthers,2,Discover Central,Eastern,4,2,4,1.0,4,0,4,0
2020-21,2021-01-27,Florida Panthers,2,Discover Central,Eastern,6,2,6,1.0,6,0,7,-1
2020-21,2021-01-29,Florida Panthers,1,Discover Central,Eastern,7,2,8,0.875,7,0,8,-1
2020-21,2021-01-31,Florida Panthers,2,Discover Central,Eastern,9,2,10,0.9,8,1,10,-1
2020-21,2021-01-31,Florida Panthers,2,Discover Central,Eastern,11,2,12,0.9166666666666666,8,3,10,1
2020-21,2021-02-05,Florida Panthers,1,Discover Central,Eastern,12,2,14,0.8571428571428571,12,0,12,0
2020-21,2021-02-06,Florida Panthers,2,Discover Central,Eastern,14,2,16,0.875,12,2,13,1
2020-21,2021-02-07,Florida Panthers,0,Discover Central,Eastern,14,2,18,0.7777777777777778,14,0,14,0
2020-21,2021-02-10,Florida Panthers,2,Discover Central,Eastern,16,2,20,0.8,15,1,15,1
2020-21,2021-02-12,Florida Panthers,2,Discover Central,Eastern,18,2,22,0.8181818181818182,16,2,16,2
2020-21,2021-02-14,Florida Panthers,0,Discover Central,Eastern,18,2,24,0.75,18,0,18,0
2020-21,2021-02-16,Florida Panthers,2,Discover Central,Eastern,20,2,26,0.7692307692307693,20,0,18,2
2020-21,2021-02-17,Florida Panthers,2,Discover Central,Eastern,22,2,28,0.7857142857142857,20,2,18,4
2020-21,2021-02-20,Florida Panthers,0,Discover Central,Eastern,22,2,30,0.7333333333333333,21,1,19,3
2020-21,2021-02-20,Florida Panthers,2,Discover Central,Eastern,24,2,32,0.75,21,3,19,5
2020-21,2021-02-23,Florida Panthers,2,Discover Central,Eastern,26,2,34,0.7647058823529411,22,4,21,5
2020-21,2021-02-24,Florida Panthers,0,Discover Central,Eastern,26,2,36,0.7222222222222222,24,2,21,5
2020-21,2021-02-26,Florida Panthers,2,Discover Central,Eastern,28,2,38,0.7368421052631579,25,3,22,6
2020-21,2021-02-28,Florida Panthers,1,Discover Central,Eastern,29,2,40,0.725,26,3,25,4
2020-21,2021-03-02,Florida Panthers,1,Discover Central,Eastern,30,2,42,0.7142857142857143,28,2,25,5
2020-21,2021-03-05,Florida Panthers,2,Discover Central,Eastern,32,2,44,0.7272727272727273,29,3,27,5
2020-21,2021-03-06,Florida Panthers,2,Discover Central,Eastern,34,2,46,0.7391304347826086,31,3,27,7
2020-21,2021-03-07,Florida Panthers,0,Discover Central,Eastern,34,2,48,0.7083333333333334,31,3,28,6
2020-21,2021-03-10,Florida Panthers,2,Discover Central,Eastern,36,2,50,0.72,31,5,30,6
2020-21,2021-03-12,Florida Panthers,2,Discover Central,Eastern,38,2,52,0.7307692307692307,33,5,32,6
2020-21,2021-03-14,Florida Panthers,2,Discover Central,Eastern,40,2,54,0.7407407407407407,33,7,32,8
2020-21,2021-03-15,Florida Panthers,2,Discover Central,Eastern,42,2,56,0.75,33,9,32,10
2020-21,2021-03-18,Florida Panthers,0,Discover Central,Eastern,42,2,58,0.7241379310344828,33,9,36,6
2020-21,2021-03-20,Florida Panthers,2,Discover Central,Eastern,44,2,60,0.7333333333333333,33,11,37,7
2020-21,2021-03-21,Florida Panthers,0,Discover Central,Eastern,44,2,62,0.7096774193548387,33,11,37,7
2020-21,2021-03-24,Florida Panthers,0,Discover Central,Eastern,44,2,64,0.6875,35,9,37,7
2020-21,2021-03-26,Florida Panthers,0,Discover Central,Eastern,44,2,66,0.6666666666666666,37,7,37,7
2020-21,2021-03-28,Florida Panthers,2,Discover Central,Eastern,46,2,68,0.6764705882352942,37,9,39,7
2020-21,2021-03-28,Florida Panthers,2,Discover Central,Eastern,48,2,70,0.6857142857142857,37,11,39,9
2020-21,2021-03-30,Florida Panthers,2,Discover Central,Eastern,50,2,72,0.6944444444444444,39,11,41,9
2020-21,2021-04-01,Florida Panthers,2,Discover Central,Eastern,52,2,74,0.7027027027027027,39,13,41,11
2020-21,2021-04-03,Florida Panthers,2,Discover Central,Eastern,54,2,76,0.7105263157894737,41,13,43,11
2020-21,2021-04-04,Florida Panthers,2,Discover Central,Eastern,56,2,78,0.717948717948718,41,15,43,13
2020-21,2021-04-06,Florida Panthers,0,Discover Central,Eastern,56,2,80,0.7,43,13,46,10
2020-21,2021-04-08,Florida Panthers,0,Discover Central,Eastern,56,2,82,0.6829268292682927,45,11,48,8
2020-21,2021-04-10,Florida Panthers,0,Discover Central,Eastern,56,2,84,0.6666666666666666,45,11,48,8
2020-21,2021-04-14,Florida Panthers,2,Discover Central,Eastern,58,2,86,0.6744186046511628,49,9,50,8
2020-21,2021-04-15,Florida Panthers,1,Discover Central,Eastern,59,2,88,0.6704545454545454,49,10,52,7
2020-21,2021-04-17,Florida Panthers,2,Discover Central,Eastern,61,2,90,0.6777777777777778,49,12,54,7
2020-21,2021-04-19,Florida Panthers,2,Discover Central,Eastern,63,2,92,0.6847826086956522,49,14,56,7
2020-21,2021-04-20,Florida Panthers,2,Discover Central,Eastern,65,2,94,0.6914893617021277,51,14,58,7
2020-21,2021-04-22,Florida Panthers,0,Discover Central,Eastern,65,2,96,0.6770833333333334,52,13,60,5
2020-21,2021-04-24,Florida Panthers,2,Discover Central,Eastern,67,2,98,0.6836734693877551,54,13,60,7
2020-21,2021-04-27,Florida Panthers,0,Discover Central,Eastern,67,2,100,0.67,56,11,62,5
2020-21,2021-04-28,Florida Panthers,2,Discover Central,Eastern,69,2,102,0.6764705882352942,56,13,62,7
2020-21,2021-04-30,Florida Panthers,2,Discover Central,Eastern,71,2,104,0.6826923076923077,56,15,64,7
2020-21,2021-05-02,Florida Panthers,2,Discover Central,Eastern,73,2,106,0.6886792452830188,58,15,66,7
2020-21,2021-05-03,Florida Panthers,2,Discover Central,Eastern,75,2,108,0.6944444444444444,60,15,67,8
2020-21,2021-05-08,Florida Panthers,2,Discover Central,Eastern,77,2,110,0.7,60,17,70,7
2020-21,2021-05-10,Florida Panthers,2,Discover Central,Eastern,79,2,112,0.7053571428571429,62,17,71,8
2020-21,2021-01-15,Los Angeles Kings,1,Honda West,Western,1,2,2,0.5,2,-1,2,-1
2020-21,2021-01-17,Los Angeles Kings,1,Honda West,Western,2,2,4,0.5,2,0,2,0
2020-21,2021-01-20,Los Angeles Kings,0,Honda West,Western,2,2,6,0.3333333333333333,4,-2,3,-1
2020-21,2021-01-22,Los Angeles Kings,2,Honda West,Western,4,2,8,0.5,4,0,4,0
2020-21,2021-01-24,Los Angeles Kings,0,Honda West,Western,4,2,10,0.4,6,-2,5,-1
2020-21,2021-01-25,Los Angeles Kings,2,Honda West,Western,6,2,12,0.5,6,0,6,0
2020-21,2021-01-27,Los Angeles Kings,2,Honda West,Western,8,2,14,0.5714285714285714,8,0,6,2
2020-21,2021-01-29,Los Angeles Kings,0,Honda West,Western,8,2,16,0.5,9,-1,8,0
2020-21,2021-02-03,Los Angeles Kings,0,Honda West,Western,8,2,18,0.4444444444444444,11,-3,11,-3
2020-21,2021-02-06,Los Angeles Kings,0,Honda West,Western,8,2,20,0.4,12,-4,12,-4
2020-21,2021-02-07,Los Angeles Kings,0,Honda West,Western,8,2,22,0.36363636363636365,13,-5,12,-4
2020-21,2021-02-10,Los Angeles Kings,1,Honda West,Western,9,2,24,0.375,13,-4,13,-4
2020-21,2021-02-12,Los Angeles Kings,2,Honda West,Western,11,2,26,0.4230769230769231,15,-4,15,-4
2020-21,2021-02-17,Los Angeles Kings,2,Honda West,Western,13,2,28,0.4642857142857143,16,-3,16,-3
2020-21,2021-02-19,Los Angeles Kings,2,Honda West,Western,15,2,30,0.5,17,-2,17,-2
2020-21,2021-02-21,Los Angeles Kings,2,Honda West,Western,17,2,32,0.53125,17,0,17,0
2020-21,2021-02-23,Los Angeles Kings,2,Honda West,Western,19,2,34,0.5588235294117647,19,0,19,0
2020-21,2021-02-25,Los Angeles Kings,2,Honda West,Western,21,2,36,0.5833333333333334,21,0,20,1
2020-21,2021-02-27,Los Angeles Kings,0,Honda West,Western,21,2,38,0.5526315789473685,21,0,21,0
2020-21,2021-02-28,Los Angeles Kings,1,Honda West,Western,22,2,40,0.55,23,-1,22,0
2020-21,2021-03-04,Los Angeles Kings,0,Honda West,Western,22,2,42,0.5238095238095238,25,-3,23,-1
2020-21,2021-03-06,Los Angeles Kings,1,Honda West,Western,23,2,44,0.5227272727272727,27,-4,24,-1
2020-21,2021-03-07,Los Angeles Kings,2,Honda West,Western,25,2,46,0.5434782608695652,27,-2,25,0
2020-21,2021-03-09,Los Angeles Kings,1,Honda West,Western,26,2,48,0.5416666666666666,28,-2,27,-1
2020-21,2021-03-11,Los Angeles Kings,2,Honda West,Western,28,2,50,0.56,30,-2,28,0
2020-21,2021-03-13,Los Angeles Kings,0,Honda West,Western,28,2,52,0.5384615384615384,32,-4,28,0
2020-21,2021-03-14,Los Angeles Kings,0,Honda West,Western,28,2,54,0.5185185185185185,33,-5,29,-1
2020-21,2021-03-18,Los Angeles Kings,2,Honda West,Western,30,2,56,0.5357142857142857,33,-3,32,-2
2020-21,2021-03-20,Los Angeles Kings,0,Honda West,Western,30,2,58,0.5172413793103449,35,-5,33,-3
2020-21,2021-03-21,Los Angeles Kings,2,Honda West,Western,32,2,60,0.5333333333333333,37,-5,33,-1
2020-21,2021-03-23,Los Angeles Kings,0,Honda West,Western,32,2,62,0.5161290322580645,37,-5,33,-1
2020-21,2021-03-25,Los Angeles Kings,0,Honda West,Western,32,2,64,0.5,37,-5,35,-3
2020-21,2021-03-30,Los Angeles Kings,0,Honda West,Western,32,2,66,0.48484848484848486,38,-6,37,-5
2020-21,2021-04-01,Los Angeles Kings,2,Honda West,Western,34,2,68,0.5,38,-4,38,-4
2020-21,2021-04-03,Los Angeles Kings,0,Honda West,Western,34,2,70,0.4857142857142857,39,-5,39,-5
2020-21,2021-04-04,Los Angeles Kings,0,Honda West,Western,34,2,72,0.4722222222222222,39,-5,39,-5
2020-21,2021-04-06,Los Angeles Kings,0,Honda West,Western,34,2,74,0.4594594594594595,43,-9,39,-5
2020-21,2021-04-08,Los Angeles Kings,2,Honda West,Western,36,2,76,0.47368421052631576,43,-7,41,-5
2020-21,2021-04-10,Los Angeles Kings,0,Honda West,Western,36,2,78,0.46153846153846156,43,-7,43,-7
2020-21,2021-04-11,Los Angeles Kings,2,Honda West,Western,38,2,80,0.475,44,-6,43,-5
2020-21,2021-04-13,Los Angeles Kings,0,Honda West,Western,38,2,82,0.4634146341463415,44,-6,44,-6
2020-21,2021-04-15,Los Angeles Kings,0,Honda West,Western,38,2,84,0.4523809523809524,44,-6,44,-6
2020-21,2021-04-21,Los Angeles Kings,2,Honda West,Western,40,2,86,0.46511627906976744,45,-5,49,-9
2020-21,2021-04-24,Los Angeles Kings,0,Honda West,Western,40,2,88,0.45454545454545453,46,-6,49,-9
2020-21,2021-04-25,Los Angeles Kings,0,Honda West,Western,40,2,90,0.4444444444444444,47,-7,49,-9
2020-21,2021-04-27,Los Angeles Kings,2,Honda West,Western,42,2,92,0.45652173913043476,48,-6,49,-7
2020-21,2021-04-29,Los Angeles Kings,0,Honda West,Western,42,2,94,0.44680851063829785,50,-8,50,-8
2020-21,2021-05-01,Los Angeles Kings,2,Honda West,Western,44,2,96,0.4583333333333333,52,-8,52,-8
2020-21,2021-05-02,Los Angeles Kings,0,Honda West,Western,44,2,98,0.4489795918367347,53,-9,53,-9
2020-21,2021-05-04,Los Angeles Kings,2,Honda West,Western,46,2,100,0.46,55,-9,55,-9
2020-21,2021-05-06,Los Angeles Kings,2,Honda West,Western,48,2,102,0.47058823529411764,56,-8,56,-8
2020-21,2021-05-08,Los Angeles Kings,0,Honda West,Western,48,2,104,0.46153846153846156,57,-9,57,-9
2020-21,2021-05-09,Los Angeles Kings,0,Honda West,Western,48,2,106,0.4528301886792453,57,-9,57,-9
2020-21,2021-05-11,Los Angeles Kings,1,Honda West,Western,49,2,108,0.4537037037037037,59,-10,59,-10
2020-21,2021-05-13,Los Angeles Kings,0,Honda West,Western,49,2,110,0.44545454545454544,61,-12,60,-11
2020-21,2021-05-14,Los Angeles Kings,0,Honda West,Western,49,2,112,0.4375,63,-14,60,-11
2020-21,2021-01-15,Minnesota Wild,2,Honda West,Western,2,2,2,1.0,2,0,2,0
2020-21,2021-01-17,Minnesota Wild,2,Honda West,Western,4,2,4,1.0,2,2,2,2
2020-21,2021-01-19,Minnesota Wild,0,Honda West,Western,4,2,6,0.6666666666666666,3,1,2,2
2020-21,2021-01-21,Minnesota Wild,2,Honda West,Western,6,2,8,0.75,4,2,4,2
2020-21,2021-01-23,Minnesota Wild,2,Honda West,Western,8,2,10,0.8,5,3,4,4
2020-21,2021-01-25,Minnesota Wild,0,Honda West,Western,8,2,12,0.6666666666666666,6,2,6,2
2020-21,2021-01-27,Minnesota Wild,0,Honda West,Western,8,2,14,0.5714285714285714,8,0,6,2
2020-21,2021-01-29,Minnesota Wild,2,Honda West,Western,10,2,16,0.625,9,1,8,2
2020-21,2021-01-31,Minnesota Wild,0,Honda West,Western,10,2,18,0.5555555555555556,10,0,8,2
2020-21,2021-02-01,Minnesota Wild,2,Honda West,Western,12,2,20,0.6,11,1,9,3
2020-21,2021-02-03,Minnesota Wild,0,Honda West,Western,12,2,22,0.5454545454545454,11,1,11,1
2020-21,2021-02-17,Minnesota Wild,0,Honda West,Western,12,2,24,0.5,16,-4,16,-4
2020-21,2021-02-19,Minnesota Wild,2,Honda West,Western,14,2,26,0.5384615384615384,17,-3,17,-3
2020-21,2021-02-21,Minnesota Wild,2,Honda West,Western,16,2,28,0.5714285714285714,17,-1,17,-1
2020-21,2021-02-23,Minnesota Wild,2,Honda West,Western,18,2,30,0.6,19,-1,19,-1
2020-21,2021-02-25,Minnesota Wild,2,Honda West,Western,20,2,32,0.625,21,-1,20,0
2020-21,2021-02-27,Minnesota Wild,2,Honda West,Western,22,2,34,0.6470588235294118,21,1,21,1
2020-21,2021-02-28,Minnesota Wild,2,Honda West,Western,24,2,36,0.6666666666666666,23,1,22,2
2020-21,2021-03-02,Minnesota Wild,1,Honda West,Western,25,2,38,0.6578947368421053,23,2,22,3
2020-21,2021-03-04,Minnesota Wild,0,Honda West,Western,25,2,40,0.625,25,0,23,2
2020-21,2021-03-06,Minnesota Wild,2,Honda West,Western,27,2,42,0.6428571428571429,27,0,24,3
2020-21,2021-03-07,Minnesota Wild,0,Honda West,Western,27,2,44,0.6136363636363636,27,0,25,2
2020-21,2021-03-09,Minnesota Wild,2,Honda West,Western,29,2,46,0.6304347826086957,28,1,27,2
2020-21,2021-03-11,Minnesota Wild,2,Honda West,Western,31,2,48,0.6458333333333334,30,1,28,3
2020-21,2021-03-13,Minnesota Wild,2,Honda West,Western,33,2,50,0.66,32,1,28,5
2020-21,2021-03-14,Minnesota Wild,2,Honda West,Western,35,2,52,0.6730769230769231,33,2,29,6
2020-21,2021-03-17,Minnesota Wild,2,Honda West,Western,37,2,54,0.6851851851851852,33,4,32,5
2020-21,2021-03-19,Minnesota Wild,0,Honda West,Western,37,2,56,0.6607142857142857,33,4,33,4
2020-21,2021-03-20,Minnesota Wild,0,Honda West,Western,37,2,58,0.6379310344827587,35,2,33,4
2020-21,2021-03-22,Minnesota Wild,2,Honda West,Western,39,2,60,0.65,37,2,33,6
2020-21,2021-03-24,Minnesota Wild,2,Honda West,Western,41,2,62,0.6612903225806451,37,4,35,6
2020-21,2021-03-26,Minnesota Wild,2,Honda West,Western,43,2,64,0.671875,37,6,35,8
2020-21,2021-03-30,Minnesota Wild,1,Honda West,Western,44,2,66,0.6666666666666666,38,6,37,7
2020-21,2021-04-01,Minnesota Wild,0,Honda West,Western,44,2,68,0.6470588235294118,38,6,38,6
2020-21,2021-04-02,Minnesota Wild,2,Honda West,Western,46,2,70,0.6571428571428571,38,8,38,8
2020-21,2021-04-04,Minnesota Wild,2,Honda West,Western,48,2,72,0.6666666666666666,39,9,39,9
2020-21,2021-04-06,Minnesota Wild,0,Honda West,Western,48,2,74,0.6486486486486487,43,5,39,9
2020-21,2021-04-08,Minnesota Wild,2,Honda West,Western,50,2,76,0.6578947368421053,43,7,41,9
2020-21,2021-04-10,Minnesota Wild,0,Honda West,Western,50,2,78,0.6410256410256411,43,7,43,7
2020-21,2021-04-11,Minnesota Wild,1,Honda West,Western,51,2,80,0.6375,44,7,43,8
2020-21,2021-04-14,Minnesota Wild,2,Honda West,Western,53,2,82,0.6463414634146342,44,9,44,9
2020-21,2021-04-17,Minnesota Wild,2,Honda West,Western,55,2,84,0.6547619047619048,45,10,45,10
2020-21,2021-04-18,Minnesota Wild,2,Honda West,Western,57,2,86,0.6627906976744186,45,12,46,11
2020-21,2021-04-20,Minnesota Wild,2,Honda West,Western,59,2,88,0.6704545454545454,45,14,47,12
2020-21,2021-04-22,Minnesota Wild,2,Honda West,Western,61,2,90,0.6777777777777778,45,16,49,12
2020-21,2021-04-24,Minnesota Wild,2,Honda West,Western,63,2,92,0.6847826086956522,46,17,49,14
2020-21,2021-04-25,Minnesota Wild,2,Honda West,Western,65,2,94,0.6914893617021277,47,18,49,16
2020-21,2021-04-28,Minnesota Wild,0,Honda West,Western,65,2,96,0.6770833333333334,50,15,50,15
2020-21,2021-04-30,Minnesota Wild,1,Honda West,Western,66,2,98,0.673469387755102,52,14,52,14
2020-21,2021-05-02,Minnesota Wild,2,Honda West,Western,68,2,100,0.68,53,15,53,15
2020-21,2021-05-04,Minnesota Wild,2,Honda West,Western,70,2,102,0.6862745098039216,55,15,55,15
2020-21,2021-05-06,Minnesota Wild,1,Honda West,Western,71,2,104,0.6826923076923077,56,15,56,15
2020-21,2021-05-08,Minnesota Wild,2,Honda West,Western,73,2,106,0.6886792452830188,57,16,57,16
2020-21,2021-05-09,Minnesota Wild,2,Honda West,Western,75,2,108,0.6944444444444444,57,18,57,18
2020-21,2021-05-13,Minnesota Wild,0,Honda West,Western,75,2,110,0.6818181818181818,61,14,60,15
2020-21,2021-05-14,Minnesota Wild,0,Honda West,Western,75,2,112,0.6696428571428571,63,12,60,15
2020-21,2021-01-14,Montréal Canadiens,1,Scotia North,Eastern,1,2,2,0.5,0,1,0,1
2020-21,2021-01-17,Montréal Canadiens,2,Scotia North,Eastern,3,2,4,0.75,2,1,2,1
2020-21,2021-01-19,Montréal Canadiens,2,Scotia North,Eastern,5,2,6,0.8333333333333334,2,3,3,2
2020-21,2021-01-21,Montréal Canadiens,1,Scotia North,Eastern,6,2,8,0.75,4,2,4,2
2020-21,2021-01-22,Montréal Canadiens,2,Scotia North,Eastern,8,2,10,0.8,5,3,5,3
2020-21,2021-01-24,Montréal Canadiens,2,Scotia North,Eastern,10,2,12,0.8333333333333334,5,5,6,4
2020-21,2021-01-29,Montréal Canadiens,2,Scotia North,Eastern,12,2,14,0.8571428571428571,10,2,8,4
2020-21,2021-01-31,Montréal Canadiens,0,Scotia North,Eastern,12,2,16,0.75,10,2,10,2
2020-21,2021-02-02,Montréal Canadiens,2,Scotia North,Eastern,14,2,18,0.7777777777777778,11,3,11,3
2020-21,2021-02-03,Montréal Canadiens,2,Scotia North,Eastern,16,2,20,0.8,12,4,11,5
2020-21,2021-02-05,Montréal Canadiens,0,Scotia North,Eastern,16,2,22,0.7272727272727273,12,4,12,4
2020-21,2021-02-06,Montréal Canadiens,2,Scotia North,Eastern,18,2,24,0.75,12,6,13,5
2020-21,2021-02-11,Montréal Canadiens,0,Scotia North,Eastern,18,2,26,0.6923076923076923,15,3,15,3
2020-21,2021-02-12,Montréal Canadiens,0,Scotia North,Eastern,18,2,28,0.6428571428571429,17,1,16,2
2020-21,2021-02-14,Montréal Canadiens,2,Scotia North,Eastern,20,2,30,0.6666666666666666,17,3,18,2
2020-21,2021-02-21,Montréal Canadiens,0,Scotia North,Eastern,20,2,32,0.625,20,0,20,0
2020-21,2021-02-22,Montréal Canadiens,1,Scotia North,Eastern,21,2,34,0.6176470588235294,21,0,20,1
2020-21,2021-02-24,Montréal Canadiens,1,Scotia North,Eastern,22,2,36,0.6111111111111112,22,0,21,1
2020-21,2021-02-26,Montréal Canadiens,0,Scotia North,Eastern,22,2,38,0.5789473684210527,22,0,22,0
2020-21,2021-02-28,Montréal Canadiens,1,Scotia North,Eastern,23,2,40,0.575,23,0,25,-2
2020-21,2021-03-03,Montréal Canadiens,2,Scotia North,Eastern,25,2,42,0.5952380952380952,25,0,25,0
2020-21,2021-03-05,Montréal Canadiens,1,Scotia North,Eastern,26,2,44,0.5909090909090909,26,0,27,-1
2020-21,2021-03-07,Montréal Canadiens,2,Scotia North,Eastern,28,2,46,0.6086956521739131,28,0,28,0
2020-21,2021-03-09,Montréal Canadiens,1,Scotia North,Eastern,29,2,48,0.6041666666666666,29,0,29,0
2020-21,2021-03-11,Montréal Canadiens,2,Scotia North,Eastern,31,2,50,0.62,31,0,31,0
2020-21,2021-03-12,Montréal Canadiens,0,Scotia North,Eastern,31,2,52,0.5961538461538461,31,0,32,-1
2020-21,2021-03-14,Montréal Canadiens,0,Scotia North,Eastern,31,2,54,0.5740740740740741,31,0,32,-1
2020-21,2021-03-16,Montréal Canadiens,2,Scotia North,Eastern,33,2,56,0.5892857142857143,33,0,34,-1
2020-21,2021-03-18,Montréal Canadiens,1,Scotia North,Eastern,34,2,58,0.5862068965517241,34,0,36,-2
2020-21,2021-03-19,Montréal Canadiens,1,Scotia North,Eastern,35,2,60,0.5833333333333334,35,0,36,-1
2020-21,2021-03-20,Montréal Canadiens,2,Scotia North,Eastern,37,2,62,0.5967741935483871,37,0,37,0
2020-21,2021-03-30,Montréal Canadiens,2,Scotia North,Eastern,39,2,64,0.609375,39,0,41,-2
2020-21,2021-04-01,Montréal Canadiens,2,Scotia North,Eastern,41,2,66,0.6212121212121212,41,0,41,0
2020-21,2021-04-03,Montréal Canadiens,0,Scotia North,Eastern,41,2,68,0.6029411764705882,41,0,43,-2
2020-21,2021-04-05,Montréal Canadiens,2,Scotia North,Eastern,43,2,70,0.6142857142857143,43,0,44,-1
2020-21,2021-04-07,Montréal Canadiens,0,Scotia North,Eastern,43,2,72,0.5972222222222222,43,0,46,-3
2020-21,2021-04-08,Montréal Canadiens,0,Scotia North,Eastern,43,2,74,0.581081081081081,43,0,48,-5
2020-21,2021-04-10,Montréal Canadiens,0,Scotia North,Eastern,43,2,76,0.5657894736842105,43,0,48,-5
2020-21,2021-04-12,Montréal Canadiens,2,Scotia North,Eastern,45,2,78,0.5769230769230769,45,0,48,-3
2020-21,2021-04-14,Montréal Canadiens,0,Scotia North,Eastern,45,2,80,0.5625,45,0,50,-5
2020-21,2021-04-16,Montréal Canadiens,2,Scotia North,Eastern,47,2,82,0.573170731707317,47,0,54,-7
2020-21,2021-04-17,Montréal Canadiens,0,Scotia North,Eastern,47,2,84,0.5595238095238095,47,0,54,-7
2020-21,2021-04-20,Montréal Canadiens,0,Scotia North,Eastern,47,2,86,0.5465116279069767,47,0,58,-11
2020-21,2021-04-22,Montréal Canadiens,2,Scotia North,Eastern,49,2,88,0.5568181818181818,49,0,60,-11
2020-21,2021-04-24,Montréal Canadiens,0,Scotia North,Eastern,49,2,90,0.5444444444444444,49,0,60,-11
2020-21,2021-04-24,Montréal Canadiens,0,Scotia North,Eastern,49,2,92,0.532608695652174,49,0,60,-11
2020-21,2021-04-26,Montréal Canadiens,2,Scotia North,Eastern,51,2,94,0.5425531914893617,51,0,60,-9
2020-21,2021-04-29,Montréal Canadiens,0,Scotia North,Eastern,51,2,96,0.53125,51,0,64,-13
2020-21,2021-04-30,Montréal Canadiens,2,Scotia North,Eastern,53,2,98,0.5408163265306123,53,0,64,-11
2020-21,2021-05-01,Montréal Canadiens,2,Scotia North,Eastern,55,2,100,0.55,55,0,66,-11
2020-21,2021-05-03,Montréal Canadiens,2,Scotia North,Eastern,57,2,102,0.5588235294117647,57,0,67,-10
2020-21,2021-05-05,Montréal Canadiens,0,Scotia North,Eastern,57,2,104,0.5480769230769231,57,0,68,-11
2020-21,2021-05-06,Montréal Canadiens,0,Scotia North,Eastern,57,2,106,0.5377358490566038,57,0,68,-11
2020-21,2021-05-08,Montréal Canadiens,0,Scotia North,Eastern,57,2,108,0.5277777777777778,57,0,70,-13
2020-21,2021-05-10,Montréal Canadiens,1,Scotia North,Eastern,58,2,110,0.5272727272727272,58,0,71,-13
2020-21,2021-05-12,Montréal Canadiens,1,Scotia North,Eastern,59,2,112,0.5267857142857143,59,0,71,-12
2020-21,2021-01-15,Nashville Predators,2,Discover Central,Western,2,2,2,1.0,0,2,2,0
2020-21,2021-01-17,Nashville Predators,2,Discover Central,Western,4,2,4,1.0,2,2,2,2
2020-21,2021-01-19,Nashville Predators,0,Discover Central,Western,4,2,6,0.6666666666666666,2,2,2,2
2020-21,2021-01-23,Nashville Predators,0,Discover Central,Western,4,2,8,0.5,4,0,4,0
2020-21,2021-01-25,Nashville Predators,0,Discover Central,Western,4,2,10,0.4,4,0,6,-2
2020-21,2021-01-27,Nashville Predators,2,Discover Central,Western,6,2,12,0.5,6,0,6,0
2020-21,2021-01-28,Nashville Predators,2,Discover Central,Western,8,2,14,0.5714285714285714,6,2,8,0
2020-21,2021-01-31,Nashville Predators,0,Discover Central,Western,8,2,16,0.5,8,0,8,0
2020-21,2021-02-02,Nashville Predators,0,Discover Central,Western,8,2,18,0.4444444444444444,9,-1,9,-1
2020-21,2021-02-05,Nashville Predators,2,Discover Central,Western,10,2,20,0.5,12,-2,11,-1
2020-21,2021-02-06,Nashville Predators,0,Discover Central,Western,10,2,22,0.45454545454545453,12,-2,12,-2
2020-21,2021-02-09,Nashville Predators,0,Discover Central,Western,10,2,24,0.4166666666666667,14,-4,13,-3
2020-21,2021-02-10,Nashville Predators,0,Discover Central,Western,10,2,26,0.38461538461538464,15,-5,13,-3
2020-21,2021-02-12,Nashville Predators,2,Discover Central,Western,12,2,28,0.42857142857142855,16,-4,15,-3
2020-21,2021-02-14,Nashville Predators,0,Discover Central,Western,12,2,30,0.4,18,-6,15,-3
2020-21,2021-02-19,Nashville Predators,0,Discover Central,Western,12,2,32,0.375,21,-9,17,-5
2020-21,2021-02-21,Nashville Predators,2,Discover Central,Western,14,2,34,0.4117647058823529,21,-7,17,-3
2020-21,2021-02-24,Nashville Predators,2,Discover Central,Western,16,2,36,0.4444444444444444,24,-8,19,-3
2020-21,2021-02-26,Nashville Predators,0,Discover Central,Western,16,2,38,0.42105263157894735,25,-9,20,-4
2020-21,2021-02-27,Nashville Predators,2,Discover Central,Western,18,2,40,0.45,25,-7,21,-3
2020-21,2021-02-28,Nashville Predators,2,Discover Central,Western,20,2,42,0.47619047619047616,26,-6,22,-2
2020-21,2021-03-03,Nashville Predators,0,Discover Central,Western,20,2,44,0.45454545454545453,28,-8,22,-2
2020-21,2021-03-05,Nashville Predators,0,Discover Central,Western,20,2,46,0.43478260869565216,29,-9,24,-4
2020-21,2021-03-06,Nashville Predators,0,Discover Central,Western,20,2,48,0.4166666666666667,31,-11,24,-4
2020-21,2021-03-08,Nashville Predators,2,Discover Central,Western,22,2,50,0.44,31,-9,25,-3
2020-21,2021-03-10,Nashville Predators,1,Discover Central,Western,23,2,52,0.4423076923076923,31,-8,27,-4
2020-21,2021-03-12,Nashville Predators,0,Discover Central,Western,23,2,54,0.42592592592592593,33,-10,28,-5
2020-21,2021-03-14,Nashville Predators,0,Discover Central,Western,23,2,56,0.4107142857142857,33,-10,29,-6
2020-21,2021-03-15,Nashville Predators,2,Discover Central,Western,25,2,58,0.43103448275862066,33,-8,30,-5
2020-21,2021-03-18,Nashville Predators,2,Discover Central,Western,27,2,60,0.45,33,-6,32,-5
2020-21,2021-03-20,Nashville Predators,0,Discover Central,Western,27,2,62,0.43548387096774194,33,-6,33,-6
2020-21,2021-03-22,Nashville Predators,2,Discover Central,Western,29,2,64,0.453125,33,-4,33,-4
2020-21,2021-03-24,Nashville Predators,2,Discover Central,Western,31,2,66,0.4696969696969697,35,-4,35,-4
2020-21,2021-03-26,Nashville Predators,2,Discover Central,Western,33,2,68,0.4852941176470588,37,-4,35,-2
2020-21,2021-03-28,Nashville Predators,2,Discover Central,Western,35,2,70,0.5,37,-2,37,-2
2020-21,2021-03-29,Nashville Predators,2,Discover Central,Western,37,2,72,0.5138888888888888,37,0,37,0
2020-21,2021-03-31,Nashville Predators,2,Discover Central,Western,39,2,74,0.527027027027027,39,0,38,1
2020-21,2021-04-02,Nashville Predators,0,Discover Central,Western,39,2,76,0.5131578947368421,39,0,38,1
2020-21,2021-04-03,Nashville Predators,2,Discover Central,Western,41,2,78,0.5256410256410257,41,0,39,2
2020-21,2021-04-06,Nashville Predators,2,Discover Central,Western,43,2,80,0.5375,43,0,39,4
2020-21,2021-04-08,Nashville Predators,2,Discover Central,Western,45,2,82,0.5487804878048781,45,0,41,4
2020-21,2021-04-11,Nashville Predators,0,Discover Central,Western,45,2,84,0.5357142857142857,45,0,43,2
2020-21,2021-04-12,Nashville Predators,2,Discover Central,Western,47,2,86,0.5465116279069767,47,0,44,3
2020-21,2021-04-14,Nashville Predators,2,Discover Central,Western,49,2,88,0.5568181818181818,49,0,44,5
2020-21,2021-04-15,Nashville Predators,0,Discover Central,Western,49,2,90,0.5444444444444444,49,0,44,5
2020-21,2021-04-17,Nashville Predators,0,Discover Central,Western,49,2,92,0.532608695652174,49,0,45,4
2020-21,2021-04-20,Nashville Predators,2,Discover Central,Western,51,2,94,0.5425531914893617,51,0,47,4
2020-21,2021-04-21,Nashville Predators,1,Discover Central,Western,52,2,96,0.5416666666666666,52,0,49,3
2020-21,2021-04-24,Nashville Predators,2,Discover Central,Western,54,2,98,0.5510204081632653,54,0,49,5
2020-21,2021-04-27,Nashville Predators,2,Discover Central,Western,56,2,100,0.56,56,0,49,7
2020-21,2021-04-28,Nashville Predators,0,Discover Central,Western,56,2,102,0.5490196078431373,56,0,50,6
2020-21,2021-05-02,Nashville Predators,2,Discover Central,Western,58,2,104,0.5576923076923077,58,0,53,5
2020-21,2021-05-03,Nashville Predators,2,Discover Central,Western,60,2,106,0.5660377358490566,60,0,53,7
2020-21,2021-05-05,Nashville Predators,0,Discover Central,Western,60,2,108,0.5555555555555556,60,0,55,5
2020-21,2021-05-09,Nashville Predators,2,Discover Central,Western,62,2,110,0.5636363636363636,62,0,57,5
2020-21,2021-05-11,Nashville Predators,2,Discover Central,Western,64,2,112,0.5714285714285714,64,0,59,5
2020-21,2021-01-15,New Jersey Devils,1,MassMutual East,Eastern,1,2,2,0.5,2,-1,1,0
2020-21,2021-01-16,New Jersey Devils,2,MassMutual East,Eastern,3,2,4,0.75,3,0,2,1
2020-21,2021-01-20,New Jersey Devils,2,MassMutual East,Eastern,5,2,6,0.8333333333333334,4,1,4,1
2020-21,2021-01-22,New Jersey Devils,0,MassMutual East,Eastern,5,2,8,0.625,5,0,5,0
2020-21,2021-01-25,New Jersey Devils,2,MassMutual East,Eastern,7,2,10,0.7,7,0,6,1
2020-21,2021-01-27,New Jersey Devils,0,MassMutual East,Eastern,7,2,12,0.5833333333333334,9,-2,7,0
2020-21,2021-01-29,New Jersey Devils,0,MassMutual East,Eastern,7,2,14,0.5,9,-2,8,-1
2020-21,2021-01-30,New Jersey Devils,1,MassMutual East,Eastern,8,2,16,0.5,10,-2,9,-1
2020-21,2021-01-31,New Jersey Devils,2,MassMutual East,Eastern,10,2,18,0.5555555555555556,11,-1,10,0
2020-21,2021-02-17,New Jersey Devils,2,MassMutual East,Eastern,12,2,20,0.6,17,-5,18,-6
2020-21,2021-02-19,New Jersey Devils,2,MassMutual East,Eastern,14,2,22,0.6363636363636364,19,-5,19,-5
2020-21,2021-02-20,New Jersey Devils,0,MassMutual East,Eastern,14,2,24,0.5833333333333334,19,-5,19,-5
2020-21,2021-02-21,New Jersey Devils,0,MassMutual East,Eastern,14,2,26,0.5384615384615384,19,-5,20,-6
2020-21,2021-02-24,New Jersey Devils,0,MassMutual East,Eastern,14,2,28,0.5,21,-7,21,-7
2020-21,2021-02-26,New Jersey Devils,2,MassMutual East,Eastern,16,2,30,0.5333333333333333,21,-5,22,-6
2020-21,2021-02-27,New Jersey Devils,0,MassMutual East,Eastern,16,2,32,0.5,23,-7,23,-7
2020-21,2021-02-28,New Jersey Devils,0,MassMutual East,Eastern,16,2,34,0.47058823529411764,25,-9,25,-9
2020-21,2021-03-03,New Jersey Devils,0,MassMutual East,Eastern,16,2,36,0.4444444444444444,25,-9,25,-9
2020-21,2021-03-05,New Jersey Devils,0,MassMutual East,Eastern,16,2,38,0.42105263157894735,27,-11,27,-11
2020-21,2021-03-06,New Jersey Devils,0,MassMutual East,Eastern,16,2,40,0.4,27,-11,27,-11
2020-21,2021-03-07,New Jersey Devils,2,MassMutual East,Eastern,18,2,42,0.42857142857142855,27,-9,28,-10
2020-21,2021-03-10,New Jersey Devils,1,MassMutual East,Eastern,19,2,44,0.4318181818181818,30,-11,30,-11
2020-21,2021-03-12,New Jersey Devils,0,MassMutual East,Eastern,19,2,46,0.41304347826086957,32,-13,32,-13
2020-21,2021-03-14,New Jersey Devils,0,MassMutual East,Eastern,19,2,48,0.3958333333333333,32,-13,32,-13
2020-21,2021-03-14,New Jersey Devils,1,MassMutual East,Eastern,20,2,50,0.4,32,-12,32,-12
2020-21,2021-03-16,New Jersey Devils,2,MassMutual East,Eastern,22,2,52,0.4230769230769231,34,-12,34,-12
2020-21,2021-03-18,New Jersey Devils,2,MassMutual East,Eastern,24,2,54,0.4444444444444444,36,-12,36,-12
2020-21,2021-03-20,New Jersey Devils,0,MassMutual East,Eastern,24,2,56,0.42857142857142855,36,-12,37,-13
2020-21,2021-03-21,New Jersey Devils,2,MassMutual East,Eastern,26,2,58,0.4482758620689655,36,-10,37,-11
2020-21,2021-03-23,New Jersey Devils,2,MassMutual East,Eastern,28,2,60,0.4666666666666667,36,-8,37,-9
2020-21,2021-03-25,New Jersey Devils,0,MassMutual East,Eastern,28,2,62,0.45161290322580644,37,-9,37,-9
2020-21,2021-03-26,New Jersey Devils,0,MassMutual East,Eastern,28,2,64,0.4375,37,-9,37,-9
2020-21,2021-03-28,New Jersey Devils,2,MassMutual East,Eastern,30,2,66,0.45454545454545453,39,-9,39,-9
2020-21,2021-03-30,New Jersey Devils,1,MassMutual East,Eastern,31,2,68,0.45588235294117646,41,-10,41,-10
2020-21,2021-04-02,New Jersey Devils,1,MassMutual East,Eastern,32,2,70,0.45714285714285713,41,-9,41,-9
2020-21,2021-04-04,New Jersey Devils,0,MassMutual East,Eastern,32,2,72,0.4444444444444444,43,-11,43,-11
2020-21,2021-04-06,New Jersey Devils,0,MassMutual East,Eastern,32,2,74,0.43243243243243246,46,-14,46,-14
2020-21,2021-04-08,New Jersey Devils,2,MassMutual East,Eastern,34,2,76,0.4473684210526316,48,-14,48,-14
2020-21,2021-04-09,New Jersey Devils,0,MassMutual East,Eastern,34,2,78,0.4358974358974359,48,-14,48,-14
2020-21,2021-04-11,New Jersey Devils,0,MassMutual East,Eastern,34,2,80,0.425,48,-14,48,-14
2020-21,2021-04-13,New Jersey Devils,0,MassMutual East,Eastern,34,2,82,0.4146341463414634,50,-16,50,-16
2020-21,2021-04-15,New Jersey Devils,0,MassMutual East,Eastern,34,2,84,0.40476190476190477,52,-18,52,-18
2020-21,2021-04-17,New Jersey Devils,0,MassMutual East,Eastern,34,2,86,0.3953488372093023,54,-20,54,-20
2020-21,2021-04-18,New Jersey Devils,0,MassMutual East,Eastern,34,2,88,0.38636363636363635,56,-22,56,-22
2020-21,2021-04-20,New Jersey Devils,0,MassMutual East,Eastern,34,2,90,0.37777777777777777,58,-24,58,-24
2020-21,2021-04-22,New Jersey Devils,0,MassMutual East,Eastern,34,2,92,0.3695652173913043,60,-26,60,-26
2020-21,2021-04-24,New Jersey Devils,0,MassMutual East,Eastern,34,2,94,0.3617021276595745,60,-26,60,-26
2020-21,2021-04-25,New Jersey Devils,1,MassMutual East,Eastern,35,2,96,0.3645833333333333,60,-25,60,-25
2020-21,2021-04-27,New Jersey Devils,2,MassMutual East,Eastern,37,2,98,0.37755102040816324,62,-25,62,-25
2020-21,2021-04-29,New Jersey Devils,2,MassMutual East,Eastern,39,2,100,0.39,64,-25,64,-25
2020-21,2021-05-01,New Jersey Devils,2,MassMutual East,Eastern,41,2,102,0.4019607843137255,66,-25,66,-25
2020-21,2021-05-03,New Jersey Devils,0,MassMutual East,Eastern,41,2,104,0.3942307692307692,67,-26,67,-26
2020-21,2021-05-04,New Jersey Devils,2,MassMutual East,Eastern,43,2,106,0.4056603773584906,68,-25,68,-25
2020-21,2021-05-06,New Jersey Devils,2,MassMutual East,Eastern,45,2,108,0.4166666666666667,68,-23,68,-23
2020-21,2021-05-08,New Jersey Devils,0,MassMutual East,Eastern,45,2,110,0.4090909090909091,70,-25,70,-25
2020-21,2021-05-10,New Jersey Devils,0,MassMutual East,Eastern,45,2,112,0.4017857142857143,71,-26,71,-26
2020-21,2021-01-15,New York Islanders,2,MassMutual East,Eastern,2,2,2,1.0,2,0,1,1
2020-21,2021-01-17,New York Islanders,0,MassMutual East,Eastern,2,2,4,0.5,3,-1,2,0
2020-21,2021-01-18,New York Islanders,2,MassMutual East,Eastern,4,2,6,0.6666666666666666,3,1,3,1
2020-21,2021-01-22,New York Islanders,2,MassMutual East,Eastern,6,2,8,0.75,5,1,5,1
2020-21,2021-01-25,New York Islanders,0,MassMutual East,Eastern,6,2,10,0.6,7,-1,6,0
2020-21,2021-01-27,New York Islanders,0,MassMutual East,Eastern,6,2,12,0.5,9,-3,7,-1
2020-21,2021-01-29,New York Islanders,0,MassMutual East,Eastern,6,2,14,0.42857142857142855,9,-3,8,-2
2020-21,2021-01-31,New York Islanders,1,MassMutual East,Eastern,7,2,16,0.4375,11,-4,10,-3
2020-21,2021-02-01,New York Islanders,1,MassMutual East,Eastern,8,2,18,0.4444444444444444,11,-3,10,-2
2020-21,2021-02-07,New York Islanders,2,MassMutual East,Eastern,10,2,20,0.5,11,-1,14,-4
2020-21,2021-02-09,New York Islanders,2,MassMutual East,Eastern,12,2,22,0.5454545454545454,12,0,14,-2
2020-21,2021-02-12,New York Islanders,1,MassMutual East,Eastern,13,2,24,0.5416666666666666,13,0,16,-3
2020-21,2021-02-14,New York Islanders,2,MassMutual East,Eastern,15,2,26,0.5769230769230769,15,0,18,-3
2020-21,2021-02-16,New York Islanders,2,MassMutual East,Eastern,17,2,28,0.6071428571428571,15,2,18,-1
2020-21,2021-02-17,New York Islanders,2,MassMutual East,Eastern,19,2,30,0.6333333333333333,17,2,18,1
2020-21,2021-02-19,New York Islanders,0,MassMutual East,Eastern,19,2,32,0.59375,19,0,19,0
2020-21,2021-02-21,New York Islanders,0,MassMutual East,Eastern,19,2,34,0.5588235294117647,19,0,20,-1
2020-21,2021-02-23,New York Islanders,2,MassMutual East,Eastern,21,2,36,0.5833333333333334,19,2,21,0
2020-21,2021-02-26,New York Islanders,2,MassMutual East,Eastern,23,2,38,0.6052631578947368,21,2,22,1
2020-21,2021-02-28,New York Islanders,2,MassMutual East,Eastern,25,2,40,0.625,25,0,25,0
2020-21,2021-02-28,New York Islanders,1,MassMutual East,Eastern,26,2,42,0.6190476190476191,25,1,25,1
2020-21,2021-03-03,New York Islanders,2,MassMutual East,Eastern,28,2,44,0.6363636363636364,25,3,25,3
2020-21,2021-03-05,New York Islanders,2,MassMutual East,Eastern,30,2,46,0.6521739130434783,27,3,27,3
2020-21,2021-03-06,New York Islanders,2,MassMutual East,Eastern,32,2,48,0.6666666666666666,27,5,27,5
2020-21,2021-03-07,New York Islanders,2,MassMutual East,Eastern,34,2,50,0.68,27,7,28,6
2020-21,2021-03-10,New York Islanders,2,MassMutual East,Eastern,36,2,52,0.6923076923076923,30,6,30,6
2020-21,2021-03-12,New York Islanders,2,MassMutual East,Eastern,38,2,54,0.7037037037037037,32,6,32,6
2020-21,2021-03-14,New York Islanders,2,MassMutual East,Eastern,40,2,56,0.7142857142857143,32,8,32,8
2020-21,2021-03-14,New York Islanders,2,MassMutual East,Eastern,42,2,58,0.7241379310344828,32,10,32,10
2020-21,2021-03-16,New York Islanders,0,MassMutual East,Eastern,42,2,60,0.7,34,8,34,8
2020-21,2021-03-18,New York Islanders,0,MassMutual East,Eastern,42,2,62,0.6774193548387096,36,6,36,6
2020-21,2021-03-20,New York Islanders,2,MassMutual East,Eastern,44,2,64,0.6875,36,8,37,7
2020-21,2021-03-22,New York Islanders,2,MassMutual East,Eastern,46,2,66,0.696969696969697,36,10,37,9
2020-21,2021-03-25,New York Islanders,2,MassMutual East,Eastern,48,2,68,0.7058823529411765,37,11,37,11
2020-21,2021-03-27,New York Islanders,0,MassMutual East,Eastern,48,2,70,0.6857142857142857,39,9,39,9
2020-21,2021-03-29,New York Islanders,0,MassMutual East,Eastern,48,2,72,0.6666666666666666,39,9,39,9
2020-21,2021-04-01,New York Islanders,2,MassMutual East,Eastern,50,2,74,0.6756756756756757,41,9,41,9
2020-21,2021-04-03,New York Islanders,2,MassMutual East,Eastern,52,2,76,0.6842105263157895,43,9,43,9
2020-21,2021-04-06,New York Islanders,2,MassMutual East,Eastern,54,2,78,0.6923076923076923,46,8,46,8
2020-21,2021-04-08,New York Islanders,2,MassMutual East,Eastern,56,2,80,0.7,48,8,48,8
2020-21,2021-04-09,New York Islanders,0,MassMutual East,Eastern,56,2,82,0.6829268292682927,48,8,48,8
2020-21,2021-04-11,New York Islanders,2,MassMutual East,Eastern,58,2,84,0.6904761904761905,48,10,48,10
2020-21,2021-04-15,New York Islanders,0,MassMutual East,Eastern,58,2,86,0.6744186046511628,52,6,52,6
2020-21,2021-04-16,New York Islanders,0,MassMutual East,Eastern,58,2,88,0.6590909090909091,54,4,54,4
2020-21,2021-04-18,New York Islanders,2,MassMutual East,Eastern,60,2,90,0.6666666666666666,56,4,56,4
2020-21,2021-04-20,New York Islanders,2,MassMutual East,Eastern,62,2,92,0.6739130434782609,58,4,58,4
2020-21,2021-04-22,New York Islanders,1,MassMutual East,Eastern,63,2,94,0.6702127659574468,60,3,60,3
2020-21,2021-04-24,New York Islanders,0,MassMutual East,Eastern,63,2,96,0.65625,60,3,60,3
2020-21,2021-04-27,New York Islanders,0,MassMutual East,Eastern,63,2,98,0.6428571428571429,62,1,62,1
2020-21,2021-04-29,New York Islanders,2,MassMutual East,Eastern,65,2,100,0.65,64,1,64,1
2020-21,2021-05-01,New York Islanders,2,MassMutual East,Eastern,67,2,102,0.6568627450980392,66,1,66,1
2020-21,2021-05-03,New York Islanders,0,MassMutual East,Eastern,67,2,104,0.6442307692307693,67,0,67,0
2020-21,2021-05-04,New York Islanders,1,MassMutual East,Eastern,68,2,106,0.6415094339622641,68,0,68,0
2020-21,2021-05-06,New York Islanders,0,MassMutual East,Eastern,68,2,108,0.6296296296296297,68,0,68,0
2020-21,2021-05-08,New York Islanders,2,MassMutual East,Eastern,70,2,110,0.6363636363636364,70,0,70,0
2020-21,2021-05-10,New York Islanders,1,MassMutual East,Eastern,71,2,112,0.6339285714285714,71,0,71,0
2020-21,2021-01-15,New York Rangers,0,MassMutual East,Eastern,0,2,2,0.0,2,-2,1,-1
2020-21,2021-01-17,New York Rangers,2,MassMutual East,Eastern,2,2,4,0.5,3,-1,2,0
2020-21,2021-01-20,New York Rangers,0,MassMutual East,Eastern,2,2,6,0.3333333333333333,4,-2,4,-2
2020-21,2021-01-23,New York Rangers,1,MassMutual East,Eastern,3,2,8,0.375,6,-3,6,-3
2020-21,2021-01-25,New York Rangers,0,MassMutual East,Eastern,3,2,10,0.3,7,-4,6,-3
2020-21,2021-01-27,New York Rangers,0,MassMutual East,Eastern,3,2,12,0.25,9,-6,7,-4
2020-21,2021-01-29,New York Rangers,2,MassMutual East,Eastern,5,2,14,0.35714285714285715,9,-4,8,-3
2020-21,2021-01-31,New York Rangers,1,MassMutual East,Eastern,6,2,16,0.375,11,-5,10,-4
2020-21,2021-02-02,New York Rangers,2,MassMutual East,Eastern,8,2,18,0.4444444444444444,11,-3,11,-3
2020-21,2021-02-05,New York Rangers,2,MassMutual East,Eastern,10,2,20,0.5,11,-1,12,-2
2020-21,2021-02-09,New York Rangers,0,MassMutual East,Eastern,10,2,22,0.45454545454545453,12,-2,14,-4
2020-21,2021-02-11,New York Rangers,1,MassMutual East,Eastern,11,2,24,0.4583333333333333,12,-1,15,-4
2020-21,2021-02-13,New York Rangers,0,MassMutual East,Eastern,11,2,26,0.4230769230769231,13,-2,16,-5
2020-21,2021-02-17,New York Rangers,0,MassMutual East,Eastern,11,2,28,0.39285714285714285,17,-6,18,-7
2020-21,2021-02-19,New York Rangers,2,MassMutual East,Eastern,13,2,30,0.43333333333333335,19,-6,19,-6
2020-21,2021-02-20,New York Rangers,2,MassMutual East,Eastern,15,2,32,0.46875,19,-4,19,-4
2020-21,2021-02-25,New York Rangers,0,MassMutual East,Eastern,15,2,34,0.4411764705882353,21,-6,21,-6
2020-21,2021-02-27,New York Rangers,2,MassMutual East,Eastern,17,2,36,0.4722222222222222,23,-6,23,-6
2020-21,2021-02-28,New York Rangers,0,MassMutual East,Eastern,17,2,38,0.4473684210526316,25,-8,25,-8
2020-21,2021-03-03,New York Rangers,2,MassMutual East,Eastern,19,2,40,0.475,25,-6,25,-6
2020-21,2021-03-05,New York Rangers,2,MassMutual East,Eastern,21,2,42,0.5,27,-6,27,-6
2020-21,2021-03-06,New York Rangers,2,MassMutual East,Eastern,23,2,44,0.5227272727272727,27,-4,27,-4
2020-21,2021-03-08,New York Rangers,0,MassMutual East,Eastern,23,2,46,0.5,29,-6,29,-6
2020-21,2021-03-09,New York Rangers,0,MassMutual East,Eastern,23,2,48,0.4791666666666667,29,-6,29,-6
2020-21,2021-03-12,New York Rangers,0,MassMutual East,Eastern,23,2,50,0.46,32,-9,32,-9
2020-21,2021-03-13,New York Rangers,2,MassMutual East,Eastern,25,2,52,0.4807692307692308,32,-7,32,-7
2020-21,2021-03-15,New York Rangers,1,MassMutual East,Eastern,26,2,54,0.48148148148148145,32,-6,32,-6
2020-21,2021-03-17,New York Rangers,2,MassMutual East,Eastern,28,2,56,0.5,34,-6,34,-6
2020-21,2021-03-19,New York Rangers,0,MassMutual East,Eastern,28,2,58,0.4827586206896552,36,-8,36,-8
2020-21,2021-03-20,New York Rangers,2,MassMutual East,Eastern,30,2,60,0.5,36,-6,37,-7
2020-21,2021-03-22,New York Rangers,2,MassMutual East,Eastern,32,2,62,0.5161290322580645,36,-4,37,-5
2020-21,2021-03-25,New York Rangers,2,MassMutual East,Eastern,34,2,64,0.53125,37,-3,37,-3
2020-21,2021-03-27,New York Rangers,0,MassMutual East,Eastern,34,2,66,0.5151515151515151,39,-5,39,-5
2020-21,2021-03-28,New York Rangers,0,MassMutual East,Eastern,34,2,68,0.5,39,-5,39,-5
2020-21,2021-03-30,New York Rangers,2,MassMutual East,Eastern,36,2,70,0.5142857142857142,41,-5,41,-5
2020-21,2021-04-01,New York Rangers,2,MassMutual East,Eastern,38,2,72,0.5277777777777778,41,-3,41,-3
2020-21,2021-04-03,New York Rangers,1,MassMutual East,Eastern,39,2,74,0.527027027027027,43,-4,43,-4
2020-21,2021-04-06,New York Rangers,2,MassMutual East,Eastern,41,2,76,0.5394736842105263,46,-5,46,-5
2020-21,2021-04-08,New York Rangers,0,MassMutual East,Eastern,41,2,78,0.5256410256410257,48,-7,48,-7
2020-21,2021-04-09,New York Rangers,2,MassMutual East,Eastern,43,2,80,0.5375,48,-5,48,-5
2020-21,2021-04-11,New York Rangers,1,MassMutual East,Eastern,44,2,82,0.5365853658536586,48,-4,48,-4
2020-21,2021-04-13,New York Rangers,2,MassMutual East,Eastern,46,2,84,0.5476190476190477,50,-4,50,-4
2020-21,2021-04-15,New York Rangers,2,MassMutual East,Eastern,48,2,86,0.5581395348837209,52,-4,52,-4
2020-21,2021-04-17,New York Rangers,2,MassMutual East,Eastern,50,2,88,0.5681818181818182,54,-4,54,-4
2020-21,2021-04-18,New York Rangers,2,MassMutual East,Eastern,52,2,90,0.5777777777777777,56,-4,56,-4
2020-21,2021-04-20,New York Rangers,0,MassMutual East,Eastern,52,2,92,0.5652173913043478,58,-6,58,-6
2020-21,2021-04-22,New York Rangers,0,MassMutual East,Eastern,52,2,94,0.5531914893617021,60,-8,60,-8
2020-21,2021-04-23,New York Rangers,2,MassMutual East,Eastern,54,2,96,0.5625,60,-6,60,-6
2020-21,2021-04-25,New York Rangers,2,MassMutual East,Eastern,56,2,98,0.5714285714285714,60,-4,60,-4
2020-21,2021-04-27,New York Rangers,2,MassMutual East,Eastern,58,2,100,0.58,62,-4,62,-4
2020-21,2021-04-29,New York Rangers,0,MassMutual East,Eastern,58,2,102,0.5686274509803921,64,-6,64,-6
2020-21,2021-05-01,New York Rangers,0,MassMutual East,Eastern,58,2,104,0.5576923076923077,66,-8,66,-8
2020-21,2021-05-03,New York Rangers,0,MassMutual East,Eastern,58,2,106,0.5471698113207547,67,-9,67,-9
2020-21,2021-05-05,New York Rangers,0,MassMutual East,Eastern,58,2,108,0.5370370370370371,68,-10,68,-10
2020-21,2021-05-06,New York Rangers,0,MassMutual East,Eastern,58,2,110,0.5272727272727272,68,-10,68,-10
2020-21,2021-05-08,New York Rangers,2,MassMutual East,Eastern,60,2,112,0.5357142857142857,70,-10,70,-10
2020-21,2021-01-16,Ottawa Senators,2,Scotia North,Eastern,2,2,2,1.0,2,0,2,0
2020-21,2021-01-17,Ottawa Senators,0,Scotia North,Eastern,2,2,4,0.5,2,0,2,0
2020-21,2021-01-20,Ottawa Senators,1,Scotia North,Eastern,3,2,6,0.5,4,-1,4,-1
2020-21,2021-01-22,Ottawa Senators,0,Scotia North,Eastern,3,2,8,0.375,5,-2,5,-2
2020-21,2021-01-24,Ottawa Senators,0,Scotia North,Eastern,3,2,10,0.3,5,-2,6,-3
2020-21,2021-01-26,Ottawa Senators,0,Scotia North,Eastern,3,2,12,0.25,6,-3,6,-3
2020-21,2021-01-28,Ottawa Senators,0,Scotia North,Eastern,3,2,14,0.21428571428571427,8,-5,7,-4
2020-21,2021-01-29,Ottawa Senators,0,Scotia North,Eastern,3,2,16,0.1875,10,-7,8,-5
2020-21,2021-02-01,Ottawa Senators,0,Scotia North,Eastern,3,2,18,0.16666666666666666,10,-7,10,-7
2020-21,2021-02-03,Ottawa Senators,0,Scotia North,Eastern,3,2,20,0.15,12,-9,11,-8
2020-21,2021-02-05,Ottawa Senators,2,Scotia North,Eastern,5,2,22,0.22727272727272727,12,-7,12,-7
2020-21,2021-02-06,Ottawa Senators,0,Scotia North,Eastern,5,2,24,0.20833333333333334,12,-7,13,-8
2020-21,2021-02-09,Ottawa Senators,0,Scotia North,Eastern,5,2,26,0.19230769230769232,14,-9,14,-9
2020-21,2021-02-10,Ottawa Senators,0,Scotia North,Eastern,5,2,28,0.17857142857142858,15,-10,15,-10
2020-21,2021-02-12,Ottawa Senators,0,Scotia North,Eastern,5,2,30,0.16666666666666666,17,-12,16,-11
2020-21,2021-02-13,Ottawa Senators,2,Scotia North,Eastern,7,2,32,0.21875,17,-10,16,-9
2020-21,2021-02-16,Ottawa Senators,2,Scotia North,Eastern,9,2,34,0.2647058823529412,18,-9,18,-9
2020-21,2021-02-18,Ottawa Senators,0,Scotia North,Eastern,9,2,36,0.25,19,-10,18,-9
2020-21,2021-02-19,Ottawa Senators,0,Scotia North,Eastern,9,2,38,0.23684210526315788,19,-10,19,-10
2020-21,2021-02-22,Ottawa Senators,2,Scotia North,Eastern,11,2,40,0.275,21,-10,20,-9
2020-21,2021-02-24,Ottawa Senators,2,Scotia North,Eastern,13,2,42,0.30952380952380953,22,-9,21,-8
2020-21,2021-02-26,Ottawa Senators,2,Scotia North,Eastern,15,2,44,0.3409090909090909,22,-7,22,-7
2020-21,2021-02-27,Ottawa Senators,0,Scotia North,Eastern,15,2,46,0.32608695652173914,22,-7,23,-8
2020-21,2021-03-02,Ottawa Senators,2,Scotia North,Eastern,17,2,48,0.3541666666666667,23,-6,25,-8
2020-21,2021-03-03,Ottawa Senators,0,Scotia North,Eastern,17,2,50,0.34,25,-8,25,-8
2020-21,2021-03-05,Ottawa Senators,0,Scotia North,Eastern,17,2,52,0.3269230769230769,26,-9,27,-10
2020-21,2021-03-08,Ottawa Senators,2,Scotia North,Eastern,19,2,54,0.35185185185185186,28,-9,29,-10
2020-21,2021-03-09,Ottawa Senators,0,Scotia North,Eastern,19,2,56,0.3392857142857143,29,-10,29,-10
2020-21,2021-03-11,Ottawa Senators,0,Scotia North,Eastern,19,2,58,0.3275862068965517,31,-12,31,-12
2020-21,2021-03-13,Ottawa Senators,0,Scotia North,Eastern,19,2,60,0.31666666666666665,31,-12,32,-13
2020-21,2021-03-14,Ottawa Senators,2,Scotia North,Eastern,21,2,62,0.3387096774193548,31,-10,32,-11
2020-21,2021-03-15,Ottawa Senators,1,Scotia North,Eastern,22,2,64,0.34375,31,-9,32,-10
2020-21,2021-03-17,Ottawa Senators,1,Scotia North,Eastern,23,2,66,0.3484848484848485,33,-10,34,-11
2020-21,2021-03-22,Ottawa Senators,2,Scotia North,Eastern,25,2,68,0.36764705882352944,37,-12,37,-12
2020-21,2021-03-24,Ottawa Senators,2,Scotia North,Eastern,27,2,70,0.38571428571428573,37,-10,37,-10
2020-21,2021-03-25,Ottawa Senators,1,Scotia North,Eastern,28,2,72,0.3888888888888889,37,-9,37,-9
2020-21,2021-04-01,Ottawa Senators,0,Scotia North,Eastern,28,2,74,0.3783783783783784,41,-13,41,-13
2020-21,2021-04-03,Ottawa Senators,2,Scotia North,Eastern,30,2,76,0.39473684210526316,41,-11,43,-13
2020-21,2021-04-05,Ottawa Senators,0,Scotia North,Eastern,30,2,78,0.38461538461538464,43,-13,44,-14
2020-21,2021-04-07,Ottawa Senators,0,Scotia North,Eastern,30,2,80,0.375,43,-13,46,-16
2020-21,2021-04-08,Ottawa Senators,0,Scotia North,Eastern,30,2,82,0.36585365853658536,43,-13,48,-18
2020-21,2021-04-10,Ottawa Senators,0,Scotia North,Eastern,30,2,84,0.35714285714285715,43,-13,48,-18
2020-21,2021-04-12,Ottawa Senators,2,Scotia North,Eastern,32,2,86,0.37209302325581395,45,-13,48,-16
2020-21,2021-04-14,Ottawa Senators,0,Scotia North,Eastern,32,2,88,0.36363636363636365,45,-13,50,-18
2020-21,2021-04-17,Ottawa Senators,2,Scotia North,Eastern,34,2,90,0.37777777777777777,47,-13,54,-20
2020-21,2021-04-20,Ottawa Senators,2,Scotia North,Eastern,36,2,92,0.391304347826087,47,-11,58,-22
2020-21,2021-04-23,Ottawa Senators,2,Scotia North,Eastern,38,2,94,0.40425531914893614,49,-11,60,-22
2020-21,2021-04-25,Ottawa Senators,0,Scotia North,Eastern,38,2,96,0.3958333333333333,49,-11,60,-22
2020-21,2021-04-26,Ottawa Senators,2,Scotia North,Eastern,40,2,98,0.40816326530612246,51,-11,60,-20
2020-21,2021-04-28,Ottawa Senators,2,Scotia North,Eastern,42,2,100,0.42,51,-9,62,-20
2020-21,2021-05-01,Ottawa Senators,1,Scotia North,Eastern,43,2,102,0.4215686274509804,55,-12,66,-23
2020-21,2021-05-03,Ottawa Senators,2,Scotia North,Eastern,45,2,104,0.4326923076923077,57,-12,67,-22
2020-21,2021-05-05,Ottawa Senators,2,Scotia North,Eastern,47,2,106,0.44339622641509435,57,-10,68,-21
2020-21,2021-05-08,Ottawa Senators,2,Scotia North,Eastern,49,2,108,0.4537037037037037,57,-8,70,-21
2020-21,2021-05-10,Ottawa Senators,0,Scotia North,Eastern,49,2,110,0.44545454545454544,58,-9,71,-22
2020-21,2021-05-13,Ottawa Senators,2,Scotia North,Eastern,51,2,112,0.45535714285714285,59,-8,71,-20
2020-21,2021-01-13,Philadelphia Flyers,2,MassMutual East,Eastern,2,2,2,1.0,0,2,0,2
2020-21,2021-01-16,Philadelphia Flyers,2,MassMutual East,Eastern,4,2,4,1.0,3,1,2,2
2020-21,2021-01-19,Philadelphia Flyers,0,MassMutual East,Eastern,4,2,6,0.6666666666666666,3,1,3,1
2020-21,2021-01-20,Philadelphia Flyers,2,MassMutual East,Eastern,6,2,8,0.75,4,2,4,2
2020-21,2021-01-22,Philadelphia Flyers,1,MassMutual East,Eastern,7,2,10,0.7,5,2,5,2
2020-21,2021-01-24,Philadelphia Flyers,0,MassMutual East,Eastern,7,2,12,0.5833333333333334,6,1,6,1
2020-21,2021-01-27,Philadelphia Flyers,2,MassMutual East,Eastern,9,2,14,0.6428571428571429,9,0,7,2
2020-21,2021-01-29,Philadelphia Flyers,2,MassMutual East,Eastern,11,2,16,0.6875,9,2,8,3
2020-21,2021-01-31,Philadelphia Flyers,2,MassMutual East,Eastern,13,2,18,0.7222222222222222,11,2,10,3
2020-21,2021-02-01,Philadelphia Flyers,2,MassMutual East,Eastern,15,2,20,0.75,11,4,10,5
2020-21,2021-02-04,Philadelphia Flyers,1,MassMutual East,Eastern,16,2,22,0.7272727272727273,11,5,11,5
2020-21,2021-02-06,Philadelphia Flyers,0,MassMutual East,Eastern,16,2,24,0.6666666666666666,11,5,13,3
2020-21,2021-02-07,Philadelphia Flyers,2,MassMutual East,Eastern,18,2,26,0.6923076923076923,11,7,14,4
2020-21,2021-02-19,Philadelphia Flyers,1,MassMutual East,Eastern,19,2,28,0.6785714285714286,19,0,19,0
2020-21,2021-02-22,Philadelphia Flyers,0,MassMutual East,Eastern,19,2,30,0.6333333333333333,19,0,20,-1
2020-21,2021-02-25,Philadelphia Flyers,2,MassMutual East,Eastern,21,2,32,0.65625,21,0,21,0
2020-21,2021-02-27,Philadelphia Flyers,2,MassMutual East,Eastern,23,2,34,0.6764705882352942,23,0,23,0
2020-21,2021-02-28,Philadelphia Flyers,2,MassMutual East,Eastern,25,2,36,0.6944444444444444,25,0,25,0
2020-21,2021-03-03,Philadelphia Flyers,0,MassMutual East,Eastern,25,2,38,0.6578947368421053,25,0,25,0
2020-21,2021-03-05,Philadelphia Flyers,2,MassMutual East,Eastern,27,2,40,0.675,27,0,27,0
2020-21,2021-03-06,Philadelphia Flyers,0,MassMutual East,Eastern,27,2,42,0.6428571428571429,27,0,27,0
2020-21,2021-03-08,Philadelphia Flyers,0,MassMutual East,Eastern,27,2,44,0.6136363636363636,29,-2,29,-2
2020-21,2021-03-10,Philadelphia Flyers,2,MassMutual East,Eastern,29,2,46,0.6304347826086957,30,-1,30,-1
2020-21,2021-03-12,Philadelphia Flyers,0,MassMutual East,Eastern,29,2,48,0.6041666666666666,32,-3,32,-3
2020-21,2021-03-14,Philadelphia Flyers,0,MassMutual East,Eastern,29,2,50,0.58,32,-3,32,-3
2020-21,2021-03-15,Philadelphia Flyers,2,MassMutual East,Eastern,31,2,52,0.5961538461538461,32,-1,32,-1
2020-21,2021-03-17,Philadelphia Flyers,0,MassMutual East,Eastern,31,2,54,0.5740740740740741,34,-3,34,-3
2020-21,2021-03-18,Philadelphia Flyers,2,MassMutual East,Eastern,33,2,56,0.5892857142857143,36,-3,36,-3
2020-21,2021-03-20,Philadelphia Flyers,0,MassMutual East,Eastern,33,2,58,0.5689655172413793,36,-3,37,-4
2020-21,2021-03-22,Philadelphia Flyers,1,MassMutual East,Eastern,34,2,60,0.5666666666666667,36,-2,37,-3
2020-21,2021-03-23,Philadelphia Flyers,0,MassMutual East,Eastern,34,2,62,0.5483870967741935,36,-2,37,-3
2020-21,2021-03-25,Philadelphia Flyers,0,MassMutual East,Eastern,34,2,64,0.53125,37,-3,37,-3
2020-21,2021-03-27,Philadelphia Flyers,2,MassMutual East,Eastern,36,2,66,0.5454545454545454,39,-3,39,-3
2020-21,2021-03-29,Philadelphia Flyers,2,MassMutual East,Eastern,38,2,68,0.5588235294117647,39,-1,39,-1
2020-21,2021-03-31,Philadelphia Flyers,0,MassMutual East,Eastern,38,2,70,0.5428571428571428,41,-3,41,-3
2020-21,2021-04-03,Philadelphia Flyers,1,MassMutual East,Eastern,39,2,72,0.5416666666666666,43,-4,43,-4
2020-21,2021-04-05,Philadelphia Flyers,2,MassMutual East,Eastern,41,2,74,0.5540540540540541,44,-3,44,-3
2020-21,2021-04-06,Philadelphia Flyers,0,MassMutual East,Eastern,41,2,76,0.5394736842105263,46,-5,46,-5
2020-21,2021-04-08,Philadelphia Flyers,1,MassMutual East,Eastern,42,2,78,0.5384615384615384,48,-6,48,-6
2020-21,2021-04-10,Philadelphia Flyers,2,MassMutual East,Eastern,44,2,80,0.55,48,-4,48,-4
2020-21,2021-04-11,Philadelphia Flyers,0,MassMutual East,Eastern,44,2,82,0.5365853658536586,48,-4,48,-4
2020-21,2021-04-13,Philadelphia Flyers,0,MassMutual East,Eastern,44,2,84,0.5238095238095238,50,-6,50,-6
2020-21,2021-04-15,Philadelphia Flyers,2,MassMutual East,Eastern,46,2,86,0.5348837209302325,52,-6,52,-6
2020-21,2021-04-17,Philadelphia Flyers,0,MassMutual East,Eastern,46,2,88,0.5227272727272727,54,-8,54,-8
2020-21,2021-04-18,Philadelphia Flyers,1,MassMutual East,Eastern,47,2,90,0.5222222222222223,56,-9,56,-9
2020-21,2021-04-22,Philadelphia Flyers,2,MassMutual East,Eastern,49,2,92,0.532608695652174,60,-11,60,-11
2020-21,2021-04-23,Philadelphia Flyers,0,MassMutual East,Eastern,49,2,94,0.5212765957446809,60,-11,60,-11
2020-21,2021-04-25,Philadelphia Flyers,2,MassMutual East,Eastern,51,2,96,0.53125,60,-9,60,-9
2020-21,2021-04-27,Philadelphia Flyers,0,MassMutual East,Eastern,51,2,98,0.5204081632653061,62,-11,62,-11
2020-21,2021-04-29,Philadelphia Flyers,0,MassMutual East,Eastern,51,2,100,0.51,64,-13,64,-13
2020-21,2021-05-01,Philadelphia Flyers,0,MassMutual East,Eastern,51,2,102,0.5,66,-15,66,-15
2020-21,2021-05-03,Philadelphia Flyers,2,MassMutual East,Eastern,53,2,104,0.5096153846153846,67,-14,67,-14
2020-21,2021-05-04,Philadelphia Flyers,0,MassMutual East,Eastern,53,2,106,0.5,68,-15,68,-15
2020-21,2021-05-07,Philadelphia Flyers,2,MassMutual East,Eastern,55,2,108,0.5092592592592593,68,-13,68,-13
2020-21,2021-05-08,Philadelphia Flyers,1,MassMutual East,Eastern,56,2,110,0.509090909090909,70,-14,70,-14
2020-21,2021-05-10,Philadelphia Flyers,2,MassMutual East,Eastern,58,2,112,0.5178571428571429,71,-13,71,-13
2020-21,2021-01-13,Pittsburgh Penguins,0,MassMutual East,Eastern,0,2,2,0.0,0,0,0,0
2020-21,2021-01-16,Pittsburgh Penguins,0,MassMutual East,Eastern,0,2,4,0.0,3,-3,2,-2
2020-21,2021-01-17,Pittsburgh Penguins,2,MassMutual East,Eastern,2,2,6,0.3333333333333333,3,-1,2,0
2020-21,2021-01-20,Pittsburgh Penguins,2,MassMutual East,Eastern,4,2,8,0.5,4,0,4,0
2020-21,2021-01-23,Pittsburgh Penguins,2,MassMutual East,Eastern,6,2,10,0.6,6,0,6,0
2020-21,2021-01-25,Pittsburgh Penguins,2,MassMutual East,Eastern,8,2,12,0.6666666666666666,7,1,6,2
2020-21,2021-01-27,Pittsburgh Penguins,1,MassMutual East,Eastern,9,2,14,0.6428571428571429,9,0,7,2
2020-21,2021-01-29,Pittsburgh Penguins,0,MassMutual East,Eastern,9,2,16,0.5625,9,0,8,1
2020-21,2021-01-31,Pittsburgh Penguins,2,MassMutual East,Eastern,11,2,18,0.6111111111111112,11,0,10,1
2020-21,2021-02-02,Pittsburgh Penguins,0,MassMutual East,Eastern,11,2,20,0.55,11,0,11,0
2020-21,2021-02-07,Pittsburgh Penguins,0,MassMutual East,Eastern,11,2,22,0.5,11,0,14,-3
2020-21,2021-02-12,Pittsburgh Penguins,2,MassMutual East,Eastern,13,2,24,0.5416666666666666,13,0,16,-3
2020-21,2021-02-14,Pittsburgh Penguins,2,MassMutual East,Eastern,15,2,26,0.5769230769230769,15,0,18,-3
2020-21,2021-02-17,Pittsburgh Penguins,0,MassMutual East,Eastern,15,2,28,0.5357142857142857,17,-2,18,-3
2020-21,2021-02-19,Pittsburgh Penguins,2,MassMutual East,Eastern,17,2,30,0.5666666666666667,19,-2,19,-2
2020-21,2021-02-21,Pittsburgh Penguins,2,MassMutual East,Eastern,19,2,32,0.59375,19,0,20,-1
2020-21,2021-02-24,Pittsburgh Penguins,2,MassMutual East,Eastern,21,2,34,0.6176470588235294,21,0,21,0
2020-21,2021-02-26,Pittsburgh Penguins,0,MassMutual East,Eastern,21,2,36,0.5833333333333334,21,0,22,-1
2020-21,2021-02-28,Pittsburgh Penguins,2,MassMutual East,Eastern,23,2,38,0.6052631578947368,25,-2,25,-2
2020-21,2021-02-28,Pittsburgh Penguins,0,MassMutual East,Eastern,23,2,40,0.575,25,-2,25,-2
2020-21,2021-03-03,Pittsburgh Penguins,2,MassMutual East,Eastern,25,2,42,0.5952380952380952,25,0,25,0
2020-21,2021-03-05,Pittsburgh Penguins,0,MassMutual East,Eastern,25,2,44,0.5681818181818182,27,-2,27,-2
2020-21,2021-03-06,Pittsburgh Penguins,2,MassMutual East,Eastern,27,2,46,0.5869565217391305,27,0,27,0
2020-21,2021-03-08,Pittsburgh Penguins,2,MassMutual East,Eastern,29,2,48,0.6041666666666666,29,0,29,0
2020-21,2021-03-09,Pittsburgh Penguins,2,MassMutual East,Eastern,31,2,50,0.62,29,2,29,2
2020-21,2021-03-12,Pittsburgh Penguins,2,MassMutual East,Eastern,33,2,52,0.6346153846153846,32,1,32,1
2020-21,2021-03-14,Pittsburgh Penguins,2,MassMutual East,Eastern,35,2,54,0.6481481481481481,32,3,32,3
2020-21,2021-03-15,Pittsburgh Penguins,2,MassMutual East,Eastern,37,2,56,0.6607142857142857,32,5,32,5
2020-21,2021-03-16,Pittsburgh Penguins,0,MassMutual East,Eastern,37,2,58,0.6379310344827587,34,3,34,3
2020-21,2021-03-18,Pittsburgh Penguins,0,MassMutual East,Eastern,37,2,60,0.6166666666666667,36,1,36,1
2020-21,2021-03-20,Pittsburgh Penguins,2,MassMutual East,Eastern,39,2,62,0.6290322580645161,36,3,37,2
2020-21,2021-03-21,Pittsburgh Penguins,1,MassMutual East,Eastern,40,2,64,0.625,36,4,37,3
2020-21,2021-03-25,Pittsburgh Penguins,2,MassMutual East,Eastern,42,2,66,0.6363636363636364,37,5,37,5
2020-21,2021-03-25,Pittsburgh Penguins,2,MassMutual East,Eastern,44,2,68,0.6470588235294118,37,7,37,7
2020-21,2021-03-27,Pittsburgh Penguins,2,MassMutual East,Eastern,46,2,70,0.6571428571428571,39,7,39,7
2020-21,2021-03-29,Pittsburgh Penguins,2,MassMutual East,Eastern,48,2,72,0.6666666666666666,39,9,39,9
2020-21,2021-04-01,Pittsburgh Penguins,2,MassMutual East,Eastern,50,2,74,0.6756756756756757,41,9,41,9
2020-21,2021-04-03,Pittsburgh Penguins,0,MassMutual East,Eastern,50,2,76,0.6578947368421053,43,7,43,7
2020-21,2021-04-06,Pittsburgh Penguins,0,MassMutual East,Eastern,50,2,78,0.6410256410256411,46,4,46,4
2020-21,2021-04-08,Pittsburgh Penguins,2,MassMutual East,Eastern,52,2,80,0.65,48,4,48,4
2020-21,2021-04-09,Pittsburgh Penguins,2,MassMutual East,Eastern,54,2,82,0.6585365853658537,48,6,48,6
2020-21,2021-04-11,Pittsburgh Penguins,2,MassMutual East,Eastern,56,2,84,0.6666666666666666,48,8,48,8
2020-21,2021-04-15,Pittsburgh Penguins,1,MassMutual East,Eastern,57,2,86,0.6627906976744186,52,5,52,5
2020-21,2021-04-17,Pittsburgh Penguins,2,MassMutual East,Eastern,59,2,88,0.6704545454545454,54,5,54,5
2020-21,2021-04-18,Pittsburgh Penguins,0,MassMutual East,Eastern,59,2,90,0.6555555555555556,56,3,56,3
2020-21,2021-04-20,Pittsburgh Penguins,2,MassMutual East,Eastern,61,2,92,0.6630434782608695,58,3,58,3
2020-21,2021-04-22,Pittsburgh Penguins,2,MassMutual East,Eastern,63,2,94,0.6702127659574468,60,3,60,3
2020-21,2021-04-24,Pittsburgh Penguins,2,MassMutual East,Eastern,65,2,96,0.6770833333333334,60,5,60,5
2020-21,2021-04-25,Pittsburgh Penguins,2,MassMutual East,Eastern,67,2,98,0.6836734693877551,60,7,60,7
2020-21,2021-04-27,Pittsburgh Penguins,0,MassMutual East,Eastern,67,2,100,0.67,62,5,62,5
2020-21,2021-04-29,Pittsburgh Penguins,2,MassMutual East,Eastern,69,2,102,0.6764705882352942,64,5,64,5
2020-21,2021-05-01,Pittsburgh Penguins,2,MassMutual East,Eastern,71,2,104,0.6826923076923077,66,5,66,5
2020-21,2021-05-03,Pittsburgh Penguins,0,MassMutual East,Eastern,71,2,106,0.6698113207547169,67,4,67,4
2020-21,2021-05-04,Pittsburgh Penguins,2,MassMutual East,Eastern,73,2,108,0.6759259259259259,68,5,68,5
2020-21,2021-05-06,Pittsburgh Penguins,2,MassMutual East,Eastern,75,2,110,0.6818181818181818,68,7,68,7
2020-21,2021-05-08,Pittsburgh Penguins,2,MassMutual East,Eastern,77,2,112,0.6875,70,7,70,7
2020-21,2021-01-15,San Jose Sharks,2,Honda West,Western,2,2,2,1.0,2,0,2,0
2020-21,2021-01-16,San Jose Sharks,0,Honda West,Western,2,2,4,0.5,2,0,2,0
2020-21,2021-01-19,San Jose Sharks,0,Honda West,Western,2,2,6,0.3333333333333333,3,-1,2,0
2020-21,2021-01-21,San Jose Sharks,2,Honda West,Western,4,2,8,0.5,4,0,4,0
2020-21,2021-01-23,San Jose Sharks,0,Honda West,Western,4,2,10,0.4,5,-1,4,0
2020-21,2021-01-25,San Jose Sharks,2,Honda West,Western,6,2,12,0.5,6,0,6,0
2020-21,2021-01-27,San Jose Sharks,0,Honda West,Western,6,2,14,0.42857142857142855,8,-2,6,0
2020-21,2021-01-29,San Jose Sharks,0,Honda West,Western,6,2,16,0.375,9,-3,8,-2
2020-21,2021-02-06,San Jose Sharks,2,Honda West,Western,8,2,18,0.4444444444444444,12,-4,12,-4
2020-21,2021-02-07,San Jose Sharks,1,Honda West,Western,9,2,20,0.45,13,-4,12,-3
2020-21,2021-02-10,San Jose Sharks,2,Honda West,Western,11,2,22,0.5,13,-2,13,-2
2020-21,2021-02-12,San Jose Sharks,0,Honda West,Western,11,2,24,0.4583333333333333,15,-4,15,-4
2020-21,2021-02-13,San Jose Sharks,0,Honda West,Western,11,2,26,0.4230769230769231,15,-4,15,-4
2020-21,2021-02-16,San Jose Sharks,2,Honda West,Western,13,2,28,0.4642857142857143,15,-2,15,-2
2020-21,2021-02-19,San Jose Sharks,1,Honda West,Western,14,2,30,0.4666666666666667,17,-3,17,-3
2020-21,2021-02-21,San Jose Sharks,2,Honda West,Western,16,2,32,0.5,17,-1,17,-1
2020-21,2021-02-23,San Jose Sharks,0,Honda West,Western,16,2,34,0.47058823529411764,19,-3,19,-3
2020-21,2021-02-28,San Jose Sharks,0,Honda West,Western,16,2,36,0.4444444444444444,23,-7,22,-6
2020-21,2021-03-02,San Jose Sharks,2,Honda West,Western,18,2,38,0.47368421052631576,23,-5,22,-4
2020-21,2021-03-04,San Jose Sharks,0,Honda West,Western,18,2,40,0.45,25,-7,23,-5
2020-21,2021-03-06,San Jose Sharks,1,Honda West,Western,19,2,42,0.4523809523809524,27,-8,24,-5
2020-21,2021-03-07,San Jose Sharks,0,Honda West,Western,19,2,44,0.4318181818181818,27,-8,25,-6
2020-21,2021-03-09,San Jose Sharks,2,Honda West,Western,21,2,46,0.45652173913043476,28,-7,27,-6
2020-21,2021-03-13,San Jose Sharks,2,Honda West,Western,23,2,48,0.4791666666666667,32,-9,28,-5
2020-21,2021-03-14,San Jose Sharks,2,Honda West,Western,25,2,50,0.5,33,-8,29,-4
2020-21,2021-03-16,San Jose Sharks,0,Honda West,Western,25,2,52,0.4807692307692308,33,-8,31,-6
2020-21,2021-03-18,San Jose Sharks,0,Honda West,Western,25,2,54,0.46296296296296297,33,-8,32,-7
2020-21,2021-03-20,San Jose Sharks,1,Honda West,Western,26,2,56,0.4642857142857143,35,-9,33,-7
2020-21,2021-03-21,San Jose Sharks,0,Honda West,Western,26,2,58,0.4482758620689655,37,-11,33,-7
2020-21,2021-03-23,San Jose Sharks,2,Honda West,Western,28,2,60,0.4666666666666667,37,-9,33,-5
2020-21,2021-03-25,San Jose Sharks,2,Honda West,Western,30,2,62,0.4838709677419355,37,-7,35,-5
2020-21,2021-03-27,San Jose Sharks,0,Honda West,Western,30,2,64,0.46875,37,-7,35,-5
2020-21,2021-03-28,San Jose Sharks,0,Honda West,Western,30,2,66,0.45454545454545453,38,-8,37,-7
2020-21,2021-03-30,San Jose Sharks,2,Honda West,Western,32,2,68,0.47058823529411764,38,-6,37,-5
2020-21,2021-04-01,San Jose Sharks,2,Honda West,Western,34,2,70,0.4857142857142857,38,-4,38,-4
2020-21,2021-04-03,San Jose Sharks,2,Honda West,Western,36,2,72,0.5,39,-3,39,-3
2020-21,2021-04-04,San Jose Sharks,2,Honda West,Western,38,2,74,0.5135135135135135,39,-1,39,-1
2020-21,2021-04-07,San Jose Sharks,0,Honda West,Western,38,2,76,0.5,43,-5,41,-3
2020-21,2021-04-10,San Jose Sharks,2,Honda West,Western,40,2,78,0.5128205128205128,43,-3,43,-3
2020-21,2021-04-11,San Jose Sharks,0,Honda West,Western,40,2,80,0.5,44,-4,43,-3
2020-21,2021-04-13,San Jose Sharks,0,Honda West,Western,40,2,82,0.4878048780487805,44,-4,44,-4
2020-21,2021-04-15,San Jose Sharks,0,Honda West,Western,40,2,84,0.47619047619047616,44,-4,44,-4
2020-21,2021-04-17,San Jose Sharks,0,Honda West,Western,40,2,86,0.46511627906976744,45,-5,45,-5
2020-21,2021-04-18,San Jose Sharks,0,Honda West,Western,40,2,88,0.45454545454545453,45,-5,46,-6
2020-21,2021-04-20,San Jose Sharks,1,Honda West,Western,41,2,90,0.45555555555555555,45,-4,47,-6
2020-21,2021-04-22,San Jose Sharks,0,Honda West,Western,41,2,92,0.44565217391304346,45,-4,49,-8
2020-21,2021-04-25,San Jose Sharks,0,Honda West,Western,41,2,94,0.43617021276595747,47,-6,49,-8
2020-21,2021-04-27,San Jose Sharks,2,Honda West,Western,43,2,96,0.4479166666666667,48,-5,49,-6
2020-21,2021-04-29,San Jose Sharks,2,Honda West,Western,45,2,98,0.45918367346938777,50,-5,50,-5
2020-21,2021-05-01,San Jose Sharks,0,Honda West,Western,45,2,100,0.45,52,-7,52,-7
2020-21,2021-05-02,San Jose Sharks,0,Honda West,Western,45,2,102,0.4411764705882353,53,-8,53,-8
2020-21,2021-05-04,San Jose Sharks,1,Honda West,Western,46,2,104,0.4423076923076923,55,-9,55,-9
2020-21,2021-05-06,San Jose Sharks,2,Honda West,Western,48,2,106,0.4528301886792453,56,-8,56,-8
2020-21,2021-05-08,San Jose Sharks,0,Honda West,Western,48,2,108,0.4444444444444444,57,-9,57,-9
2020-21,2021-05-09,San Jose Sharks,1,Honda West,Western,49,2,110,0.44545454545454544,57,-8,57,-8
2020-21,2021-05-13,San Jose Sharks,0,Honda West,Western,49,2,112,0.4375,61,-12,60,-11
2020-21,2021-01-14,St. Louis Blues,2,Honda West,Western,2,2,2,1.0,0,2,0,2
2020-21,2021-01-16,St. Louis Blues,0,Honda West,Western,2,2,4,0.5,2,0,2,0
2020-21,2021-01-19,St. Louis Blues,2,Honda West,Western,4,2,6,0.6666666666666666,3,1,2,2
2020-21,2021-01-21,St. Louis Blues,1,Honda West,Western,5,2,8,0.625,4,1,4,1
2020-21,2021-01-24,St. Louis Blues,2,Honda West,Western,7,2,10,0.7,6,1,5,2
2020-21,2021-01-25,St. Louis Blues,0,Honda West,Western,7,2,12,0.5833333333333334,6,1,6,1
2020-21,2021-01-27,St. Louis Blues,2,Honda West,Western,9,2,14,0.6428571428571429,8,1,6,3
2020-21,2021-01-31,St. Louis Blues,2,Honda West,Western,11,2,16,0.6875,10,1,8,3
2020-21,2021-02-01,St. Louis Blues,2,Honda West,Western,13,2,18,0.7222222222222222,11,2,9,4
2020-21,2021-02-03,St. Louis Blues,2,Honda West,Western,15,2,20,0.75,11,4,11,4
2020-21,2021-02-05,St. Louis Blues,0,Honda West,Western,15,2,22,0.6818181818181818,11,4,11,4
2020-21,2021-02-06,St. Louis Blues,0,Honda West,Western,15,2,24,0.625,12,3,12,3
2020-21,2021-02-09,St. Louis Blues,1,Honda West,Western,16,2,26,0.6153846153846154,13,3,13,3
2020-21,2021-02-13,St. Louis Blues,2,Honda West,Western,18,2,28,0.6428571428571429,15,3,15,3
2020-21,2021-02-14,St. Louis Blues,2,Honda West,Western,20,2,30,0.6666666666666666,15,5,15,5
2020-21,2021-02-15,St. Louis Blues,0,Honda West,Western,20,2,32,0.625,15,5,15,5
2020-21,2021-02-19,St. Louis Blues,2,Honda West,Western,22,2,34,0.6470588235294118,17,5,17,5
2020-21,2021-02-21,St. Louis Blues,0,Honda West,Western,22,2,36,0.6111111111111112,17,5,17,5
2020-21,2021-02-23,St. Louis Blues,0,Honda West,Western,22,2,38,0.5789473684210527,19,3,19,3
2020-21,2021-02-25,St. Louis Blues,0,Honda West,Western,22,2,40,0.55,21,1,20,2
2020-21,2021-02-28,St. Louis Blues,2,Honda West,Western,24,2,42,0.5714285714285714,23,1,22,2
2020-21,2021-03-02,St. Louis Blues,2,Honda West,Western,26,2,44,0.5909090909090909,23,3,22,4
2020-21,2021-03-04,St. Louis Blues,2,Honda West,Western,28,2,46,0.6086956521739131,25,3,23,5
2020-21,2021-03-06,St. Louis Blues,2,Honda West,Western,30,2,48,0.625,27,3,24,6
2020-21,2021-03-07,St. Louis Blues,1,Honda West,Western,31,2,50,0.62,27,4,25,6
2020-21,2021-03-09,St. Louis Blues,1,Honda West,Western,32,2,52,0.6153846153846154,28,4,27,5
2020-21,2021-03-13,St. Louis Blues,1,Honda West,Western,33,2,54,0.6111111111111112,32,1,28,5
2020-21,2021-03-14,St. Louis Blues,0,Honda West,Western,33,2,56,0.5892857142857143,33,0,29,4
2020-21,2021-03-18,St. Louis Blues,0,Honda West,Western,33,2,58,0.5689655172413793,33,0,32,1
2020-21,2021-03-20,St. Louis Blues,2,Honda West,Western,35,2,60,0.5833333333333334,35,0,33,2
2020-21,2021-03-21,St. Louis Blues,2,Honda West,Western,37,2,62,0.5967741935483871,37,0,33,4
2020-21,2021-03-23,St. Louis Blues,0,Honda West,Western,37,2,64,0.578125,37,0,33,4
2020-21,2021-03-26,St. Louis Blues,0,Honda West,Western,37,2,66,0.5606060606060606,37,0,35,2
2020-21,2021-03-27,St. Louis Blues,0,Honda West,Western,37,2,68,0.5441176470588235,37,0,35,2
2020-21,2021-03-28,St. Louis Blues,1,Honda West,Western,38,2,70,0.5428571428571428,38,0,37,1
2020-21,2021-04-03,St. Louis Blues,0,Honda West,Western,38,2,72,0.5277777777777778,39,-1,39,-1
2020-21,2021-04-04,St. Louis Blues,0,Honda West,Western,38,2,74,0.5135135135135135,39,-1,39,-1
2020-21,2021-04-06,St. Louis Blues,0,Honda West,Western,38,2,76,0.5,43,-5,39,-1
2020-21,2021-04-08,St. Louis Blues,2,Honda West,Western,40,2,78,0.5128205128205128,43,-3,41,-1
2020-21,2021-04-10,St. Louis Blues,2,Honda West,Western,42,2,80,0.525,43,-1,43,-1
2020-21,2021-04-11,St. Louis Blues,2,Honda West,Western,44,2,82,0.5365853658536586,44,0,43,1
2020-21,2021-04-14,St. Louis Blues,0,Honda West,Western,44,2,84,0.5238095238095238,44,0,44,0
2020-21,2021-04-17,St. Louis Blues,0,Honda West,Western,44,2,86,0.5116279069767442,45,-1,45,-1
2020-21,2021-04-23,St. Louis Blues,0,Honda West,Western,44,2,88,0.5,45,-1,49,-5
2020-21,2021-04-24,St. Louis Blues,2,Honda West,Western,46,2,90,0.5111111111111111,46,0,49,-3
2020-21,2021-04-26,St. Louis Blues,2,Honda West,Western,48,2,92,0.5217391304347826,48,0,49,-1
2020-21,2021-04-28,St. Louis Blues,2,Honda West,Western,50,2,94,0.5319148936170213,50,0,50,0
2020-21,2021-04-30,St. Louis Blues,2,Honda West,Western,52,2,96,0.5416666666666666,52,0,52,0
2020-21,2021-05-02,St. Louis Blues,1,Honda West,Western,53,2,98,0.5408163265306123,53,0,53,0
2020-21,2021-05-04,St. Louis Blues,2,Honda West,Western,55,2,100,0.55,55,0,55,0
2020-21,2021-05-06,St. Louis Blues,1,Honda West,Western,56,2,102,0.5490196078431373,56,0,56,0
2020-21,2021-05-08,St. Louis Blues,1,Honda West,Western,57,2,104,0.5480769230769231,57,0,57,0
2020-21,2021-05-09,St. Louis Blues,0,Honda West,Western,57,2,106,0.5377358490566038,57,0,57,0
2020-21,2021-05-11,St. Louis Blues,2,Honda West,Western,59,2,108,0.5462962962962963,59,0,59,0
2020-21,2021-05-13,St. Louis Blues,2,Honda West,Western,61,2,110,0.5545454545454546,61,0,60,1
2020-21,2021-05-14,St. Louis Blues,2,Honda West,Western,63,2,112,0.5625,63,0,60,3
2020-21,2021-01-14,Tampa Bay Lightning,2,Discover Central,Eastern,2,2,2,1.0,0,2,0,2
2020-21,2021-01-16,Tampa Bay Lightning,2,Discover Central,Eastern,4,2,4,1.0,0,4,2,2
2020-21,2021-01-22,Tampa Bay Lightning,2,Discover Central,Eastern,6,2,6,1.0,4,2,5,1
2020-21,2021-01-23,Tampa Bay Lightning,0,Discover Central,Eastern,6,2,8,0.75,4,2,6,0
2020-21,2021-01-29,Tampa Bay Lightning,1,Discover Central,Eastern,7,2,10,0.7,7,0,8,-1
2020-21,2021-01-31,Tampa Bay Lightning,2,Discover Central,Eastern,9,2,12,0.75,8,1,10,-1
2020-21,2021-02-02,Tampa Bay Lightning,2,Discover Central,Eastern,11,2,14,0.7857142857142857,9,2,11,0
2020-21,2021-02-03,Tampa Bay Lightning,2,Discover Central,Eastern,13,2,16,0.8125,11,2,11,2
2020-21,2021-02-06,Tampa Bay Lightning,2,Discover Central,Eastern,15,2,18,0.8333333333333334,12,3,13,2
2020-21,2021-02-09,Tampa Bay Lightning,2,Discover Central,Eastern,17,2,20,0.85,14,3,14,3
2020-21,2021-02-10,Tampa Bay Lightning,2,Discover Central,Eastern,19,2,22,0.8636363636363636,15,4,15,4
2020-21,2021-02-12,Tampa Bay Lightning,0,Discover Central,Eastern,19,2,24,0.7916666666666666,16,3,16,3
2020-21,2021-02-14,Tampa Bay Lightning,2,Discover Central,Eastern,21,2,26,0.8076923076923077,18,3,18,3
2020-21,2021-02-16,Tampa Bay Lightning,0,Discover Central,Eastern,21,2,28,0.75,20,1,18,3
2020-21,2021-02-21,Tampa Bay Lightning,0,Discover Central,Eastern,21,2,30,0.7,21,0,20,1
2020-21,2021-02-23,Tampa Bay Lightning,2,Discover Central,Eastern,23,2,32,0.71875,22,1,21,2
2020-21,2021-02-24,Tampa Bay Lightning,2,Discover Central,Eastern,25,2,34,0.7352941176470589,24,1,21,4
2020-21,2021-02-26,Tampa Bay Lightning,2,Discover Central,Eastern,27,2,36,0.75,25,2,22,5
2020-21,2021-02-28,Tampa Bay Lightning,2,Discover Central,Eastern,29,2,38,0.7631578947368421,26,3,25,4
2020-21,2021-03-03,Tampa Bay Lightning,2,Discover Central,Eastern,31,2,40,0.775,28,3,25,6
2020-21,2021-03-05,Tampa Bay Lightning,2,Discover Central,Eastern,33,2,42,0.7857142857142857,29,4,27,6
2020-21,2021-03-06,Tampa Bay Lightning,1,Discover Central,Eastern,34,2,44,0.7727272727272727,31,3,27,7
2020-21,2021-03-07,Tampa Bay Lightning,2,Discover Central,Eastern,36,2,46,0.782608695652174,31,5,28,8
2020-21,2021-03-10,Tampa Bay Lightning,2,Discover Central,Eastern,38,2,48,0.7916666666666666,31,7,30,8
2020-21,2021-03-12,Tampa Bay Lightning,0,Discover Central,Eastern,38,2,50,0.76,33,5,32,6
2020-21,2021-03-14,Tampa Bay Lightning,2,Discover Central,Eastern,40,2,52,0.7692307692307693,33,7,32,8
2020-21,2021-03-15,Tampa Bay Lightning,0,Discover Central,Eastern,40,2,54,0.7407407407407407,33,7,32,8
2020-21,2021-03-17,Tampa Bay Lightning,2,Discover Central,Eastern,42,2,56,0.75,33,9,34,8
2020-21,2021-03-18,Tampa Bay Lightning,2,Discover Central,Eastern,44,2,58,0.7586206896551724,33,11,36,8
2020-21,2021-03-20,Tampa Bay Lightning,2,Discover Central,Eastern,46,2,60,0.7666666666666667,33,13,37,9
2020-21,2021-03-21,Tampa Bay Lightning,2,Discover Central,Eastern,48,2,62,0.7741935483870968,33,15,37,11
2020-21,2021-03-24,Tampa Bay Lightning,2,Discover Central,Eastern,50,2,64,0.78125,35,15,37,13
2020-21,2021-03-26,Tampa Bay Lightning,0,Discover Central,Eastern,50,2,66,0.7575757575757576,37,13,37,13
2020-21,2021-03-27,Tampa Bay Lightning,0,Discover Central,Eastern,50,2,68,0.7352941176470589,37,13,39,11
2020-21,2021-03-30,Tampa Bay Lightning,0,Discover Central,Eastern,50,2,70,0.7142857142857143,39,11,41,9
2020-21,2021-04-01,Tampa Bay Lightning,2,Discover Central,Eastern,52,2,72,0.7222222222222222,39,13,41,11
2020-21,2021-04-03,Tampa Bay Lightning,2,Discover Central,Eastern,54,2,74,0.7297297297297297,41,13,43,11
2020-21,2021-04-04,Tampa Bay Lightning,0,Discover Central,Eastern,54,2,76,0.7105263157894737,41,13,43,11
2020-21,2021-04-06,Tampa Bay Lightning,0,Discover Central,Eastern,54,2,78,0.6923076923076923,43,11,46,8
2020-21,2021-04-08,Tampa Bay Lightning,2,Discover Central,Eastern,56,2,80,0.7,45,11,48,8
2020-21,2021-04-11,Tampa Bay Lightning,2,Discover Central,Eastern,58,2,82,0.7073170731707317,45,13,48,10
2020-21,2021-04-14,Tampa Bay Lightning,0,Discover Central,Eastern,58,2,84,0.6904761904761905,49,9,50,8
2020-21,2021-04-15,Tampa Bay Lightning,2,Discover Central,Eastern,60,2,86,0.6976744186046512,49,11,52,8
2020-21,2021-04-17,Tampa Bay Lightning,0,Discover Central,Eastern,60,2,88,0.6818181818181818,49,11,54,6
2020-21,2021-04-19,Tampa Bay Lightning,2,Discover Central,Eastern,62,2,90,0.6888888888888889,49,13,56,6
2020-21,2021-04-20,Tampa Bay Lightning,0,Discover Central,Eastern,62,2,92,0.6739130434782609,51,11,58,4
2020-21,2021-04-22,Tampa Bay Lightning,2,Discover Central,Eastern,64,2,94,0.6808510638297872,52,12,60,4
2020-21,2021-04-25,Tampa Bay Lightning,2,Discover Central,Eastern,66,2,96,0.6875,54,12,60,6
2020-21,2021-04-28,Tampa Bay Lightning,2,Discover Central,Eastern,68,2,98,0.6938775510204082,56,12,62,6
2020-21,2021-04-29,Tampa Bay Lightning,2,Discover Central,Eastern,70,2,100,0.7,56,14,64,6
2020-21,2021-05-01,Tampa Bay Lightning,1,Discover Central,Eastern,71,2,102,0.696078431372549,56,15,66,5
2020-21,2021-05-02,Tampa Bay Lightning,2,Discover Central,Eastern,73,2,104,0.7019230769230769,58,15,66,7
2020-21,2021-05-05,Tampa Bay Lightning,2,Discover Central,Eastern,75,2,106,0.7075471698113207,60,15,68,7
2020-21,2021-05-07,Tampa Bay Lightning,0,Discover Central,Eastern,75,2,108,0.6944444444444444,60,15,68,7
2020-21,2021-05-08,Tampa Bay Lightning,0,Discover Central,Eastern,75,2,110,0.6818181818181818,60,15,70,5
2020-21,2021-05-10,Tampa Bay Lightning,0,Discover Central,Eastern,75,2,112,0.6696428571428571,62,13,71,4
2020-21,2021-01-14,Toronto Maple Leafs,2,Scotia North,Eastern,2,2,2,1.0,0,2,0,2
2020-21,2021-01-16,Toronto Maple Leafs,0,Scotia North,Eastern,2,2,4,0.5,2,0,2,0
2020-21,2021-01-17,Toronto Maple Leafs,2,Scotia North,Eastern,4,2,6,0.6666666666666666,2,2,2,2
2020-21,2021-01-19,Toronto Maple Leafs,2,Scotia North,Eastern,6,2,8,0.75,2,4,3,3
2020-21,2021-01-21,Toronto Maple Leafs,0,Scotia North,Eastern,6,2,10,0.6,4,2,4,2
2020-21,2021-01-23,Toronto Maple Leafs,2,Scotia North,Eastern,8,2,12,0.6666666666666666,5,3,6,2
2020-21,2021-01-24,Toronto Maple Leafs,2,Scotia North,Eastern,10,2,14,0.7142857142857143,5,5,6,4
2020-21,2021-01-27,Toronto Maple Leafs,2,Scotia North,Eastern,12,2,16,0.75,6,6,7,5
2020-21,2021-01-29,Toronto Maple Leafs,2,Scotia North,Eastern,14,2,18,0.7777777777777778,10,4,8,6
2020-21,2021-01-31,Toronto Maple Leafs,1,Scotia North,Eastern,15,2,20,0.75,10,5,10,5
2020-21,2021-02-05,Toronto Maple Leafs,2,Scotia North,Eastern,17,2,22,0.7727272727272727,12,5,12,5
2020-21,2021-02-07,Toronto Maple Leafs,2,Scotia North,Eastern,19,2,24,0.7916666666666666,12,7,14,5
2020-21,2021-02-09,Toronto Maple Leafs,2,Scotia North,Eastern,21,2,26,0.8076923076923077,14,7,14,7
2020-21,2021-02-11,Toronto Maple Leafs,2,Scotia North,Eastern,23,2,28,0.8214285714285714,15,8,15,8
2020-21,2021-02-14,Toronto Maple Leafs,0,Scotia North,Eastern,23,2,30,0.7666666666666667,17,6,18,5
2020-21,2021-02-16,Toronto Maple Leafs,1,Scotia North,Eastern,24,2,32,0.75,18,6,18,6
2020-21,2021-02-18,Toronto Maple Leafs,2,Scotia North,Eastern,26,2,34,0.7647058823529411,19,7,18,8
2020-21,2021-02-19,Toronto Maple Leafs,2,Scotia North,Eastern,28,2,36,0.7777777777777778,19,9,19,9
2020-21,2021-02-21,Toronto Maple Leafs,2,Scotia North,Eastern,30,2,38,0.7894736842105263,20,10,20,10
2020-21,2021-02-23,Toronto Maple Leafs,0,Scotia North,Eastern,30,2,40,0.75,21,9,21,9
2020-21,2021-02-25,Toronto Maple Leafs,2,Scotia North,Eastern,32,2,42,0.7619047619047619,22,10,21,11
2020-21,2021-02-28,Toronto Maple Leafs,2,Scotia North,Eastern,34,2,44,0.7727272727272727,23,11,25,9
2020-21,2021-03-02,Toronto Maple Leafs,2,Scotia North,Eastern,36,2,46,0.782608695652174,23,13,25,11
2020-21,2021-03-04,Toronto Maple Leafs,2,Scotia North,Eastern,38,2,48,0.7916666666666666,25,13,25,13
2020-21,2021-03-05,Toronto Maple Leafs,0,Scotia North,Eastern,38,2,50,0.76,26,12,27,11
2020-21,2021-03-07,Toronto Maple Leafs,0,Scotia North,Eastern,38,2,52,0.7307692307692307,28,10,28,10
2020-21,2021-03-10,Toronto Maple Leafs,0,Scotia North,Eastern,38,2,54,0.7037037037037037,29,9,30,8
2020-21,2021-03-12,Toronto Maple Leafs,2,Scotia North,Eastern,40,2,56,0.7142857142857143,31,9,32,8
2020-21,2021-03-14,Toronto Maple Leafs,0,Scotia North,Eastern,40,2,58,0.6896551724137931,31,9,32,8
2020-21,2021-03-14,Toronto Maple Leafs,0,Scotia North,Eastern,40,2,60,0.6666666666666666,31,9,32,8
2020-21,2021-03-19,Toronto Maple Leafs,0,Scotia North,Eastern,40,2,62,0.6451612903225806,35,5,36,4
2020-21,2021-03-20,Toronto Maple Leafs,2,Scotia North,Eastern,42,2,64,0.65625,37,5,37,5
2020-21,2021-03-25,Toronto Maple Leafs,2,Scotia North,Eastern,44,2,66,0.6666666666666666,37,7,37,7
2020-21,2021-03-27,Toronto Maple Leafs,2,Scotia North,Eastern,46,2,68,0.6764705882352942,37,9,39,7
2020-21,2021-03-29,Toronto Maple Leafs,1,Scotia North,Eastern,47,2,70,0.6714285714285714,37,10,39,8
2020-21,2021-03-31,Toronto Maple Leafs,2,Scotia North,Eastern,49,2,72,0.6805555555555556,39,10,41,8
2020-21,2021-04-03,Toronto Maple Leafs,2,Scotia North,Eastern,51,2,74,0.6891891891891891,41,10,43,8
2020-21,2021-04-05,Toronto Maple Leafs,2,Scotia North,Eastern,53,2,76,0.6973684210526315,43,10,44,9
2020-21,2021-04-06,Toronto Maple Leafs,2,Scotia North,Eastern,55,2,78,0.7051282051282052,43,12,46,9
2020-21,2021-04-07,Toronto Maple Leafs,2,Scotia North,Eastern,57,2,80,0.7125,43,14,46,11
2020-21,2021-04-10,Toronto Maple Leafs,2,Scotia North,Eastern,59,2,82,0.7195121951219512,43,16,48,11
2020-21,2021-04-12,Toronto Maple Leafs,0,Scotia North,Eastern,59,2,84,0.7023809523809523,45,14,48,11
2020-21,2021-04-13,Toronto Maple Leafs,1,Scotia North,Eastern,60,2,86,0.6976744186046512,45,15,50,10
2020-21,2021-04-15,Toronto Maple Leafs,0,Scotia North,Eastern,60,2,88,0.6818181818181818,45,15,52,8
2020-21,2021-04-18,Toronto Maple Leafs,1,Scotia North,Eastern,61,2,90,0.6777777777777778,47,14,56,5
2020-21,2021-04-21,Toronto Maple Leafs,0,Scotia North,Eastern,61,2,92,0.6630434782608695,47,14,58,3
2020-21,2021-04-22,Toronto Maple Leafs,2,Scotia North,Eastern,63,2,94,0.6702127659574468,49,14,60,3
2020-21,2021-04-24,Toronto Maple Leafs,2,Scotia North,Eastern,65,2,96,0.6770833333333334,49,16,60,5
2020-21,2021-04-29,Toronto Maple Leafs,2,Scotia North,Eastern,67,2,98,0.6836734693877551,51,16,64,3
2020-21,2021-04-29,Toronto Maple Leafs,2,Scotia North,Eastern,69,2,100,0.69,51,18,64,5
2020-21,2021-05-01,Toronto Maple Leafs,2,Scotia North,Eastern,71,2,102,0.696078431372549,55,16,66,5
2020-21,2021-05-03,Toronto Maple Leafs,1,Scotia North,Eastern,72,2,104,0.6923076923076923,57,15,67,5
2020-21,2021-05-06,Toronto Maple Leafs,2,Scotia North,Eastern,74,2,106,0.6981132075471698,57,17,68,6
2020-21,2021-05-08,Toronto Maple Leafs,2,Scotia North,Eastern,76,2,108,0.7037037037037037,57,19,70,6
2020-21,2021-05-13,Toronto Maple Leafs,1,Scotia North,Eastern,77,2,110,0.7,59,18,71,6
2020-21,2021-05-15,Toronto Maple Leafs,0,Scotia North,Eastern,77,2,112,0.6875,59,18,71,6
2020-21,2021-01-14,Vancouver Canucks,2,Scotia North,Western,2,2,2,1.0,0,2,0,2
2020-21,2021-01-15,Vancouver Canucks,0,Scotia North,Western,2,2,4,0.5,2,0,2,0
2020-21,2021-01-17,Vancouver Canucks,0,Scotia North,Western,2,2,6,0.3333333333333333,2,0,2,0
2020-21,2021-01-19,Vancouver Canucks,0,Scotia North,Western,2,2,8,0.25,2,0,2,0
2020-21,2021-01-21,Vancouver Canucks,2,Scotia North,Western,4,2,10,0.4,4,0,4,0
2020-21,2021-01-22,Vancouver Canucks,0,Scotia North,Western,4,2,12,0.3333333333333333,5,-1,4,0
2020-21,2021-01-24,Vancouver Canucks,0,Scotia North,Western,4,2,14,0.2857142857142857,5,-1,5,-1
2020-21,2021-01-26,Vancouver Canucks,2,Scotia North,Western,6,2,16,0.375,6,0,6,0
2020-21,2021-01-28,Vancouver Canucks,2,Scotia North,Western,8,2,18,0.4444444444444444,8,0,8,0
2020-21,2021-01-29,Vancouver Canucks,2,Scotia North,Western,10,2,20,0.5,10,0,8,2
2020-21,2021-01-31,Vancouver Canucks,2,Scotia North,Western,12,2,22,0.5454545454545454,10,2,8,4
2020-21,2021-02-02,Vancouver Canucks,0,Scotia North,Western,12,2,24,0.5,11,1,9,3
2020-21,2021-02-03,Vancouver Canucks,0,Scotia North,Western,12,2,26,0.46153846153846156,12,0,11,1
2020-21,2021-02-05,Vancouver Canucks,0,Scotia North,Western,12,2,28,0.42857142857142855,12,0,11,1
2020-21,2021-02-07,Vancouver Canucks,0,Scotia North,Western,12,2,30,0.4,12,0,12,0
2020-21,2021-02-09,Vancouver Canucks,0,Scotia North,Western,12,2,32,0.375,14,-2,13,-1
2020-21,2021-02-12,Vancouver Canucks,0,Scotia North,Western,12,2,34,0.35294117647058826,17,-5,15,-3
2020-21,2021-02-14,Vancouver Canucks,2,Scotia North,Western,14,2,36,0.3888888888888889,17,-3,15,-1
2020-21,2021-02-16,Vancouver Canucks,1,Scotia North,Western,15,2,38,0.39473684210526316,18,-3,15,0
2020-21,2021-02-18,Vancouver Canucks,2,Scotia North,Western,17,2,40,0.425,19,-2,17,0
2020-21,2021-02-20,Vancouver Canucks,0,Scotia North,Western,17,2,42,0.40476190476190477,20,-3,17,0
2020-21,2021-02-22,Vancouver Canucks,1,Scotia North,Western,18,2,44,0.4090909090909091,21,-3,17,1
2020-21,2021-02-24,Vancouver Canucks,0,Scotia North,Western,18,2,46,0.391304347826087,22,-4,19,-1
2020-21,2021-02-26,Vancouver Canucks,0,Scotia North,Western,18,2,48,0.375,22,-4,20,-2
2020-21,2021-03-02,Vancouver Canucks,2,Scotia North,Western,20,2,50,0.4,23,-3,22,-2
2020-21,2021-03-03,Vancouver Canucks,0,Scotia North,Western,20,2,52,0.38461538461538464,25,-5,22,-2
2020-21,2021-03-05,Vancouver Canucks,2,Scotia North,Western,22,2,54,0.4074074074074074,26,-4,24,-2
2020-21,2021-03-07,Vancouver Canucks,2,Scotia North,Western,24,2,56,0.42857142857142855,28,-4,25,-1
2020-21,2021-03-09,Vancouver Canucks,2,Scotia North,Western,26,2,58,0.4482758620689655,29,-3,27,-1
2020-21,2021-03-11,Vancouver Canucks,0,Scotia North,Western,26,2,60,0.43333333333333335,31,-5,28,-2
2020-21,2021-03-14,Vancouver Canucks,2,Scotia North,Western,28,2,62,0.45161290322580644,31,-3,29,-1
2020-21,2021-03-15,Vancouver Canucks,2,Scotia North,Western,30,2,64,0.46875,31,-1,30,0
2020-21,2021-03-17,Vancouver Canucks,2,Scotia North,Western,32,2,66,0.48484848484848486,33,-1,32,0
2020-21,2021-03-19,Vancouver Canucks,2,Scotia North,Western,34,2,68,0.5,35,-1,33,1
2020-21,2021-03-20,Vancouver Canucks,1,Scotia North,Western,35,2,70,0.5,37,-2,33,2
2020-21,2021-03-23,Vancouver Canucks,0,Scotia North,Western,35,2,72,0.4861111111111111,37,-2,33,2
2020-21,2021-03-25,Vancouver Canucks,0,Scotia North,Western,35,2,74,0.47297297297297297,37,-2,35,0
2020-21,2021-04-18,Vancouver Canucks,2,Scotia North,Western,37,2,76,0.4868421052631579,47,-10,46,-9
2020-21,2021-04-21,Vancouver Canucks,2,Scotia North,Western,39,2,78,0.5,47,-8,49,-10
2020-21,2021-04-23,Vancouver Canucks,0,Scotia North,Western,39,2,80,0.4875,49,-10,49,-10
2020-21,2021-04-25,Vancouver Canucks,2,Scotia North,Western,41,2,82,0.5,49,-8,49,-8
2020-21,2021-04-26,Vancouver Canucks,0,Scotia North,Western,41,2,84,0.4880952380952381,51,-10,49,-8
2020-21,2021-04-28,Vancouver Canucks,0,Scotia North,Western,41,2,86,0.47674418604651164,51,-10,50,-9
2020-21,2021-04-29,Vancouver Canucks,0,Scotia North,Western,41,2,88,0.4659090909090909,51,-10,50,-9
2020-21,2021-05-01,Vancouver Canucks,0,Scotia North,Western,41,2,90,0.45555555555555555,55,-14,52,-11
2020-21,2021-05-04,Vancouver Canucks,0,Scotia North,Western,41,2,92,0.44565217391304346,57,-16,55,-14
2020-21,2021-05-05,Vancouver Canucks,0,Scotia North,Western,41,2,94,0.43617021276595747,57,-16,55,-14
2020-21,2021-05-07,Vancouver Canucks,2,Scotia North,Western,43,2,96,0.4479166666666667,57,-14,56,-13
2020-21,2021-05-09,Vancouver Canucks,0,Scotia North,Western,43,2,98,0.4387755102040816,57,-14,57,-14
2020-21,2021-05-11,Vancouver Canucks,2,Scotia North,Western,45,2,100,0.45,58,-13,59,-14
2020-21,2021-05-12,Vancouver Canucks,0,Scotia North,Western,45,2,102,0.4411764705882353,59,-14,59,-14
2020-21,2021-05-14,Vancouver Canucks,0,Scotia North,Western,45,2,104,0.4326923076923077,59,-14,60,-15
2020-21,2021-05-15,Vancouver Canucks,2,Scotia North,Western,47,2,106,0.44339622641509435,59,-12,60,-13
2020-21,2021-05-17,Vancouver Canucks,1,Scotia North,Western,48,2,108,0.4444444444444444,59,-11,60,-12
2020-21,2021-05-18,Vancouver Canucks,2,Scotia North,Western,50,2,110,0.45454545454545453,59,-9,60,-10
2020-21,2021-05-19,Vancouver Canucks,0,Scotia North,Western,50,2,112,0.44642857142857145,59,-9,60,-10
2020-21,2021-01-15,Vegas Golden Knights,2,Honda West,Western,2,2,2,1.0,2,0,2,0
2020-21,2021-01-17,Vegas Golden Knights,2,Honda West,Western,4,2,4,1.0,2,2,2,2
2020-21,2021-01-19,Vegas Golden Knights,2,Honda West,Western,6,2,6,1.0,3,3,2,4
2020-21,2021-01-21,Vegas Golden Knights,2,Honda West,Western,8,2,8,1.0,4,4,4,4
2020-21,2021-01-23,Vegas Golden Knights,0,Honda West,Western,8,2,10,0.8,5,3,4,4
2020-21,2021-01-24,Vegas Golden Knights,2,Honda West,Western,10,2,12,0.8333333333333334,6,4,5,5
2020-21,2021-01-27,Vegas Golden Knights,1,Honda West,Western,11,2,14,0.7857142857142857,8,3,6,5
2020-21,2021-02-06,Vegas Golden Knights,2,Honda West,Western,13,2,16,0.8125,12,1,12,1
2020-21,2021-02-07,Vegas Golden Knights,2,Honda West,Western,15,2,18,0.8333333333333334,13,2,12,3
2020-21,2021-02-10,Vegas Golden Knights,2,Honda West,Western,17,2,20,0.85,13,4,13,4
2020-21,2021-02-12,Vegas Golden Knights,0,Honda West,Western,17,2,22,0.7727272727272727,15,2,15,2
2020-21,2021-02-13,Vegas Golden Knights,2,Honda West,Western,19,2,24,0.7916666666666666,15,4,15,4
2020-21,2021-02-15,Vegas Golden Knights,2,Honda West,Western,21,2,26,0.8076923076923077,15,6,15,6
2020-21,2021-02-17,Vegas Golden Knights,0,Honda West,Western,21,2,28,0.75,16,5,16,5
2020-21,2021-02-20,Vegas Golden Knights,0,Honda West,Western,21,2,30,0.7,17,4,17,4
2020-21,2021-02-23,Vegas Golden Knights,2,Honda West,Western,23,2,32,0.71875,19,4,19,4
2020-21,2021-02-28,Vegas Golden Knights,2,Honda West,Western,25,2,34,0.7352941176470589,23,2,22,3
2020-21,2021-03-02,Vegas Golden Knights,2,Honda West,Western,27,2,36,0.75,23,4,22,5
2020-21,2021-03-04,Vegas Golden Knights,2,Honda West,Western,29,2,38,0.7631578947368421,25,4,23,6
2020-21,2021-03-06,Vegas Golden Knights,2,Honda West,Western,31,2,40,0.775,27,4,24,7
2020-21,2021-03-07,Vegas Golden Knights,2,Honda West,Western,33,2,42,0.7857142857142857,27,6,25,8
2020-21,2021-03-09,Vegas Golden Knights,0,Honda West,Western,33,2,44,0.75,28,5,27,6
2020-21,2021-03-11,Vegas Golden Knights,0,Honda West,Western,33,2,46,0.717391304347826,30,3,28,5
2020-21,2021-03-13,Vegas Golden Knights,2,Honda West,Western,35,2,48,0.7291666666666666,32,3,28,7
2020-21,2021-03-14,Vegas Golden Knights,2,Honda West,Western,37,2,50,0.74,33,4,29,8
2020-21,2021-03-16,Vegas Golden Knights,2,Honda West,Western,39,2,52,0.75,33,6,31,8
2020-21,2021-03-18,Vegas Golden Knights,2,Honda West,Western,41,2,54,0.7592592592592593,33,8,32,9
2020-21,2021-03-20,Vegas Golden Knights,2,Honda West,Western,43,2,56,0.7678571428571429,35,8,33,10
2020-21,2021-03-21,Vegas Golden Knights,0,Honda West,Western,43,2,58,0.7413793103448276,37,6,33,10
2020-21,2021-03-23,Vegas Golden Knights,2,Honda West,Western,45,2,60,0.75,37,8,33,12
2020-21,2021-03-26,Vegas Golden Knights,0,Honda West,Western,45,2,62,0.7258064516129032,37,8,35,10
2020-21,2021-03-27,Vegas Golden Knights,2,Honda West,Western,47,2,64,0.734375,37,10,35,12
2020-21,2021-03-30,Vegas Golden Knights,2,Honda West,Western,49,2,66,0.7424242424242424,38,11,37,12
2020-21,2021-04-01,Vegas Golden Knights,0,Honda West,Western,49,2,68,0.7205882352941176,38,11,38,11
2020-21,2021-04-02,Vegas Golden Knights,1,Honda West,Western,50,2,70,0.7142857142857143,38,12,38,12
2020-21,2021-04-04,Vegas Golden Knights,0,Honda West,Western,50,2,72,0.6944444444444444,39,11,39,11
2020-21,2021-04-06,Vegas Golden Knights,2,Honda West,Western,52,2,74,0.7027027027027027,43,9,39,13
2020-21,2021-04-08,Vegas Golden Knights,0,Honda West,Western,52,2,76,0.6842105263157895,43,9,41,11
2020-21,2021-04-10,Vegas Golden Knights,2,Honda West,Western,54,2,78,0.6923076923076923,43,11,43,11
2020-21,2021-04-11,Vegas Golden Knights,2,Honda West,Western,56,2,80,0.7,44,12,43,13
2020-21,2021-04-13,Vegas Golden Knights,2,Honda West,Western,58,2,82,0.7073170731707317,44,14,44,14
2020-21,2021-04-15,Vegas Golden Knights,2,Honda West,Western,60,2,84,0.7142857142857143,44,16,44,16
2020-21,2021-04-17,Vegas Golden Knights,2,Honda West,Western,62,2,86,0.7209302325581395,45,17,45,17
2020-21,2021-04-18,Vegas Golden Knights,2,Honda West,Western,64,2,88,0.7272727272727273,45,19,46,18
2020-21,2021-04-20,Vegas Golden Knights,2,Honda West,Western,66,2,90,0.7333333333333333,45,21,47,19
2020-21,2021-04-22,Vegas Golden Knights,2,Honda West,Western,68,2,92,0.7391304347826086,45,23,49,19
2020-21,2021-04-25,Vegas Golden Knights,2,Honda West,Western,70,2,94,0.7446808510638298,47,23,49,21
2020-21,2021-04-29,Vegas Golden Knights,2,Honda West,Western,72,2,96,0.75,50,22,50,22
2020-21,2021-05-01,Vegas Golden Knights,0,Honda West,Western,72,2,98,0.7346938775510204,52,20,52,20
2020-21,2021-05-02,Vegas Golden Knights,2,Honda West,Western,74,2,100,0.74,53,21,53,21
2020-21,2021-05-04,Vegas Golden Knights,0,Honda West,Western,74,2,102,0.7254901960784313,55,19,55,19
2020-21,2021-05-06,Vegas Golden Knights,2,Honda West,Western,76,2,104,0.7307692307692307,56,20,56,20
2020-21,2021-05-08,Vegas Golden Knights,2,Honda West,Western,78,2,106,0.7358490566037735,57,21,57,21
2020-21,2021-05-09,Vegas Golden Knights,2,Honda West,Western,80,2,108,0.7407407407407407,57,23,57,23
2020-21,2021-05-11,Vegas Golden Knights,0,Honda West,Western,80,2,110,0.7272727272727273,59,21,59,21
2020-21,2021-05-13,Vegas Golden Knights,2,Honda West,Western,82,2,112,0.7321428571428571,61,21,60,22
2020-21,2021-01-15,Washington Capitals,2,MassMutual East,Eastern,2,2,2,1.0,2,0,1,1
2020-21,2021-01-16,Washington Capitals,2,MassMutual East,Eastern,4,2,4,1.0,3,1,2,2
2020-21,2021-01-17,Washington Capitals,1,MassMutual East,Eastern,5,2,6,0.8333333333333334,3,2,2,3
2020-21,2021-01-20,Washington Capitals,1,MassMutual East,Eastern,6,2,8,0.75,4,2,4,2
2020-21,2021-01-23,Washington Capitals,2,MassMutual East,Eastern,8,2,10,0.8,6,2,6,2
2020-21,2021-01-24,Washington Capitals,1,MassMutual East,Eastern,9,2,12,0.75,6,3,6,3
2020-21,2021-01-27,Washington Capitals,2,MassMutual East,Eastern,11,2,14,0.7857142857142857,9,2,7,4
2020-21,2021-01-29,Washington Capitals,2,MassMutual East,Eastern,13,2,16,0.8125,9,4,8,5
2020-21,2021-01-31,Washington Capitals,2,MassMutual East,Eastern,15,2,18,0.8333333333333334,11,4,10,5
2020-21,2021-02-02,Washington Capitals,0,MassMutual East,Eastern,15,2,20,0.75,11,4,11,4
2020-21,2021-02-05,Washington Capitals,0,MassMutual East,Eastern,15,2,22,0.6818181818181818,11,4,12,3
2020-21,2021-02-07,Washington Capitals,0,MassMutual East,Eastern,15,2,24,0.625,11,4,14,1
2020-21,2021-02-14,Washington Capitals,0,MassMutual East,Eastern,15,2,26,0.5769230769230769,15,0,18,-3
2020-21,2021-02-17,Washington Capitals,2,MassMutual East,Eastern,17,2,28,0.6071428571428571,17,0,18,-1
2020-21,2021-02-19,Washington Capitals,2,MassMutual East,Eastern,19,2,30,0.6333333333333333,19,0,19,0
2020-21,2021-02-20,Washington Capitals,0,MassMutual East,Eastern,19,2,32,0.59375,19,0,19,0
2020-21,2021-02-21,Washington Capitals,2,MassMutual East,Eastern,21,2,34,0.6176470588235294,19,2,20,1
2020-21,2021-02-24,Washington Capitals,1,MassMutual East,Eastern,22,2,36,0.6111111111111112,21,1,21,1
2020-21,2021-02-26,Washington Capitals,2,MassMutual East,Eastern,24,2,38,0.631578947368421,21,3,22,2
2020-21,2021-02-27,Washington Capitals,2,MassMutual East,Eastern,26,2,40,0.65,23,3,23,3
2020-21,2021-02-28,Washington Capitals,2,MassMutual East,Eastern,28,2,42,0.6666666666666666,25,3,25,3
2020-21,2021-03-04,Washington Capitals,2,MassMutual East,Eastern,30,2,44,0.6818181818181818,25,5,25,5
2020-21,2021-03-06,Washington Capitals,0,MassMutual East,Eastern,30,2,46,0.6521739130434783,27,3,27,3
2020-21,2021-03-08,Washington Capitals,2,MassMutual East,Eastern,32,2,48,0.6666666666666666,29,3,29,3
2020-21,2021-03-10,Washington Capitals,2,MassMutual East,Eastern,34,2,50,0.68,30,4,30,4
2020-21,2021-03-12,Washington Capitals,2,MassMutual East,Eastern,36,2,52,0.6923076923076923,32,4,32,4
2020-21,2021-03-14,Washington Capitals,2,MassMutual East,Eastern,38,2,54,0.7037037037037037,32,6,32,6
2020-21,2021-03-15,Washington Capitals,2,MassMutual East,Eastern,40,2,56,0.7142857142857143,32,8,32,8
2020-21,2021-03-16,Washington Capitals,2,MassMutual East,Eastern,42,2,58,0.7241379310344828,34,8,34,8
2020-21,2021-03-19,Washington Capitals,2,MassMutual East,Eastern,44,2,60,0.7333333333333333,36,8,36,8
2020-21,2021-03-20,Washington Capitals,0,MassMutual East,Eastern,44,2,62,0.7096774193548387,36,8,37,7
2020-21,2021-03-25,Washington Capitals,2,MassMutual East,Eastern,46,2,64,0.71875,37,9,37,9
2020-21,2021-03-26,Washington Capitals,2,MassMutual East,Eastern,48,2,66,0.7272727272727273,37,11,37,11
2020-21,2021-03-28,Washington Capitals,2,MassMutual East,Eastern,50,2,68,0.7352941176470589,39,11,39,11
2020-21,2021-03-30,Washington Capitals,0,MassMutual East,Eastern,50,2,70,0.7142857142857143,41,9,41,9
2020-21,2021-04-01,Washington Capitals,0,MassMutual East,Eastern,50,2,72,0.6944444444444444,41,9,41,9
2020-21,2021-04-02,Washington Capitals,2,MassMutual East,Eastern,52,2,74,0.7027027027027027,41,11,41,11
2020-21,2021-04-04,Washington Capitals,2,MassMutual East,Eastern,54,2,76,0.7105263157894737,43,11,43,11
2020-21,2021-04-06,Washington Capitals,0,MassMutual East,Eastern,54,2,78,0.6923076923076923,46,8,46,8
2020-21,2021-04-08,Washington Capitals,0,MassMutual East,Eastern,54,2,80,0.675,48,6,48,6
2020-21,2021-04-09,Washington Capitals,2,MassMutual East,Eastern,56,2,82,0.6829268292682927,48,8,48,8
2020-21,2021-04-11,Washington Capitals,2,MassMutual East,Eastern,58,2,84,0.6904761904761905,48,10,48,10
2020-21,2021-04-13,Washington Capitals,2,MassMutual East,Eastern,60,2,86,0.6976744186046512,50,10,50,10
2020-21,2021-04-15,Washington Capitals,0,MassMutual East,Eastern,60,2,88,0.6818181818181818,52,8,52,8
2020-21,2021-04-17,Washington Capitals,2,MassMutual East,Eastern,62,2,90,0.6888888888888889,54,8,54,8
2020-21,2021-04-18,Washington Capitals,0,MassMutual East,Eastern,62,2,92,0.6739130434782609,56,6,56,6
2020-21,2021-04-22,Washington Capitals,2,MassMutual East,Eastern,64,2,94,0.6808510638297872,60,4,60,4
2020-21,2021-04-24,Washington Capitals,2,MassMutual East,Eastern,66,2,96,0.6875,60,6,60,6
2020-21,2021-04-27,Washington Capitals,2,MassMutual East,Eastern,68,2,98,0.6938775510204082,62,6,62,6
2020-21,2021-04-29,Washington Capitals,1,MassMutual East,Eastern,69,2,100,0.69,64,5,64,5
2020-21,2021-05-01,Washington Capitals,0,MassMutual East,Eastern,69,2,102,0.6764705882352942,66,3,66,3
2020-21,2021-05-03,Washington Capitals,2,MassMutual East,Eastern,71,2,104,0.6826923076923077,67,4,67,4
2020-21,2021-05-05,Washington Capitals,2,MassMutual East,Eastern,73,2,106,0.6886792452830188,68,5,68,5
2020-21,2021-05-07,Washington Capitals,0,MassMutual East,Eastern,73,2,108,0.6759259259259259,68,5,68,5
2020-21,2021-05-08,Washington Capitals,2,MassMutual East,Eastern,75,2,110,0.6818181818181818,70,5,70,5
2020-21,2021-05-11,Washington Capitals,2,MassMutual East,Eastern,77,2,112,0.6875,71,6,71,6
2020-21,2021-01-15,Winnipeg Jets,2,Scotia North,Western,2,2,2,1.0,2,0,2,0
2020-21,2021-01-19,Winnipeg Jets,0,Scotia North,Western,2,2,4,0.5,2,0,2,0
2020-21,2021-01-20,Winnipeg Jets,2,Scotia North,Western,4,2,6,0.6666666666666666,4,0,3,1
2020-21,2021-01-22,Winnipeg Jets,2,Scotia North,Western,6,2,8,0.75,5,1,4,2
2020-21,2021-01-24,Winnipeg Jets,2,Scotia North,Western,8,2,10,0.8,5,3,5,3
2020-21,2021-01-25,Winnipeg Jets,0,Scotia North,Western,8,2,12,0.6666666666666666,6,2,6,2
2020-21,2021-01-27,Winnipeg Jets,2,Scotia North,Western,10,2,14,0.7142857142857143,6,4,6,4
2020-21,2021-01-31,Winnipeg Jets,0,Scotia North,Western,10,2,16,0.625,10,0,8,2
2020-21,2021-02-02,Winnipeg Jets,1,Scotia North,Western,11,2,18,0.6111111111111112,11,0,9,2
2020-21,2021-02-03,Winnipeg Jets,2,Scotia North,Western,13,2,20,0.65,12,1,11,2
2020-21,2021-02-05,Winnipeg Jets,2,Scotia North,Western,15,2,22,0.6818181818181818,12,3,11,4
2020-21,2021-02-10,Winnipeg Jets,0,Scotia North,Western,15,2,24,0.625,15,0,13,2
2020-21,2021-02-12,Winnipeg Jets,2,Scotia North,Western,17,2,26,0.6538461538461539,17,0,15,2
2020-21,2021-02-13,Winnipeg Jets,0,Scotia North,Western,17,2,28,0.6071428571428571,17,0,15,2
2020-21,2021-02-16,Winnipeg Jets,2,Scotia North,Western,19,2,30,0.6333333333333333,18,1,15,4
2020-21,2021-02-18,Winnipeg Jets,0,Scotia North,Western,19,2,32,0.59375,19,0,17,2
2020-21,2021-02-20,Winnipeg Jets,2,Scotia North,Western,21,2,34,0.6176470588235294,20,1,17,4
2020-21,2021-02-22,Winnipeg Jets,2,Scotia North,Western,23,2,36,0.6388888888888888,21,2,17,6
2020-21,2021-02-26,Winnipeg Jets,2,Scotia North,Western,25,2,38,0.6578947368421053,22,3,20,5
2020-21,2021-02-28,Winnipeg Jets,2,Scotia North,Western,27,2,40,0.675,23,4,22,5
2020-21,2021-03-02,Winnipeg Jets,0,Scotia North,Western,27,2,42,0.6428571428571429,23,4,22,5
2020-21,2021-03-03,Winnipeg Jets,2,Scotia North,Western,29,2,44,0.6590909090909091,25,4,22,7
2020-21,2021-03-05,Winnipeg Jets,2,Scotia North,Western,31,2,46,0.6739130434782609,26,5,24,7
2020-21,2021-03-07,Winnipeg Jets,0,Scotia North,Western,31,2,48,0.6458333333333334,28,3,25,6
2020-21,2021-03-10,Winnipeg Jets,2,Scotia North,Western,33,2,50,0.66,29,4,27,6
2020-21,2021-03-12,Winnipeg Jets,1,Scotia North,Western,34,2,52,0.6538461538461539,31,3,28,6
2020-21,2021-03-14,Winnipeg Jets,2,Scotia North,Western,36,2,54,0.6666666666666666,31,5,29,7
2020-21,2021-03-16,Winnipeg Jets,0,Scotia North,Western,36,2,56,0.6428571428571429,33,3,31,5
2020-21,2021-03-18,Winnipeg Jets,2,Scotia North,Western,38,2,58,0.6551724137931034,34,4,32,6
2020-21,2021-03-19,Winnipeg Jets,0,Scotia North,Western,38,2,60,0.6333333333333333,35,3,33,5
2020-21,2021-03-21,Winnipeg Jets,0,Scotia North,Western,38,2,62,0.6129032258064516,37,1,33,5
2020-21,2021-03-23,Winnipeg Jets,2,Scotia North,Western,40,2,64,0.625,37,3,33,7
2020-21,2021-03-25,Winnipeg Jets,2,Scotia North,Western,42,2,66,0.6363636363636364,37,5,35,7
2020-21,2021-03-27,Winnipeg Jets,2,Scotia North,Western,44,2,68,0.6470588235294118,37,7,35,9
2020-21,2021-03-28,Winnipeg Jets,0,Scotia North,Western,44,2,70,0.6285714285714286,37,7,37,7
2020-21,2021-03-30,Winnipeg Jets,2,Scotia North,Western,46,2,72,0.6388888888888888,39,7,37,9
2020-21,2021-03-31,Winnipeg Jets,0,Scotia North,Western,46,2,74,0.6216216216216216,39,7,38,8
2020-21,2021-04-03,Winnipeg Jets,1,Scotia North,Western,47,2,76,0.618421052631579,41,6,39,8
2020-21,2021-04-05,Winnipeg Jets,2,Scotia North,Western,49,2,78,0.6282051282051282,43,6,39,10
2020-21,2021-04-08,Winnipeg Jets,2,Scotia North,Western,51,2,80,0.6375,43,8,41,10
2020-21,2021-04-10,Winnipeg Jets,2,Scotia North,Western,53,2,82,0.6463414634146342,43,10,43,10
2020-21,2021-04-12,Winnipeg Jets,0,Scotia North,Western,53,2,84,0.6309523809523809,45,8,44,9
2020-21,2021-04-14,Winnipeg Jets,2,Scotia North,Western,55,2,86,0.6395348837209303,45,10,44,11
2020-21,2021-04-15,Winnipeg Jets,2,Scotia North,Western,57,2,88,0.6477272727272727,45,12,44,13
2020-21,2021-04-17,Winnipeg Jets,0,Scotia North,Western,57,2,90,0.6333333333333333,47,10,45,12
2020-21,2021-04-22,Winnipeg Jets,0,Scotia North,Western,57,2,92,0.6195652173913043,49,8,49,8
2020-21,2021-04-24,Winnipeg Jets,0,Scotia North,Western,57,2,94,0.6063829787234043,49,8,49,8
2020-21,2021-04-27,Winnipeg Jets,0,Scotia North,Western,57,2,96,0.59375,51,6,49,8
2020-21,2021-04-29,Winnipeg Jets,0,Scotia North,Western,57,2,98,0.5816326530612245,51,6,50,7
2020-21,2021-04-30,Winnipeg Jets,0,Scotia North,Western,57,2,100,0.57,53,4,52,5
2020-21,2021-05-03,Winnipeg Jets,0,Scotia North,Western,57,2,102,0.5588235294117647,57,0,53,4
2020-21,2021-05-06,Winnipeg Jets,2,Scotia North,Western,59,2,104,0.5673076923076923,57,2,56,3
2020-21,2021-05-08,Winnipeg Jets,0,Scotia North,Western,59,2,106,0.5566037735849056,57,2,57,2
2020-21,2021-05-11,Winnipeg Jets,0,Scotia North,Western,59,2,108,0.5462962962962963,58,1,59,0
2020-21,2021-05-12,Winnipeg Jets,2,Scotia North,Western,61,2,110,0.5545454545454546,59,2,59,2
2020-21,2021-05-15,Winnipeg Jets,2,Scotia North,Western,63,2,112,0.5625,59,4,60,3
